user_id,radius,iteration,FN,TP,test_size,FN_p,TP_p
6189,0,0,7,15,22,0.3181818181818182,0.6818181818181818
5936,0,0,0,31,31,0.0,1.0
6087,0,0,0,18,18,0.0,1.0
5973,0,0,0,34,34,0.0,1.0
6085,0,0,0,34,34,0.0,1.0
5948,0,0,0,42,42,0.0,1.0
5974,0,0,0,10,10,0.0,1.0
6090,0,0,0,1,1,0.0,1.0
6068,0,0,0,35,35,0.0,1.0
6024,0,0,1,1,2,0.5,0.5
5976,0,0,78,2,80,0.975,0.025
5962,0,0,0,59,59,0.0,1.0
6033,0,0,0,24,24,0.0,1.0
6038,0,0,0,7,7,0.0,1.0
6042,0,0,0,49,49,0.0,1.0
5924,0,0,0,50,50,0.0,1.0
6083,0,0,5,7,12,0.4166666666666667,0.5833333333333334
6178,0,0,192,33,225,0.8533333333333334,0.14666666666666667
6086,0,0,0,25,25,0.0,1.0
5945,0,0,0,95,95,0.0,1.0
5925,0,0,0,122,122,0.0,1.0
5935,0,0,0,3,3,0.0,1.0
6073,0,0,5,2,7,0.7142857142857143,0.2857142857142857
5980,0,0,0,12,12,0.0,1.0
5993,0,0,0,24,24,0.0,1.0
5979,0,0,0,33,33,0.0,1.0
5966,0,0,24,2,26,0.9230769230769231,0.07692307692307693
5967,0,0,96,5,101,0.9504950495049505,0.04950495049504951
5970,0,0,0,14,14,0.0,1.0
6188,0,0,3,0,3,1.0,0.0
6096,0,0,1,0,1,1.0,0.0
6069,0,0,0,17,17,0.0,1.0
5937,0,0,0,6,6,0.0,1.0
5990,0,0,0,50,50,0.0,1.0
5928,0,0,0,22,22,0.0,1.0
6058,0,0,64,5,69,0.927536231884058,0.07246376811594203
6001,0,0,6,18,24,0.25,0.75
5964,0,0,1,9,10,0.1,0.9
5950,0,0,1,6,7,0.14285714285714285,0.8571428571428571
5991,0,0,0,20,20,0.0,1.0
6177,0,0,0,3,3,0.0,1.0
5961,0,0,0,45,45,0.0,1.0
5938,0,0,232,108,340,0.6823529411764706,0.3176470588235294
5960,0,0,0,36,36,0.0,1.0
5947,0,0,0,78,78,0.0,1.0
5957,0,0,7,0,7,1.0,0.0
6043,0,0,0,29,29,0.0,1.0
6014,0,0,10,0,10,1.0,0.0
6015,0,0,2,0,2,1.0,0.0
5978,0,0,16,0,16,1.0,0.0
5986,0,0,4,0,4,1.0,0.0
5969,0,0,4,0,4,1.0,0.0
5949,0,0,0,30,30,0.0,1.0
5959,0,0,39,1,40,0.975,0.025
6051,0,0,0,108,108,0.0,1.0
6029,0,0,1,19,20,0.05,0.95
6070,0,0,3,1,4,0.75,0.25
5942,0,0,0,108,108,0.0,1.0
5953,0,0,0,28,28,0.0,1.0
6076,0,0,11,3,14,0.7857142857142857,0.21428571428571427
5940,0,0,9,0,9,1.0,0.0
6109,0,0,90,5,95,0.9473684210526315,0.05263157894736842
6187,0,0,0,6,6,0.0,1.0
6053,0,0,0,15,15,0.0,1.0
6104,0,0,3,1,4,0.75,0.25
5943,0,0,0,9,9,0.0,1.0
6168,0,0,0,240,240,0.0,1.0
5989,0,0,0,6,6,0.0,1.0
5963,0,0,20,0,20,1.0,0.0
6194,0,0,0,80,80,0.0,1.0
6003,0,0,111,127,238,0.46638655462184875,0.5336134453781513
6167,0,0,9,1,10,0.9,0.1
6004,0,0,86,49,135,0.6370370370370371,0.362962962962963
6054,0,0,0,14,14,0.0,1.0
6170,0,0,6,28,34,0.17647058823529413,0.8235294117647058
6063,0,0,9,1,10,0.9,0.1
5988,0,0,0,17,17,0.0,1.0
6075,0,0,1,11,12,0.08333333333333333,0.9166666666666666
6061,0,0,0,26,26,0.0,1.0
5965,0,0,0,45,45,0.0,1.0
6040,0,0,12,0,12,1.0,0.0
6106,0,0,2,28,30,0.06666666666666667,0.9333333333333333
6082,0,0,2,11,13,0.15384615384615385,0.8461538461538461
6031,0,0,0,25,25,0.0,1.0
6039,0,0,1,57,58,0.017241379310344827,0.9827586206896551
6189,1,0,10,12,22,0.45454545454545453,0.5454545454545454
5936,1,0,0,31,31,0.0,1.0
6087,1,0,0,18,18,0.0,1.0
5973,1,0,0,34,34,0.0,1.0
6085,1,0,0,34,34,0.0,1.0
5948,1,0,0,42,42,0.0,1.0
5974,1,0,0,10,10,0.0,1.0
6090,1,0,0,1,1,0.0,1.0
6068,1,0,0,35,35,0.0,1.0
6024,1,0,1,1,2,0.5,0.5
5976,1,0,72,8,80,0.9,0.1
5962,1,0,0,59,59,0.0,1.0
6033,1,0,0,24,24,0.0,1.0
6038,1,0,0,7,7,0.0,1.0
6042,1,0,0,49,49,0.0,1.0
5924,1,0,0,50,50,0.0,1.0
6083,1,0,0,12,12,0.0,1.0
6178,1,0,149,76,225,0.6622222222222223,0.3377777777777778
6086,1,0,0,25,25,0.0,1.0
5945,1,0,0,95,95,0.0,1.0
5925,1,0,0,122,122,0.0,1.0
5935,1,0,0,3,3,0.0,1.0
6073,1,0,4,3,7,0.5714285714285714,0.42857142857142855
5980,1,0,0,12,12,0.0,1.0
5993,1,0,3,21,24,0.125,0.875
5979,1,0,0,33,33,0.0,1.0
5966,1,0,25,1,26,0.9615384615384616,0.038461538461538464
5967,1,0,82,19,101,0.8118811881188119,0.18811881188118812
5970,1,0,0,14,14,0.0,1.0
6188,1,0,3,0,3,1.0,0.0
6096,1,0,1,0,1,1.0,0.0
6069,1,0,0,17,17,0.0,1.0
5937,1,0,0,6,6,0.0,1.0
5990,1,0,0,50,50,0.0,1.0
5928,1,0,0,22,22,0.0,1.0
6058,1,0,61,8,69,0.8840579710144928,0.11594202898550725
6001,1,0,5,19,24,0.20833333333333334,0.7916666666666666
5964,1,0,1,9,10,0.1,0.9
5950,1,0,0,7,7,0.0,1.0
5991,1,0,0,20,20,0.0,1.0
6177,1,0,0,3,3,0.0,1.0
5961,1,0,0,45,45,0.0,1.0
5938,1,0,131,209,340,0.38529411764705884,0.6147058823529412
5960,1,0,0,36,36,0.0,1.0
5947,1,0,0,78,78,0.0,1.0
5957,1,0,6,1,7,0.8571428571428571,0.14285714285714285
6043,1,0,0,29,29,0.0,1.0
6014,1,0,10,0,10,1.0,0.0
6015,1,0,2,0,2,1.0,0.0
5978,1,0,16,0,16,1.0,0.0
5986,1,0,4,0,4,1.0,0.0
5969,1,0,4,0,4,1.0,0.0
5949,1,0,0,30,30,0.0,1.0
5959,1,0,38,2,40,0.95,0.05
6051,1,0,0,108,108,0.0,1.0
6029,1,0,1,19,20,0.05,0.95
6070,1,0,3,1,4,0.75,0.25
5942,1,0,0,108,108,0.0,1.0
5953,1,0,0,28,28,0.0,1.0
6076,1,0,9,5,14,0.6428571428571429,0.35714285714285715
5940,1,0,8,1,9,0.8888888888888888,0.1111111111111111
6109,1,0,83,12,95,0.8736842105263158,0.12631578947368421
6187,1,0,0,6,6,0.0,1.0
6053,1,0,0,15,15,0.0,1.0
6104,1,0,3,1,4,0.75,0.25
5943,1,0,0,9,9,0.0,1.0
6168,1,0,0,240,240,0.0,1.0
5989,1,0,0,6,6,0.0,1.0
5963,1,0,19,1,20,0.95,0.05
6194,1,0,0,80,80,0.0,1.0
6003,1,0,93,145,238,0.3907563025210084,0.6092436974789915
6167,1,0,9,1,10,0.9,0.1
6004,1,0,70,65,135,0.5185185185185185,0.48148148148148145
6054,1,0,0,14,14,0.0,1.0
6170,1,0,8,26,34,0.23529411764705882,0.7647058823529411
6063,1,0,10,0,10,1.0,0.0
5988,1,0,0,17,17,0.0,1.0
6075,1,0,1,11,12,0.08333333333333333,0.9166666666666666
6061,1,0,0,26,26,0.0,1.0
5965,1,0,0,45,45,0.0,1.0
6040,1,0,12,0,12,1.0,0.0
6106,1,0,0,30,30,0.0,1.0
6082,1,0,0,13,13,0.0,1.0
6031,1,0,1,24,25,0.04,0.96
6039,1,0,1,57,58,0.017241379310344827,0.9827586206896551
6189,2,0,5,17,22,0.22727272727272727,0.7727272727272727
5936,2,0,0,31,31,0.0,1.0
6087,2,0,0,18,18,0.0,1.0
5973,2,0,0,34,34,0.0,1.0
6085,2,0,0,34,34,0.0,1.0
5948,2,0,1,41,42,0.023809523809523808,0.9761904761904762
5974,2,0,0,10,10,0.0,1.0
6090,2,0,0,1,1,0.0,1.0
6068,2,0,0,35,35,0.0,1.0
6024,2,0,1,1,2,0.5,0.5
5976,2,0,40,40,80,0.5,0.5
5962,2,0,0,59,59,0.0,1.0
6033,2,0,2,22,24,0.08333333333333333,0.9166666666666666
6038,2,0,0,7,7,0.0,1.0
6042,2,0,0,49,49,0.0,1.0
5924,2,0,0,50,50,0.0,1.0
6083,2,0,7,5,12,0.5833333333333334,0.4166666666666667
6178,2,0,81,144,225,0.36,0.64
6086,2,0,0,25,25,0.0,1.0
5945,2,0,0,95,95,0.0,1.0
5925,2,0,0,122,122,0.0,1.0
5935,2,0,0,3,3,0.0,1.0
6073,2,0,6,1,7,0.8571428571428571,0.14285714285714285
5980,2,0,2,10,12,0.16666666666666666,0.8333333333333334
5993,2,0,0,24,24,0.0,1.0
5979,2,0,0,33,33,0.0,1.0
5966,2,0,20,6,26,0.7692307692307693,0.23076923076923078
5967,2,0,52,49,101,0.5148514851485149,0.48514851485148514
5970,2,0,0,14,14,0.0,1.0
6188,2,0,3,0,3,1.0,0.0
6096,2,0,1,0,1,1.0,0.0
6069,2,0,0,17,17,0.0,1.0
5937,2,0,0,6,6,0.0,1.0
5990,2,0,0,50,50,0.0,1.0
5928,2,0,0,22,22,0.0,1.0
6058,2,0,44,25,69,0.6376811594202898,0.36231884057971014
6001,2,0,6,18,24,0.25,0.75
5964,2,0,1,9,10,0.1,0.9
5950,2,0,0,7,7,0.0,1.0
5991,2,0,0,20,20,0.0,1.0
6177,2,0,0,3,3,0.0,1.0
5961,2,0,0,45,45,0.0,1.0
5938,2,0,30,310,340,0.08823529411764706,0.9117647058823529
5960,2,0,0,36,36,0.0,1.0
5947,2,0,0,78,78,0.0,1.0
5957,2,0,6,1,7,0.8571428571428571,0.14285714285714285
6043,2,0,0,29,29,0.0,1.0
6014,2,0,10,0,10,1.0,0.0
6015,2,0,2,0,2,1.0,0.0
5978,2,0,13,3,16,0.8125,0.1875
5986,2,0,4,0,4,1.0,0.0
5969,2,0,3,1,4,0.75,0.25
5949,2,0,0,30,30,0.0,1.0
5959,2,0,32,8,40,0.8,0.2
6051,2,0,0,108,108,0.0,1.0
6029,2,0,1,19,20,0.05,0.95
6070,2,0,4,0,4,1.0,0.0
5942,2,0,0,108,108,0.0,1.0
5953,2,0,0,28,28,0.0,1.0
6076,2,0,10,4,14,0.7142857142857143,0.2857142857142857
5940,2,0,8,1,9,0.8888888888888888,0.1111111111111111
6109,2,0,50,45,95,0.5263157894736842,0.47368421052631576
6187,2,0,2,4,6,0.3333333333333333,0.6666666666666666
6053,2,0,0,15,15,0.0,1.0
6104,2,0,4,0,4,1.0,0.0
5943,2,0,0,9,9,0.0,1.0
6168,2,0,0,240,240,0.0,1.0
5989,2,0,0,6,6,0.0,1.0
5963,2,0,16,4,20,0.8,0.2
6194,2,0,0,80,80,0.0,1.0
6003,2,0,49,189,238,0.20588235294117646,0.7941176470588235
6167,2,0,5,5,10,0.5,0.5
6004,2,0,31,104,135,0.22962962962962963,0.7703703703703704
6054,2,0,0,14,14,0.0,1.0
6170,2,0,4,30,34,0.11764705882352941,0.8823529411764706
6063,2,0,9,1,10,0.9,0.1
5988,2,0,0,17,17,0.0,1.0
6075,2,0,0,12,12,0.0,1.0
6061,2,0,0,26,26,0.0,1.0
5965,2,0,0,45,45,0.0,1.0
6040,2,0,10,2,12,0.8333333333333334,0.16666666666666666
6106,2,0,0,30,30,0.0,1.0
6082,2,0,2,11,13,0.15384615384615385,0.8461538461538461
6031,2,0,1,24,25,0.04,0.96
6039,2,0,4,54,58,0.06896551724137931,0.9310344827586207
6189,3,0,7,15,22,0.3181818181818182,0.6818181818181818
5936,3,0,0,31,31,0.0,1.0
6087,3,0,0,18,18,0.0,1.0
5973,3,0,0,34,34,0.0,1.0
6085,3,0,0,34,34,0.0,1.0
5948,3,0,0,42,42,0.0,1.0
5974,3,0,0,10,10,0.0,1.0
6090,3,0,0,1,1,0.0,1.0
6068,3,0,0,35,35,0.0,1.0
6024,3,0,2,0,2,1.0,0.0
5976,3,0,31,49,80,0.3875,0.6125
5962,3,0,0,59,59,0.0,1.0
6033,3,0,2,22,24,0.08333333333333333,0.9166666666666666
6038,3,0,0,7,7,0.0,1.0
6042,3,0,0,49,49,0.0,1.0
5924,3,0,0,50,50,0.0,1.0
6083,3,0,2,10,12,0.16666666666666666,0.8333333333333334
6178,3,0,37,188,225,0.16444444444444445,0.8355555555555556
6086,3,0,0,25,25,0.0,1.0
5945,3,0,0,95,95,0.0,1.0
5925,3,0,0,122,122,0.0,1.0
5935,3,0,0,3,3,0.0,1.0
6073,3,0,5,2,7,0.7142857142857143,0.2857142857142857
5980,3,0,2,10,12,0.16666666666666666,0.8333333333333334
5993,3,0,0,24,24,0.0,1.0
5979,3,0,0,33,33,0.0,1.0
5966,3,0,15,11,26,0.5769230769230769,0.4230769230769231
5967,3,0,30,71,101,0.297029702970297,0.7029702970297029
5970,3,0,0,14,14,0.0,1.0
6188,3,0,3,0,3,1.0,0.0
6096,3,0,1,0,1,1.0,0.0
6069,3,0,0,17,17,0.0,1.0
5937,3,0,0,6,6,0.0,1.0
5990,3,0,0,50,50,0.0,1.0
5928,3,0,0,22,22,0.0,1.0
6058,3,0,30,39,69,0.43478260869565216,0.5652173913043478
6001,3,0,3,21,24,0.125,0.875
5964,3,0,3,7,10,0.3,0.7
5950,3,0,2,5,7,0.2857142857142857,0.7142857142857143
5991,3,0,0,20,20,0.0,1.0
6177,3,0,0,3,3,0.0,1.0
5961,3,0,0,45,45,0.0,1.0
5938,3,0,17,323,340,0.05,0.95
5960,3,0,0,36,36,0.0,1.0
5947,3,0,0,78,78,0.0,1.0
5957,3,0,6,1,7,0.8571428571428571,0.14285714285714285
6043,3,0,0,29,29,0.0,1.0
6014,3,0,10,0,10,1.0,0.0
6015,3,0,2,0,2,1.0,0.0
5978,3,0,14,2,16,0.875,0.125
5986,3,0,4,0,4,1.0,0.0
5969,3,0,4,0,4,1.0,0.0
5949,3,0,0,30,30,0.0,1.0
5959,3,0,23,17,40,0.575,0.425
6051,3,0,0,108,108,0.0,1.0
6029,3,0,1,19,20,0.05,0.95
6070,3,0,3,1,4,0.75,0.25
5942,3,0,0,108,108,0.0,1.0
5953,3,0,0,28,28,0.0,1.0
6076,3,0,10,4,14,0.7142857142857143,0.2857142857142857
5940,3,0,9,0,9,1.0,0.0
6109,3,0,39,56,95,0.4105263157894737,0.5894736842105263
6187,3,0,0,6,6,0.0,1.0
6053,3,0,4,11,15,0.26666666666666666,0.7333333333333333
6104,3,0,4,0,4,1.0,0.0
5943,3,0,0,9,9,0.0,1.0
6168,3,0,0,240,240,0.0,1.0
5989,3,0,0,6,6,0.0,1.0
5963,3,0,14,6,20,0.7,0.3
6194,3,0,0,80,80,0.0,1.0
6003,3,0,23,215,238,0.09663865546218488,0.9033613445378151
6167,3,0,4,6,10,0.4,0.6
6004,3,0,17,118,135,0.1259259259259259,0.8740740740740741
6054,3,0,0,14,14,0.0,1.0
6170,3,0,5,29,34,0.14705882352941177,0.8529411764705882
6063,3,0,8,2,10,0.8,0.2
5988,3,0,0,17,17,0.0,1.0
6075,3,0,1,11,12,0.08333333333333333,0.9166666666666666
6061,3,0,0,26,26,0.0,1.0
5965,3,0,0,45,45,0.0,1.0
6040,3,0,11,1,12,0.9166666666666666,0.08333333333333333
6106,3,0,1,29,30,0.03333333333333333,0.9666666666666667
6082,3,0,0,13,13,0.0,1.0
6031,3,0,1,24,25,0.04,0.96
6039,3,0,1,57,58,0.017241379310344827,0.9827586206896551
6189,4,0,4,18,22,0.18181818181818182,0.8181818181818182
5936,4,0,0,31,31,0.0,1.0
6087,4,0,0,18,18,0.0,1.0
5973,4,0,0,34,34,0.0,1.0
6085,4,0,0,34,34,0.0,1.0
5948,4,0,1,41,42,0.023809523809523808,0.9761904761904762
5974,4,0,0,10,10,0.0,1.0
6090,4,0,0,1,1,0.0,1.0
6068,4,0,0,35,35,0.0,1.0
6024,4,0,2,0,2,1.0,0.0
5976,4,0,19,61,80,0.2375,0.7625
5962,4,0,0,59,59,0.0,1.0
6033,4,0,0,24,24,0.0,1.0
6038,4,0,0,7,7,0.0,1.0
6042,4,0,0,49,49,0.0,1.0
5924,4,0,0,50,50,0.0,1.0
6083,4,0,0,12,12,0.0,1.0
6178,4,0,25,200,225,0.1111111111111111,0.8888888888888888
6086,4,0,0,25,25,0.0,1.0
5945,4,0,0,95,95,0.0,1.0
5925,4,0,0,122,122,0.0,1.0
5935,4,0,0,3,3,0.0,1.0
6073,4,0,6,1,7,0.8571428571428571,0.14285714285714285
5980,4,0,2,10,12,0.16666666666666666,0.8333333333333334
5993,4,0,0,24,24,0.0,1.0
5979,4,0,0,33,33,0.0,1.0
5966,4,0,14,12,26,0.5384615384615384,0.46153846153846156
5967,4,0,28,73,101,0.27722772277227725,0.7227722772277227
5970,4,0,0,14,14,0.0,1.0
6188,4,0,3,0,3,1.0,0.0
6096,4,0,1,0,1,1.0,0.0
6069,4,0,0,17,17,0.0,1.0
5937,4,0,0,6,6,0.0,1.0
5990,4,0,0,50,50,0.0,1.0
5928,4,0,0,22,22,0.0,1.0
6058,4,0,27,42,69,0.391304347826087,0.6086956521739131
6001,4,0,3,21,24,0.125,0.875
5964,4,0,0,10,10,0.0,1.0
5950,4,0,0,7,7,0.0,1.0
5991,4,0,0,20,20,0.0,1.0
6177,4,0,0,3,3,0.0,1.0
5961,4,0,0,45,45,0.0,1.0
5938,4,0,20,320,340,0.058823529411764705,0.9411764705882353
5960,4,0,0,36,36,0.0,1.0
5947,4,0,0,78,78,0.0,1.0
5957,4,0,5,2,7,0.7142857142857143,0.2857142857142857
6043,4,0,0,29,29,0.0,1.0
6014,4,0,10,0,10,1.0,0.0
6015,4,0,2,0,2,1.0,0.0
5978,4,0,14,2,16,0.875,0.125
5986,4,0,4,0,4,1.0,0.0
5969,4,0,3,1,4,0.75,0.25
5949,4,0,0,30,30,0.0,1.0
5959,4,0,18,22,40,0.45,0.55
6051,4,0,0,108,108,0.0,1.0
6029,4,0,1,19,20,0.05,0.95
6070,4,0,3,1,4,0.75,0.25
5942,4,0,0,108,108,0.0,1.0
5953,4,0,0,28,28,0.0,1.0
6076,4,0,8,6,14,0.5714285714285714,0.42857142857142855
5940,4,0,8,1,9,0.8888888888888888,0.1111111111111111
6109,4,0,30,65,95,0.3157894736842105,0.6842105263157895
6187,4,0,2,4,6,0.3333333333333333,0.6666666666666666
6053,4,0,0,15,15,0.0,1.0
6104,4,0,3,1,4,0.75,0.25
5943,4,0,0,9,9,0.0,1.0
6168,4,0,0,240,240,0.0,1.0
5989,4,0,0,6,6,0.0,1.0
5963,4,0,12,8,20,0.6,0.4
6194,4,0,0,80,80,0.0,1.0
6003,4,0,15,223,238,0.06302521008403361,0.9369747899159664
6167,4,0,5,5,10,0.5,0.5
6004,4,0,17,118,135,0.1259259259259259,0.8740740740740741
6054,4,0,0,14,14,0.0,1.0
6170,4,0,6,28,34,0.17647058823529413,0.8235294117647058
6063,4,0,7,3,10,0.7,0.3
5988,4,0,0,17,17,0.0,1.0
6075,4,0,1,11,12,0.08333333333333333,0.9166666666666666
6061,4,0,0,26,26,0.0,1.0
5965,4,0,0,45,45,0.0,1.0
6040,4,0,10,2,12,0.8333333333333334,0.16666666666666666
6106,4,0,1,29,30,0.03333333333333333,0.9666666666666667
6082,4,0,0,13,13,0.0,1.0
6031,4,0,0,25,25,0.0,1.0
6039,4,0,1,57,58,0.017241379310344827,0.9827586206896551
6189,5,0,8,14,22,0.36363636363636365,0.6363636363636364
5936,5,0,0,31,31,0.0,1.0
6087,5,0,0,18,18,0.0,1.0
5973,5,0,0,34,34,0.0,1.0
6085,5,0,0,34,34,0.0,1.0
5948,5,0,0,42,42,0.0,1.0
5974,5,0,0,10,10,0.0,1.0
6090,5,0,0,1,1,0.0,1.0
6068,5,0,0,35,35,0.0,1.0
6024,5,0,2,0,2,1.0,0.0
5976,5,0,17,63,80,0.2125,0.7875
5962,5,0,0,59,59,0.0,1.0
6033,5,0,2,22,24,0.08333333333333333,0.9166666666666666
6038,5,0,0,7,7,0.0,1.0
6042,5,0,0,49,49,0.0,1.0
5924,5,0,0,50,50,0.0,1.0
6083,5,0,0,12,12,0.0,1.0
6178,5,0,19,206,225,0.08444444444444445,0.9155555555555556
6086,5,0,0,25,25,0.0,1.0
5945,5,0,0,95,95,0.0,1.0
5925,5,0,0,122,122,0.0,1.0
5935,5,0,0,3,3,0.0,1.0
6073,5,0,4,3,7,0.5714285714285714,0.42857142857142855
5980,5,0,2,10,12,0.16666666666666666,0.8333333333333334
5993,5,0,0,24,24,0.0,1.0
5979,5,0,0,33,33,0.0,1.0
5966,5,0,13,13,26,0.5,0.5
5967,5,0,18,83,101,0.1782178217821782,0.8217821782178217
5970,5,0,0,14,14,0.0,1.0
6188,5,0,3,0,3,1.0,0.0
6096,5,0,1,0,1,1.0,0.0
6069,5,0,0,17,17,0.0,1.0
5937,5,0,0,6,6,0.0,1.0
5990,5,0,0,50,50,0.0,1.0
5928,5,0,0,22,22,0.0,1.0
6058,5,0,22,47,69,0.3188405797101449,0.6811594202898551
6001,5,0,4,20,24,0.16666666666666666,0.8333333333333334
5964,5,0,1,9,10,0.1,0.9
5950,5,0,1,6,7,0.14285714285714285,0.8571428571428571
5991,5,0,0,20,20,0.0,1.0
6177,5,0,0,3,3,0.0,1.0
5961,5,0,0,45,45,0.0,1.0
5938,5,0,12,328,340,0.03529411764705882,0.9647058823529412
5960,5,0,0,36,36,0.0,1.0
5947,5,0,0,78,78,0.0,1.0
5957,5,0,5,2,7,0.7142857142857143,0.2857142857142857
6043,5,0,0,29,29,0.0,1.0
6014,5,0,10,0,10,1.0,0.0
6015,5,0,2,0,2,1.0,0.0
5978,5,0,9,7,16,0.5625,0.4375
5986,5,0,4,0,4,1.0,0.0
5969,5,0,4,0,4,1.0,0.0
5949,5,0,0,30,30,0.0,1.0
5959,5,0,16,24,40,0.4,0.6
6051,5,0,0,108,108,0.0,1.0
6029,5,0,0,20,20,0.0,1.0
6070,5,0,3,1,4,0.75,0.25
5942,5,0,0,108,108,0.0,1.0
5953,5,0,0,28,28,0.0,1.0
6076,5,0,7,7,14,0.5,0.5
5940,5,0,8,1,9,0.8888888888888888,0.1111111111111111
6109,5,0,24,71,95,0.25263157894736843,0.7473684210526316
6187,5,0,0,6,6,0.0,1.0
6053,5,0,0,15,15,0.0,1.0
6104,5,0,3,1,4,0.75,0.25
5943,5,0,0,9,9,0.0,1.0
6168,5,0,0,240,240,0.0,1.0
5989,5,0,0,6,6,0.0,1.0
5963,5,0,11,9,20,0.55,0.45
6194,5,0,0,80,80,0.0,1.0
6003,5,0,15,223,238,0.06302521008403361,0.9369747899159664
6167,5,0,6,4,10,0.6,0.4
6004,5,0,13,122,135,0.0962962962962963,0.9037037037037037
6054,5,0,0,14,14,0.0,1.0
6170,5,0,4,30,34,0.11764705882352941,0.8823529411764706
6063,5,0,8,2,10,0.8,0.2
5988,5,0,0,17,17,0.0,1.0
6075,5,0,0,12,12,0.0,1.0
6061,5,0,0,26,26,0.0,1.0
5965,5,0,0,45,45,0.0,1.0
6040,5,0,10,2,12,0.8333333333333334,0.16666666666666666
6106,5,0,0,30,30,0.0,1.0
6082,5,0,2,11,13,0.15384615384615385,0.8461538461538461
6031,5,0,2,23,25,0.08,0.92
6039,5,0,3,55,58,0.05172413793103448,0.9482758620689655
6189,6,0,2,20,22,0.09090909090909091,0.9090909090909091
5936,6,0,0,31,31,0.0,1.0
6087,6,0,0,18,18,0.0,1.0
5973,6,0,0,34,34,0.0,1.0
6085,6,0,0,34,34,0.0,1.0
5948,6,0,1,41,42,0.023809523809523808,0.9761904761904762
5974,6,0,0,10,10,0.0,1.0
6090,6,0,0,1,1,0.0,1.0
6068,6,0,0,35,35,0.0,1.0
6024,6,0,1,1,2,0.5,0.5
5976,6,0,12,68,80,0.15,0.85
5962,6,0,0,59,59,0.0,1.0
6033,6,0,4,20,24,0.16666666666666666,0.8333333333333334
6038,6,0,0,7,7,0.0,1.0
6042,6,0,0,49,49,0.0,1.0
5924,6,0,0,50,50,0.0,1.0
6083,6,0,0,12,12,0.0,1.0
6178,6,0,13,212,225,0.057777777777777775,0.9422222222222222
6086,6,0,0,25,25,0.0,1.0
5945,6,0,0,95,95,0.0,1.0
5925,6,0,0,122,122,0.0,1.0
5935,6,0,0,3,3,0.0,1.0
6073,6,0,5,2,7,0.7142857142857143,0.2857142857142857
5980,6,0,0,12,12,0.0,1.0
5993,6,0,0,24,24,0.0,1.0
5979,6,0,0,33,33,0.0,1.0
5966,6,0,6,20,26,0.23076923076923078,0.7692307692307693
5967,6,0,7,94,101,0.06930693069306931,0.9306930693069307
5970,6,0,0,14,14,0.0,1.0
6188,6,0,2,1,3,0.6666666666666666,0.3333333333333333
6096,6,0,1,0,1,1.0,0.0
6069,6,0,0,17,17,0.0,1.0
5937,6,0,0,6,6,0.0,1.0
5990,6,0,0,50,50,0.0,1.0
5928,6,0,0,22,22,0.0,1.0
6058,6,0,20,49,69,0.2898550724637681,0.7101449275362319
6001,6,0,5,19,24,0.20833333333333334,0.7916666666666666
5964,6,0,1,9,10,0.1,0.9
5950,6,0,1,6,7,0.14285714285714285,0.8571428571428571
5991,6,0,0,20,20,0.0,1.0
6177,6,0,0,3,3,0.0,1.0
5961,6,0,0,45,45,0.0,1.0
5938,6,0,6,334,340,0.01764705882352941,0.9823529411764705
5960,6,0,0,36,36,0.0,1.0
5947,6,0,0,78,78,0.0,1.0
5957,6,0,4,3,7,0.5714285714285714,0.42857142857142855
6043,6,0,0,29,29,0.0,1.0
6014,6,0,10,0,10,1.0,0.0
6015,6,0,2,0,2,1.0,0.0
5978,6,0,9,7,16,0.5625,0.4375
5986,6,0,4,0,4,1.0,0.0
5969,6,0,4,0,4,1.0,0.0
5949,6,0,0,30,30,0.0,1.0
5959,6,0,11,29,40,0.275,0.725
6051,6,0,0,108,108,0.0,1.0
6029,6,0,0,20,20,0.0,1.0
6070,6,0,3,1,4,0.75,0.25
5942,6,0,0,108,108,0.0,1.0
5953,6,0,0,28,28,0.0,1.0
6076,6,0,7,7,14,0.5,0.5
5940,6,0,8,1,9,0.8888888888888888,0.1111111111111111
6109,6,0,20,75,95,0.21052631578947367,0.7894736842105263
6187,6,0,0,6,6,0.0,1.0
6053,6,0,0,15,15,0.0,1.0
6104,6,0,4,0,4,1.0,0.0
5943,6,0,0,9,9,0.0,1.0
6168,6,0,0,240,240,0.0,1.0
5989,6,0,0,6,6,0.0,1.0
5963,6,0,12,8,20,0.6,0.4
6194,6,0,0,80,80,0.0,1.0
6003,6,0,6,232,238,0.025210084033613446,0.9747899159663865
6167,6,0,5,5,10,0.5,0.5
6004,6,0,14,121,135,0.1037037037037037,0.8962962962962963
6054,6,0,0,14,14,0.0,1.0
6170,6,0,4,30,34,0.11764705882352941,0.8823529411764706
6063,6,0,9,1,10,0.9,0.1
5988,6,0,0,17,17,0.0,1.0
6075,6,0,1,11,12,0.08333333333333333,0.9166666666666666
6061,6,0,0,26,26,0.0,1.0
5965,6,0,0,45,45,0.0,1.0
6040,6,0,9,3,12,0.75,0.25
6106,6,0,0,30,30,0.0,1.0
6082,6,0,2,11,13,0.15384615384615385,0.8461538461538461
6031,6,0,2,23,25,0.08,0.92
6039,6,0,3,55,58,0.05172413793103448,0.9482758620689655
6189,7,0,0,22,22,0.0,1.0
5936,7,0,0,31,31,0.0,1.0
6087,7,0,0,18,18,0.0,1.0
5973,7,0,0,34,34,0.0,1.0
6085,7,0,0,34,34,0.0,1.0
5948,7,0,0,42,42,0.0,1.0
5974,7,0,0,10,10,0.0,1.0
6090,7,0,0,1,1,0.0,1.0
6068,7,0,0,35,35,0.0,1.0
6024,7,0,2,0,2,1.0,0.0
5976,7,0,6,74,80,0.075,0.925
5962,7,0,0,59,59,0.0,1.0
6033,7,0,4,20,24,0.16666666666666666,0.8333333333333334
6038,7,0,0,7,7,0.0,1.0
6042,7,0,0,49,49,0.0,1.0
5924,7,0,0,50,50,0.0,1.0
6083,7,0,1,11,12,0.08333333333333333,0.9166666666666666
6178,7,0,8,217,225,0.035555555555555556,0.9644444444444444
6086,7,0,0,25,25,0.0,1.0
5945,7,0,0,95,95,0.0,1.0
5925,7,0,0,122,122,0.0,1.0
5935,7,0,0,3,3,0.0,1.0
6073,7,0,3,4,7,0.42857142857142855,0.5714285714285714
5980,7,0,0,12,12,0.0,1.0
5993,7,0,0,24,24,0.0,1.0
5979,7,0,0,33,33,0.0,1.0
5966,7,0,4,22,26,0.15384615384615385,0.8461538461538461
5967,7,0,15,86,101,0.1485148514851485,0.8514851485148515
5970,7,0,0,14,14,0.0,1.0
6188,7,0,1,2,3,0.3333333333333333,0.6666666666666666
6096,7,0,1,0,1,1.0,0.0
6069,7,0,0,17,17,0.0,1.0
5937,7,0,0,6,6,0.0,1.0
5990,7,0,0,50,50,0.0,1.0
5928,7,0,0,22,22,0.0,1.0
6058,7,0,19,50,69,0.2753623188405797,0.7246376811594203
6001,7,0,3,21,24,0.125,0.875
5964,7,0,0,10,10,0.0,1.0
5950,7,0,0,7,7,0.0,1.0
5991,7,0,0,20,20,0.0,1.0
6177,7,0,0,3,3,0.0,1.0
5961,7,0,0,45,45,0.0,1.0
5938,7,0,6,334,340,0.01764705882352941,0.9823529411764705
5960,7,0,0,36,36,0.0,1.0
5947,7,0,0,78,78,0.0,1.0
5957,7,0,4,3,7,0.5714285714285714,0.42857142857142855
6043,7,0,0,29,29,0.0,1.0
6014,7,0,10,0,10,1.0,0.0
6015,7,0,2,0,2,1.0,0.0
5978,7,0,6,10,16,0.375,0.625
5986,7,0,4,0,4,1.0,0.0
5969,7,0,4,0,4,1.0,0.0
5949,7,0,0,30,30,0.0,1.0
5959,7,0,6,34,40,0.15,0.85
6051,7,0,0,108,108,0.0,1.0
6029,7,0,0,20,20,0.0,1.0
6070,7,0,3,1,4,0.75,0.25
5942,7,0,0,108,108,0.0,1.0
5953,7,0,0,28,28,0.0,1.0
6076,7,0,4,10,14,0.2857142857142857,0.7142857142857143
5940,7,0,6,3,9,0.6666666666666666,0.3333333333333333
6109,7,0,15,80,95,0.15789473684210525,0.8421052631578947
6187,7,0,0,6,6,0.0,1.0
6053,7,0,0,15,15,0.0,1.0
6104,7,0,3,1,4,0.75,0.25
5943,7,0,0,9,9,0.0,1.0
6168,7,0,0,240,240,0.0,1.0
5989,7,0,0,6,6,0.0,1.0
5963,7,0,8,12,20,0.4,0.6
6194,7,0,0,80,80,0.0,1.0
6003,7,0,9,229,238,0.037815126050420166,0.9621848739495799
6167,7,0,2,8,10,0.2,0.8
6004,7,0,3,132,135,0.022222222222222223,0.9777777777777777
6054,7,0,0,14,14,0.0,1.0
6170,7,0,2,32,34,0.058823529411764705,0.9411764705882353
6063,7,0,9,1,10,0.9,0.1
5988,7,0,0,17,17,0.0,1.0
6075,7,0,2,10,12,0.16666666666666666,0.8333333333333334
6061,7,0,0,26,26,0.0,1.0
5965,7,0,0,45,45,0.0,1.0
6040,7,0,8,4,12,0.6666666666666666,0.3333333333333333
6106,7,0,1,29,30,0.03333333333333333,0.9666666666666667
6082,7,0,0,13,13,0.0,1.0
6031,7,0,0,25,25,0.0,1.0
6039,7,0,0,58,58,0.0,1.0
6189,8,0,5,17,22,0.22727272727272727,0.7727272727272727
5936,8,0,0,31,31,0.0,1.0
6087,8,0,0,18,18,0.0,1.0
5973,8,0,0,34,34,0.0,1.0
6085,8,0,0,34,34,0.0,1.0
5948,8,0,1,41,42,0.023809523809523808,0.9761904761904762
5974,8,0,0,10,10,0.0,1.0
6090,8,0,0,1,1,0.0,1.0
6068,8,0,0,35,35,0.0,1.0
6024,8,0,1,1,2,0.5,0.5
5976,8,0,13,67,80,0.1625,0.8375
5962,8,0,0,59,59,0.0,1.0
6033,8,0,2,22,24,0.08333333333333333,0.9166666666666666
6038,8,0,0,7,7,0.0,1.0
6042,8,0,0,49,49,0.0,1.0
5924,8,0,0,50,50,0.0,1.0
6083,8,0,2,10,12,0.16666666666666666,0.8333333333333334
6178,8,0,8,217,225,0.035555555555555556,0.9644444444444444
6086,8,0,0,25,25,0.0,1.0
5945,8,0,0,95,95,0.0,1.0
5925,8,0,0,122,122,0.0,1.0
5935,8,0,0,3,3,0.0,1.0
6073,8,0,4,3,7,0.5714285714285714,0.42857142857142855
5980,8,0,0,12,12,0.0,1.0
5993,8,0,0,24,24,0.0,1.0
5979,8,0,0,33,33,0.0,1.0
5966,8,0,5,21,26,0.19230769230769232,0.8076923076923077
5967,8,0,7,94,101,0.06930693069306931,0.9306930693069307
5970,8,0,0,14,14,0.0,1.0
6188,8,0,1,2,3,0.3333333333333333,0.6666666666666666
6096,8,0,1,0,1,1.0,0.0
6069,8,0,0,17,17,0.0,1.0
5937,8,0,0,6,6,0.0,1.0
5990,8,0,0,50,50,0.0,1.0
5928,8,0,0,22,22,0.0,1.0
6058,8,0,13,56,69,0.18840579710144928,0.8115942028985508
6001,8,0,2,22,24,0.08333333333333333,0.9166666666666666
5964,8,0,1,9,10,0.1,0.9
5950,8,0,1,6,7,0.14285714285714285,0.8571428571428571
5991,8,0,0,20,20,0.0,1.0
6177,8,0,0,3,3,0.0,1.0
5961,8,0,0,45,45,0.0,1.0
5938,8,0,6,334,340,0.01764705882352941,0.9823529411764705
5960,8,0,0,36,36,0.0,1.0
5947,8,0,0,78,78,0.0,1.0
5957,8,0,4,3,7,0.5714285714285714,0.42857142857142855
6043,8,0,0,29,29,0.0,1.0
6014,8,0,9,1,10,0.9,0.1
6015,8,0,2,0,2,1.0,0.0
5978,8,0,4,12,16,0.25,0.75
5986,8,0,3,1,4,0.75,0.25
5969,8,0,3,1,4,0.75,0.25
5949,8,0,0,30,30,0.0,1.0
5959,8,0,9,31,40,0.225,0.775
6051,8,0,0,108,108,0.0,1.0
6029,8,0,1,19,20,0.05,0.95
6070,8,0,3,1,4,0.75,0.25
5942,8,0,0,108,108,0.0,1.0
5953,8,0,0,28,28,0.0,1.0
6076,8,0,4,10,14,0.2857142857142857,0.7142857142857143
5940,8,0,5,4,9,0.5555555555555556,0.4444444444444444
6109,8,0,13,82,95,0.1368421052631579,0.8631578947368421
6187,8,0,2,4,6,0.3333333333333333,0.6666666666666666
6053,8,0,0,15,15,0.0,1.0
6104,8,0,3,1,4,0.75,0.25
5943,8,0,0,9,9,0.0,1.0
6168,8,0,0,240,240,0.0,1.0
5989,8,0,0,6,6,0.0,1.0
5963,8,0,11,9,20,0.55,0.45
6194,8,0,0,80,80,0.0,1.0
6003,8,0,3,235,238,0.012605042016806723,0.9873949579831933
6167,8,0,1,9,10,0.1,0.9
6004,8,0,3,132,135,0.022222222222222223,0.9777777777777777
6054,8,0,0,14,14,0.0,1.0
6170,8,0,4,30,34,0.11764705882352941,0.8823529411764706
6063,8,0,7,3,10,0.7,0.3
5988,8,0,0,17,17,0.0,1.0
6075,8,0,1,11,12,0.08333333333333333,0.9166666666666666
6061,8,0,0,26,26,0.0,1.0
5965,8,0,0,45,45,0.0,1.0
6040,8,0,11,1,12,0.9166666666666666,0.08333333333333333
6106,8,0,0,30,30,0.0,1.0
6082,8,0,0,13,13,0.0,1.0
6031,8,0,1,24,25,0.04,0.96
6039,8,0,0,58,58,0.0,1.0
6189,9,0,5,17,22,0.22727272727272727,0.7727272727272727
5936,9,0,0,31,31,0.0,1.0
6087,9,0,0,18,18,0.0,1.0
5973,9,0,0,34,34,0.0,1.0
6085,9,0,0,34,34,0.0,1.0
5948,9,0,0,42,42,0.0,1.0
5974,9,0,0,10,10,0.0,1.0
6090,9,0,0,1,1,0.0,1.0
6068,9,0,0,35,35,0.0,1.0
6024,9,0,2,0,2,1.0,0.0
5976,9,0,3,77,80,0.0375,0.9625
5962,9,0,0,59,59,0.0,1.0
6033,9,0,0,24,24,0.0,1.0
6038,9,0,0,7,7,0.0,1.0
6042,9,0,0,49,49,0.0,1.0
5924,9,0,0,50,50,0.0,1.0
6083,9,0,3,9,12,0.25,0.75
6178,9,0,2,223,225,0.008888888888888889,0.9911111111111112
6086,9,0,0,25,25,0.0,1.0
5945,9,0,0,95,95,0.0,1.0
5925,9,0,0,122,122,0.0,1.0
5935,9,0,0,3,3,0.0,1.0
6073,9,0,2,5,7,0.2857142857142857,0.7142857142857143
5980,9,0,0,12,12,0.0,1.0
5993,9,0,0,24,24,0.0,1.0
5979,9,0,0,33,33,0.0,1.0
5966,9,0,3,23,26,0.11538461538461539,0.8846153846153846
5967,9,0,9,92,101,0.0891089108910891,0.9108910891089109
5970,9,0,0,14,14,0.0,1.0
6188,9,0,3,0,3,1.0,0.0
6096,9,0,1,0,1,1.0,0.0
6069,9,0,0,17,17,0.0,1.0
5937,9,0,0,6,6,0.0,1.0
5990,9,0,0,50,50,0.0,1.0
5928,9,0,0,22,22,0.0,1.0
6058,9,0,15,54,69,0.21739130434782608,0.782608695652174
6001,9,0,2,22,24,0.08333333333333333,0.9166666666666666
5964,9,0,0,10,10,0.0,1.0
5950,9,0,1,6,7,0.14285714285714285,0.8571428571428571
5991,9,0,0,20,20,0.0,1.0
6177,9,0,0,3,3,0.0,1.0
5961,9,0,0,45,45,0.0,1.0
5938,9,0,2,338,340,0.0058823529411764705,0.9941176470588236
5960,9,0,0,36,36,0.0,1.0
5947,9,0,0,78,78,0.0,1.0
5957,9,0,4,3,7,0.5714285714285714,0.42857142857142855
6043,9,0,0,29,29,0.0,1.0
6014,9,0,10,0,10,1.0,0.0
6015,9,0,2,0,2,1.0,0.0
5978,9,0,6,10,16,0.375,0.625
5986,9,0,2,2,4,0.5,0.5
5969,9,0,3,1,4,0.75,0.25
5949,9,0,0,30,30,0.0,1.0
5959,9,0,5,35,40,0.125,0.875
6051,9,0,0,108,108,0.0,1.0
6029,9,0,1,19,20,0.05,0.95
6070,9,0,3,1,4,0.75,0.25
5942,9,0,0,108,108,0.0,1.0
5953,9,0,0,28,28,0.0,1.0
6076,9,0,4,10,14,0.2857142857142857,0.7142857142857143
5940,9,0,4,5,9,0.4444444444444444,0.5555555555555556
6109,9,0,6,89,95,0.06315789473684211,0.9368421052631579
6187,9,0,0,6,6,0.0,1.0
6053,9,0,0,15,15,0.0,1.0
6104,9,0,3,1,4,0.75,0.25
5943,9,0,0,9,9,0.0,1.0
6168,9,0,0,240,240,0.0,1.0
5989,9,0,0,6,6,0.0,1.0
5963,9,0,6,14,20,0.3,0.7
6194,9,0,0,80,80,0.0,1.0
6003,9,0,3,235,238,0.012605042016806723,0.9873949579831933
6167,9,0,2,8,10,0.2,0.8
6004,9,0,2,133,135,0.014814814814814815,0.9851851851851852
6054,9,0,0,14,14,0.0,1.0
6170,9,0,3,31,34,0.08823529411764706,0.9117647058823529
6063,9,0,5,5,10,0.5,0.5
5988,9,0,0,17,17,0.0,1.0
6075,9,0,0,12,12,0.0,1.0
6061,9,0,0,26,26,0.0,1.0
5965,9,0,0,45,45,0.0,1.0
6040,9,0,4,8,12,0.3333333333333333,0.6666666666666666
6106,9,0,2,28,30,0.06666666666666667,0.9333333333333333
6082,9,0,0,13,13,0.0,1.0
6031,9,0,0,25,25,0.0,1.0
6039,9,0,0,58,58,0.0,1.0
6189,10,0,2,20,22,0.09090909090909091,0.9090909090909091
5936,10,0,0,31,31,0.0,1.0
6087,10,0,0,18,18,0.0,1.0
5973,10,0,0,34,34,0.0,1.0
6085,10,0,0,34,34,0.0,1.0
5948,10,0,0,42,42,0.0,1.0
5974,10,0,0,10,10,0.0,1.0
6090,10,0,0,1,1,0.0,1.0
6068,10,0,0,35,35,0.0,1.0
6024,10,0,2,0,2,1.0,0.0
5976,10,0,9,71,80,0.1125,0.8875
5962,10,0,0,59,59,0.0,1.0
6033,10,0,0,24,24,0.0,1.0
6038,10,0,0,7,7,0.0,1.0
6042,10,0,0,49,49,0.0,1.0
5924,10,0,0,50,50,0.0,1.0
6083,10,0,1,11,12,0.08333333333333333,0.9166666666666666
6178,10,0,3,222,225,0.013333333333333334,0.9866666666666667
6086,10,0,0,25,25,0.0,1.0
5945,10,0,0,95,95,0.0,1.0
5925,10,0,0,122,122,0.0,1.0
5935,10,0,0,3,3,0.0,1.0
6073,10,0,5,2,7,0.7142857142857143,0.2857142857142857
5980,10,0,0,12,12,0.0,1.0
5993,10,0,0,24,24,0.0,1.0
5979,10,0,0,33,33,0.0,1.0
5966,10,0,3,23,26,0.11538461538461539,0.8846153846153846
5967,10,0,4,97,101,0.039603960396039604,0.9603960396039604
5970,10,0,0,14,14,0.0,1.0
6188,10,0,2,1,3,0.6666666666666666,0.3333333333333333
6096,10,0,1,0,1,1.0,0.0
6069,10,0,0,17,17,0.0,1.0
5937,10,0,0,6,6,0.0,1.0
5990,10,0,0,50,50,0.0,1.0
5928,10,0,0,22,22,0.0,1.0
6058,10,0,9,60,69,0.13043478260869565,0.8695652173913043
6001,10,0,3,21,24,0.125,0.875
5964,10,0,0,10,10,0.0,1.0
5950,10,0,1,6,7,0.14285714285714285,0.8571428571428571
5991,10,0,0,20,20,0.0,1.0
6177,10,0,0,3,3,0.0,1.0
5961,10,0,0,45,45,0.0,1.0
5938,10,0,5,335,340,0.014705882352941176,0.9852941176470589
5960,10,0,0,36,36,0.0,1.0
5947,10,0,0,78,78,0.0,1.0
5957,10,0,5,2,7,0.7142857142857143,0.2857142857142857
6043,10,0,0,29,29,0.0,1.0
6014,10,0,9,1,10,0.9,0.1
6015,10,0,2,0,2,1.0,0.0
5978,10,0,4,12,16,0.25,0.75
5986,10,0,3,1,4,0.75,0.25
5969,10,0,2,2,4,0.5,0.5
5949,10,0,0,30,30,0.0,1.0
5959,10,0,5,35,40,0.125,0.875
6051,10,0,0,108,108,0.0,1.0
6029,10,0,1,19,20,0.05,0.95
6070,10,0,4,0,4,1.0,0.0
5942,10,0,0,108,108,0.0,1.0
5953,10,0,0,28,28,0.0,1.0
6076,10,0,3,11,14,0.21428571428571427,0.7857142857142857
5940,10,0,4,5,9,0.4444444444444444,0.5555555555555556
6109,10,0,8,87,95,0.08421052631578947,0.9157894736842105
6187,10,0,0,6,6,0.0,1.0
6053,10,0,0,15,15,0.0,1.0
6104,10,0,3,1,4,0.75,0.25
5943,10,0,0,9,9,0.0,1.0
6168,10,0,0,240,240,0.0,1.0
5989,10,0,0,6,6,0.0,1.0
5963,10,0,5,15,20,0.25,0.75
6194,10,0,0,80,80,0.0,1.0
6003,10,0,1,237,238,0.004201680672268907,0.9957983193277311
6167,10,0,1,9,10,0.1,0.9
6004,10,0,4,131,135,0.02962962962962963,0.9703703703703703
6054,10,0,0,14,14,0.0,1.0
6170,10,0,8,26,34,0.23529411764705882,0.7647058823529411
6063,10,0,4,6,10,0.4,0.6
5988,10,0,0,17,17,0.0,1.0
6075,10,0,0,12,12,0.0,1.0
6061,10,0,0,26,26,0.0,1.0
5965,10,0,0,45,45,0.0,1.0
6040,10,0,6,6,12,0.5,0.5
6106,10,0,0,30,30,0.0,1.0
6082,10,0,2,11,13,0.15384615384615385,0.8461538461538461
6031,10,0,1,24,25,0.04,0.96
6039,10,0,0,58,58,0.0,1.0
6189,11,0,3,19,22,0.13636363636363635,0.8636363636363636
5936,11,0,0,31,31,0.0,1.0
6087,11,0,0,18,18,0.0,1.0
5973,11,0,0,34,34,0.0,1.0
6085,11,0,0,34,34,0.0,1.0
5948,11,0,0,42,42,0.0,1.0
5974,11,0,0,10,10,0.0,1.0
6090,11,0,0,1,1,0.0,1.0
6068,11,0,0,35,35,0.0,1.0
6024,11,0,2,0,2,1.0,0.0
5976,11,0,4,76,80,0.05,0.95
5962,11,0,0,59,59,0.0,1.0
6033,11,0,2,22,24,0.08333333333333333,0.9166666666666666
6038,11,0,0,7,7,0.0,1.0
6042,11,0,0,49,49,0.0,1.0
5924,11,0,0,50,50,0.0,1.0
6083,11,0,0,12,12,0.0,1.0
6178,11,0,0,225,225,0.0,1.0
6086,11,0,0,25,25,0.0,1.0
5945,11,0,0,95,95,0.0,1.0
5925,11,0,0,122,122,0.0,1.0
5935,11,0,0,3,3,0.0,1.0
6073,11,0,2,5,7,0.2857142857142857,0.7142857142857143
5980,11,0,0,12,12,0.0,1.0
5993,11,0,0,24,24,0.0,1.0
5979,11,0,0,33,33,0.0,1.0
5966,11,0,7,19,26,0.2692307692307692,0.7307692307692307
5967,11,0,5,96,101,0.04950495049504951,0.9504950495049505
5970,11,0,0,14,14,0.0,1.0
6188,11,0,2,1,3,0.6666666666666666,0.3333333333333333
6096,11,0,1,0,1,1.0,0.0
6069,11,0,0,17,17,0.0,1.0
5937,11,0,0,6,6,0.0,1.0
5990,11,0,0,50,50,0.0,1.0
5928,11,0,0,22,22,0.0,1.0
6058,11,0,10,59,69,0.14492753623188406,0.855072463768116
6001,11,0,3,21,24,0.125,0.875
5964,11,0,0,10,10,0.0,1.0
5950,11,0,2,5,7,0.2857142857142857,0.7142857142857143
5991,11,0,0,20,20,0.0,1.0
6177,11,0,0,3,3,0.0,1.0
5961,11,0,0,45,45,0.0,1.0
5938,11,0,6,334,340,0.01764705882352941,0.9823529411764705
5960,11,0,0,36,36,0.0,1.0
5947,11,0,0,78,78,0.0,1.0
5957,11,0,4,3,7,0.5714285714285714,0.42857142857142855
6043,11,0,0,29,29,0.0,1.0
6014,11,0,8,2,10,0.8,0.2
6015,11,0,1,1,2,0.5,0.5
5978,11,0,1,15,16,0.0625,0.9375
5986,11,0,3,1,4,0.75,0.25
5969,11,0,1,3,4,0.25,0.75
5949,11,0,0,30,30,0.0,1.0
5959,11,0,3,37,40,0.075,0.925
6051,11,0,0,108,108,0.0,1.0
6029,11,0,0,20,20,0.0,1.0
6070,11,0,3,1,4,0.75,0.25
5942,11,0,0,108,108,0.0,1.0
5953,11,0,0,28,28,0.0,1.0
6076,11,0,2,12,14,0.14285714285714285,0.8571428571428571
5940,11,0,5,4,9,0.5555555555555556,0.4444444444444444
6109,11,0,5,90,95,0.05263157894736842,0.9473684210526315
6187,11,0,0,6,6,0.0,1.0
6053,11,0,0,15,15,0.0,1.0
6104,11,0,3,1,4,0.75,0.25
5943,11,0,0,9,9,0.0,1.0
6168,11,0,0,240,240,0.0,1.0
5989,11,0,0,6,6,0.0,1.0
5963,11,0,7,13,20,0.35,0.65
6194,11,0,0,80,80,0.0,1.0
6003,11,0,3,235,238,0.012605042016806723,0.9873949579831933
6167,11,0,2,8,10,0.2,0.8
6004,11,0,5,130,135,0.037037037037037035,0.9629629629629629
6054,11,0,0,14,14,0.0,1.0
6170,11,0,3,31,34,0.08823529411764706,0.9117647058823529
6063,11,0,7,3,10,0.7,0.3
5988,11,0,0,17,17,0.0,1.0
6075,11,0,1,11,12,0.08333333333333333,0.9166666666666666
6061,11,0,0,26,26,0.0,1.0
5965,11,0,0,45,45,0.0,1.0
6040,11,0,8,4,12,0.6666666666666666,0.3333333333333333
6106,11,0,1,29,30,0.03333333333333333,0.9666666666666667
6082,11,0,0,13,13,0.0,1.0
6031,11,0,1,24,25,0.04,0.96
6039,11,0,1,57,58,0.017241379310344827,0.9827586206896551
6189,12,0,3,19,22,0.13636363636363635,0.8636363636363636
5936,12,0,0,31,31,0.0,1.0
6087,12,0,0,18,18,0.0,1.0
5973,12,0,0,34,34,0.0,1.0
6085,12,0,0,34,34,0.0,1.0
5948,12,0,1,41,42,0.023809523809523808,0.9761904761904762
5974,12,0,0,10,10,0.0,1.0
6090,12,0,0,1,1,0.0,1.0
6068,12,0,0,35,35,0.0,1.0
6024,12,0,1,1,2,0.5,0.5
5976,12,0,1,79,80,0.0125,0.9875
5962,12,0,0,59,59,0.0,1.0
6033,12,0,4,20,24,0.16666666666666666,0.8333333333333334
6038,12,0,0,7,7,0.0,1.0
6042,12,0,0,49,49,0.0,1.0
5924,12,0,0,50,50,0.0,1.0
6083,12,0,2,10,12,0.16666666666666666,0.8333333333333334
6178,12,0,2,223,225,0.008888888888888889,0.9911111111111112
6086,12,0,0,25,25,0.0,1.0
5945,12,0,0,95,95,0.0,1.0
5925,12,0,0,122,122,0.0,1.0
5935,12,0,0,3,3,0.0,1.0
6073,12,0,3,4,7,0.42857142857142855,0.5714285714285714
5980,12,0,0,12,12,0.0,1.0
5993,12,0,0,24,24,0.0,1.0
5979,12,0,0,33,33,0.0,1.0
5966,12,0,2,24,26,0.07692307692307693,0.9230769230769231
5967,12,0,3,98,101,0.0297029702970297,0.9702970297029703
5970,12,0,0,14,14,0.0,1.0
6188,12,0,2,1,3,0.6666666666666666,0.3333333333333333
6096,12,0,1,0,1,1.0,0.0
6069,12,0,0,17,17,0.0,1.0
5937,12,0,0,6,6,0.0,1.0
5990,12,0,0,50,50,0.0,1.0
5928,12,0,0,22,22,0.0,1.0
6058,12,0,13,56,69,0.18840579710144928,0.8115942028985508
6001,12,0,3,21,24,0.125,0.875
5964,12,0,1,9,10,0.1,0.9
5950,12,0,2,5,7,0.2857142857142857,0.7142857142857143
5991,12,0,0,20,20,0.0,1.0
6177,12,0,0,3,3,0.0,1.0
5961,12,0,0,45,45,0.0,1.0
5938,12,0,0,340,340,0.0,1.0
5960,12,0,0,36,36,0.0,1.0
5947,12,0,0,78,78,0.0,1.0
5957,12,0,4,3,7,0.5714285714285714,0.42857142857142855
6043,12,0,0,29,29,0.0,1.0
6014,12,0,6,4,10,0.6,0.4
6015,12,0,1,1,2,0.5,0.5
5978,12,0,5,11,16,0.3125,0.6875
5986,12,0,3,1,4,0.75,0.25
5969,12,0,1,3,4,0.25,0.75
5949,12,0,0,30,30,0.0,1.0
5959,12,0,1,39,40,0.025,0.975
6051,12,0,0,108,108,0.0,1.0
6029,12,0,0,20,20,0.0,1.0
6070,12,0,4,0,4,1.0,0.0
5942,12,0,0,108,108,0.0,1.0
5953,12,0,0,28,28,0.0,1.0
6076,12,0,5,9,14,0.35714285714285715,0.6428571428571429
5940,12,0,3,6,9,0.3333333333333333,0.6666666666666666
6109,12,0,8,87,95,0.08421052631578947,0.9157894736842105
6187,12,0,2,4,6,0.3333333333333333,0.6666666666666666
6053,12,0,0,15,15,0.0,1.0
6104,12,0,4,0,4,1.0,0.0
5943,12,0,0,9,9,0.0,1.0
6168,12,0,0,240,240,0.0,1.0
5989,12,0,0,6,6,0.0,1.0
5963,12,0,5,15,20,0.25,0.75
6194,12,0,0,80,80,0.0,1.0
6003,12,0,2,236,238,0.008403361344537815,0.9915966386554622
6167,12,0,1,9,10,0.1,0.9
6004,12,0,0,135,135,0.0,1.0
6054,12,0,0,14,14,0.0,1.0
6170,12,0,1,33,34,0.029411764705882353,0.9705882352941176
6063,12,0,4,6,10,0.4,0.6
5988,12,0,0,17,17,0.0,1.0
6075,12,0,2,10,12,0.16666666666666666,0.8333333333333334
6061,12,0,0,26,26,0.0,1.0
5965,12,0,0,45,45,0.0,1.0
6040,12,0,5,7,12,0.4166666666666667,0.5833333333333334
6106,12,0,1,29,30,0.03333333333333333,0.9666666666666667
6082,12,0,0,13,13,0.0,1.0
6031,12,0,1,24,25,0.04,0.96
6039,12,0,3,55,58,0.05172413793103448,0.9482758620689655
6189,13,0,1,21,22,0.045454545454545456,0.9545454545454546
5936,13,0,0,31,31,0.0,1.0
6087,13,0,0,18,18,0.0,1.0
5973,13,0,0,34,34,0.0,1.0
6085,13,0,0,34,34,0.0,1.0
5948,13,0,1,41,42,0.023809523809523808,0.9761904761904762
5974,13,0,0,10,10,0.0,1.0
6090,13,0,0,1,1,0.0,1.0
6068,13,0,0,35,35,0.0,1.0
6024,13,0,1,1,2,0.5,0.5
5976,13,0,4,76,80,0.05,0.95
5962,13,0,0,59,59,0.0,1.0
6033,13,0,2,22,24,0.08333333333333333,0.9166666666666666
6038,13,0,0,7,7,0.0,1.0
6042,13,0,0,49,49,0.0,1.0
5924,13,0,0,50,50,0.0,1.0
6083,13,0,2,10,12,0.16666666666666666,0.8333333333333334
6178,13,0,0,225,225,0.0,1.0
6086,13,0,0,25,25,0.0,1.0
5945,13,0,0,95,95,0.0,1.0
5925,13,0,0,122,122,0.0,1.0
5935,13,0,0,3,3,0.0,1.0
6073,13,0,4,3,7,0.5714285714285714,0.42857142857142855
5980,13,0,0,12,12,0.0,1.0
5993,13,0,0,24,24,0.0,1.0
5979,13,0,0,33,33,0.0,1.0
5966,13,0,4,22,26,0.15384615384615385,0.8461538461538461
5967,13,0,1,100,101,0.009900990099009901,0.9900990099009901
5970,13,0,0,14,14,0.0,1.0
6188,13,0,1,2,3,0.3333333333333333,0.6666666666666666
6096,13,0,1,0,1,1.0,0.0
6069,13,0,0,17,17,0.0,1.0
5937,13,0,0,6,6,0.0,1.0
5990,13,0,0,50,50,0.0,1.0
5928,13,0,0,22,22,0.0,1.0
6058,13,0,8,61,69,0.11594202898550725,0.8840579710144928
6001,13,0,1,23,24,0.041666666666666664,0.9583333333333334
5964,13,0,0,10,10,0.0,1.0
5950,13,0,0,7,7,0.0,1.0
5991,13,0,0,20,20,0.0,1.0
6177,13,0,0,3,3,0.0,1.0
5961,13,0,0,45,45,0.0,1.0
5938,13,0,2,338,340,0.0058823529411764705,0.9941176470588236
5960,13,0,0,36,36,0.0,1.0
5947,13,0,0,78,78,0.0,1.0
5957,13,0,3,4,7,0.42857142857142855,0.5714285714285714
6043,13,0,0,29,29,0.0,1.0
6014,13,0,8,2,10,0.8,0.2
6015,13,0,2,0,2,1.0,0.0
5978,13,0,2,14,16,0.125,0.875
5986,13,0,2,2,4,0.5,0.5
5969,13,0,1,3,4,0.25,0.75
5949,13,0,0,30,30,0.0,1.0
5959,13,0,1,39,40,0.025,0.975
6051,13,0,0,108,108,0.0,1.0
6029,13,0,0,20,20,0.0,1.0
6070,13,0,3,1,4,0.75,0.25
5942,13,0,0,108,108,0.0,1.0
5953,13,0,0,28,28,0.0,1.0
6076,13,0,2,12,14,0.14285714285714285,0.8571428571428571
5940,13,0,5,4,9,0.5555555555555556,0.4444444444444444
6109,13,0,6,89,95,0.06315789473684211,0.9368421052631579
6187,13,0,0,6,6,0.0,1.0
6053,13,0,0,15,15,0.0,1.0
6104,13,0,3,1,4,0.75,0.25
5943,13,0,0,9,9,0.0,1.0
6168,13,0,0,240,240,0.0,1.0
5989,13,0,0,6,6,0.0,1.0
5963,13,0,1,19,20,0.05,0.95
6194,13,0,0,80,80,0.0,1.0
6003,13,0,1,237,238,0.004201680672268907,0.9957983193277311
6167,13,0,2,8,10,0.2,0.8
6004,13,0,4,131,135,0.02962962962962963,0.9703703703703703
6054,13,0,0,14,14,0.0,1.0
6170,13,0,2,32,34,0.058823529411764705,0.9411764705882353
6063,13,0,4,6,10,0.4,0.6
5988,13,0,0,17,17,0.0,1.0
6075,13,0,1,11,12,0.08333333333333333,0.9166666666666666
6061,13,0,0,26,26,0.0,1.0
5965,13,0,0,45,45,0.0,1.0
6040,13,0,5,7,12,0.4166666666666667,0.5833333333333334
6106,13,0,0,30,30,0.0,1.0
6082,13,0,0,13,13,0.0,1.0
6031,13,0,1,24,25,0.04,0.96
6039,13,0,1,57,58,0.017241379310344827,0.9827586206896551
6189,14,0,1,21,22,0.045454545454545456,0.9545454545454546
5936,14,0,0,31,31,0.0,1.0
6087,14,0,0,18,18,0.0,1.0
5973,14,0,0,34,34,0.0,1.0
6085,14,0,0,34,34,0.0,1.0
5948,14,0,0,42,42,0.0,1.0
5974,14,0,0,10,10,0.0,1.0
6090,14,0,0,1,1,0.0,1.0
6068,14,0,0,35,35,0.0,1.0
6024,14,0,1,1,2,0.5,0.5
5976,14,0,5,75,80,0.0625,0.9375
5962,14,0,0,59,59,0.0,1.0
6033,14,0,2,22,24,0.08333333333333333,0.9166666666666666
6038,14,0,0,7,7,0.0,1.0
6042,14,0,0,49,49,0.0,1.0
5924,14,0,0,50,50,0.0,1.0
6083,14,0,3,9,12,0.25,0.75
6178,14,0,2,223,225,0.008888888888888889,0.9911111111111112
6086,14,0,0,25,25,0.0,1.0
5945,14,0,0,95,95,0.0,1.0
5925,14,0,0,122,122,0.0,1.0
5935,14,0,0,3,3,0.0,1.0
6073,14,0,1,6,7,0.14285714285714285,0.8571428571428571
5980,14,0,0,12,12,0.0,1.0
5993,14,0,0,24,24,0.0,1.0
5979,14,0,0,33,33,0.0,1.0
5966,14,0,1,25,26,0.038461538461538464,0.9615384615384616
5967,14,0,5,96,101,0.04950495049504951,0.9504950495049505
5970,14,0,0,14,14,0.0,1.0
6188,14,0,3,0,3,1.0,0.0
6096,14,0,1,0,1,1.0,0.0
6069,14,0,0,17,17,0.0,1.0
5937,14,0,0,6,6,0.0,1.0
5990,14,0,0,50,50,0.0,1.0
5928,14,0,0,22,22,0.0,1.0
6058,14,0,5,64,69,0.07246376811594203,0.927536231884058
6001,14,0,4,20,24,0.16666666666666666,0.8333333333333334
5964,14,0,3,7,10,0.3,0.7
5950,14,0,1,6,7,0.14285714285714285,0.8571428571428571
5991,14,0,0,20,20,0.0,1.0
6177,14,0,0,3,3,0.0,1.0
5961,14,0,0,45,45,0.0,1.0
5938,14,0,1,339,340,0.0029411764705882353,0.9970588235294118
5960,14,0,0,36,36,0.0,1.0
5947,14,0,0,78,78,0.0,1.0
5957,14,0,2,5,7,0.2857142857142857,0.7142857142857143
6043,14,0,0,29,29,0.0,1.0
6014,14,0,7,3,10,0.7,0.3
6015,14,0,1,1,2,0.5,0.5
5978,14,0,0,16,16,0.0,1.0
5986,14,0,3,1,4,0.75,0.25
5969,14,0,1,3,4,0.25,0.75
5949,14,0,0,30,30,0.0,1.0
5959,14,0,2,38,40,0.05,0.95
6051,14,0,0,108,108,0.0,1.0
6029,14,0,0,20,20,0.0,1.0
6070,14,0,4,0,4,1.0,0.0
5942,14,0,0,108,108,0.0,1.0
5953,14,0,0,28,28,0.0,1.0
6076,14,0,1,13,14,0.07142857142857142,0.9285714285714286
5940,14,0,4,5,9,0.4444444444444444,0.5555555555555556
6109,14,0,2,93,95,0.021052631578947368,0.9789473684210527
6187,14,0,2,4,6,0.3333333333333333,0.6666666666666666
6053,14,0,0,15,15,0.0,1.0
6104,14,0,3,1,4,0.75,0.25
5943,14,0,0,9,9,0.0,1.0
6168,14,0,0,240,240,0.0,1.0
5989,14,0,0,6,6,0.0,1.0
5963,14,0,2,18,20,0.1,0.9
6194,14,0,0,80,80,0.0,1.0
6003,14,0,2,236,238,0.008403361344537815,0.9915966386554622
6167,14,0,1,9,10,0.1,0.9
6004,14,0,3,132,135,0.022222222222222223,0.9777777777777777
6054,14,0,0,14,14,0.0,1.0
6170,14,0,1,33,34,0.029411764705882353,0.9705882352941176
6063,14,0,5,5,10,0.5,0.5
5988,14,0,0,17,17,0.0,1.0
6075,14,0,0,12,12,0.0,1.0
6061,14,0,0,26,26,0.0,1.0
5965,14,0,0,45,45,0.0,1.0
6040,14,0,5,7,12,0.4166666666666667,0.5833333333333334
6106,14,0,1,29,30,0.03333333333333333,0.9666666666666667
6082,14,0,2,11,13,0.15384615384615385,0.8461538461538461
6031,14,0,0,25,25,0.0,1.0
6039,14,0,0,58,58,0.0,1.0
6189,15,0,5,17,22,0.22727272727272727,0.7727272727272727
5936,15,0,0,31,31,0.0,1.0
6087,15,0,0,18,18,0.0,1.0
5973,15,0,0,34,34,0.0,1.0
6085,15,0,0,34,34,0.0,1.0
5948,15,0,0,42,42,0.0,1.0
5974,15,0,0,10,10,0.0,1.0
6090,15,0,0,1,1,0.0,1.0
6068,15,0,0,35,35,0.0,1.0
6024,15,0,1,1,2,0.5,0.5
5976,15,0,3,77,80,0.0375,0.9625
5962,15,0,0,59,59,0.0,1.0
6033,15,0,0,24,24,0.0,1.0
6038,15,0,0,7,7,0.0,1.0
6042,15,0,0,49,49,0.0,1.0
5924,15,0,0,50,50,0.0,1.0
6083,15,0,1,11,12,0.08333333333333333,0.9166666666666666
6178,15,0,0,225,225,0.0,1.0
6086,15,0,0,25,25,0.0,1.0
5945,15,0,0,95,95,0.0,1.0
5925,15,0,0,122,122,0.0,1.0
5935,15,0,0,3,3,0.0,1.0
6073,15,0,1,6,7,0.14285714285714285,0.8571428571428571
5980,15,0,2,10,12,0.16666666666666666,0.8333333333333334
5993,15,0,0,24,24,0.0,1.0
5979,15,0,0,33,33,0.0,1.0
5966,15,0,1,25,26,0.038461538461538464,0.9615384615384616
5967,15,0,2,99,101,0.019801980198019802,0.9801980198019802
5970,15,0,0,14,14,0.0,1.0
6188,15,0,2,1,3,0.6666666666666666,0.3333333333333333
6096,15,0,1,0,1,1.0,0.0
6069,15,0,0,17,17,0.0,1.0
5937,15,0,0,6,6,0.0,1.0
5990,15,0,0,50,50,0.0,1.0
5928,15,0,0,22,22,0.0,1.0
6058,15,0,4,65,69,0.057971014492753624,0.9420289855072463
6001,15,0,1,23,24,0.041666666666666664,0.9583333333333334
5964,15,0,1,9,10,0.1,0.9
5950,15,0,1,6,7,0.14285714285714285,0.8571428571428571
5991,15,0,0,20,20,0.0,1.0
6177,15,0,0,3,3,0.0,1.0
5961,15,0,0,45,45,0.0,1.0
5938,15,0,3,337,340,0.008823529411764706,0.9911764705882353
5960,15,0,0,36,36,0.0,1.0
5947,15,0,0,78,78,0.0,1.0
5957,15,0,2,5,7,0.2857142857142857,0.7142857142857143
6043,15,0,0,29,29,0.0,1.0
6014,15,0,10,0,10,1.0,0.0
6015,15,0,1,1,2,0.5,0.5
5978,15,0,2,14,16,0.125,0.875
5986,15,0,3,1,4,0.75,0.25
5969,15,0,0,4,4,0.0,1.0
5949,15,0,0,30,30,0.0,1.0
5959,15,0,0,40,40,0.0,1.0
6051,15,0,0,108,108,0.0,1.0
6029,15,0,0,20,20,0.0,1.0
6070,15,0,3,1,4,0.75,0.25
5942,15,0,0,108,108,0.0,1.0
5953,15,0,0,28,28,0.0,1.0
6076,15,0,2,12,14,0.14285714285714285,0.8571428571428571
5940,15,0,2,7,9,0.2222222222222222,0.7777777777777778
6109,15,0,3,92,95,0.031578947368421054,0.968421052631579
6187,15,0,2,4,6,0.3333333333333333,0.6666666666666666
6053,15,0,0,15,15,0.0,1.0
6104,15,0,3,1,4,0.75,0.25
5943,15,0,0,9,9,0.0,1.0
6168,15,0,0,240,240,0.0,1.0
5989,15,0,0,6,6,0.0,1.0
5963,15,0,2,18,20,0.1,0.9
6194,15,0,0,80,80,0.0,1.0
6003,15,0,1,237,238,0.004201680672268907,0.9957983193277311
6167,15,0,1,9,10,0.1,0.9
6004,15,0,2,133,135,0.014814814814814815,0.9851851851851852
6054,15,0,0,14,14,0.0,1.0
6170,15,0,4,30,34,0.11764705882352941,0.8823529411764706
6063,15,0,4,6,10,0.4,0.6
5988,15,0,0,17,17,0.0,1.0
6075,15,0,2,10,12,0.16666666666666666,0.8333333333333334
6061,15,0,0,26,26,0.0,1.0
5965,15,0,0,45,45,0.0,1.0
6040,15,0,8,4,12,0.6666666666666666,0.3333333333333333
6106,15,0,2,28,30,0.06666666666666667,0.9333333333333333
6082,15,0,0,13,13,0.0,1.0
6031,15,0,1,24,25,0.04,0.96
6039,15,0,0,58,58,0.0,1.0
6189,16,0,1,21,22,0.045454545454545456,0.9545454545454546
5936,16,0,0,31,31,0.0,1.0
6087,16,0,0,18,18,0.0,1.0
5973,16,0,0,34,34,0.0,1.0
6085,16,0,0,34,34,0.0,1.0
5948,16,0,1,41,42,0.023809523809523808,0.9761904761904762
5974,16,0,0,10,10,0.0,1.0
6090,16,0,0,1,1,0.0,1.0
6068,16,0,0,35,35,0.0,1.0
6024,16,0,1,1,2,0.5,0.5
5976,16,0,0,80,80,0.0,1.0
5962,16,0,0,59,59,0.0,1.0
6033,16,0,4,20,24,0.16666666666666666,0.8333333333333334
6038,16,0,0,7,7,0.0,1.0
6042,16,0,0,49,49,0.0,1.0
5924,16,0,0,50,50,0.0,1.0
6083,16,0,1,11,12,0.08333333333333333,0.9166666666666666
6178,16,0,0,225,225,0.0,1.0
6086,16,0,0,25,25,0.0,1.0
5945,16,0,0,95,95,0.0,1.0
5925,16,0,0,122,122,0.0,1.0
5935,16,0,0,3,3,0.0,1.0
6073,16,0,0,7,7,0.0,1.0
5980,16,0,2,10,12,0.16666666666666666,0.8333333333333334
5993,16,0,0,24,24,0.0,1.0
5979,16,0,0,33,33,0.0,1.0
5966,16,0,1,25,26,0.038461538461538464,0.9615384615384616
5967,16,0,3,98,101,0.0297029702970297,0.9702970297029703
5970,16,0,0,14,14,0.0,1.0
6188,16,0,2,1,3,0.6666666666666666,0.3333333333333333
6096,16,0,1,0,1,1.0,0.0
6069,16,0,0,17,17,0.0,1.0
5937,16,0,0,6,6,0.0,1.0
5990,16,0,0,50,50,0.0,1.0
5928,16,0,0,22,22,0.0,1.0
6058,16,0,2,67,69,0.028985507246376812,0.9710144927536232
6001,16,0,3,21,24,0.125,0.875
5964,16,0,1,9,10,0.1,0.9
5950,16,0,1,6,7,0.14285714285714285,0.8571428571428571
5991,16,0,0,20,20,0.0,1.0
6177,16,0,0,3,3,0.0,1.0
5961,16,0,0,45,45,0.0,1.0
5938,16,0,2,338,340,0.0058823529411764705,0.9941176470588236
5960,16,0,0,36,36,0.0,1.0
5947,16,0,0,78,78,0.0,1.0
5957,16,0,3,4,7,0.42857142857142855,0.5714285714285714
6043,16,0,0,29,29,0.0,1.0
6014,16,0,8,2,10,0.8,0.2
6015,16,0,1,1,2,0.5,0.5
5978,16,0,1,15,16,0.0625,0.9375
5986,16,0,2,2,4,0.5,0.5
5969,16,0,1,3,4,0.25,0.75
5949,16,0,0,30,30,0.0,1.0
5959,16,0,3,37,40,0.075,0.925
6051,16,0,0,108,108,0.0,1.0
6029,16,0,1,19,20,0.05,0.95
6070,16,0,3,1,4,0.75,0.25
5942,16,0,0,108,108,0.0,1.0
5953,16,0,0,28,28,0.0,1.0
6076,16,0,1,13,14,0.07142857142857142,0.9285714285714286
5940,16,0,5,4,9,0.5555555555555556,0.4444444444444444
6109,16,0,1,94,95,0.010526315789473684,0.9894736842105263
6187,16,0,2,4,6,0.3333333333333333,0.6666666666666666
6053,16,0,0,15,15,0.0,1.0
6104,16,0,2,2,4,0.5,0.5
5943,16,0,0,9,9,0.0,1.0
6168,16,0,0,240,240,0.0,1.0
5989,16,0,0,6,6,0.0,1.0
5963,16,0,2,18,20,0.1,0.9
6194,16,0,0,80,80,0.0,1.0
6003,16,0,1,237,238,0.004201680672268907,0.9957983193277311
6167,16,0,2,8,10,0.2,0.8
6004,16,0,1,134,135,0.007407407407407408,0.9925925925925926
6054,16,0,0,14,14,0.0,1.0
6170,16,0,5,29,34,0.14705882352941177,0.8529411764705882
6063,16,0,4,6,10,0.4,0.6
5988,16,0,0,17,17,0.0,1.0
6075,16,0,1,11,12,0.08333333333333333,0.9166666666666666
6061,16,0,0,26,26,0.0,1.0
5965,16,0,0,45,45,0.0,1.0
6040,16,0,8,4,12,0.6666666666666666,0.3333333333333333
6106,16,0,0,30,30,0.0,1.0
6082,16,0,0,13,13,0.0,1.0
6031,16,0,2,23,25,0.08,0.92
6039,16,0,1,57,58,0.017241379310344827,0.9827586206896551
6189,17,0,2,20,22,0.09090909090909091,0.9090909090909091
5936,17,0,0,31,31,0.0,1.0
6087,17,0,0,18,18,0.0,1.0
5973,17,0,0,34,34,0.0,1.0
6085,17,0,0,34,34,0.0,1.0
5948,17,0,1,41,42,0.023809523809523808,0.9761904761904762
5974,17,0,0,10,10,0.0,1.0
6090,17,0,0,1,1,0.0,1.0
6068,17,0,0,35,35,0.0,1.0
6024,17,0,2,0,2,1.0,0.0
5976,17,0,1,79,80,0.0125,0.9875
5962,17,0,0,59,59,0.0,1.0
6033,17,0,2,22,24,0.08333333333333333,0.9166666666666666
6038,17,0,0,7,7,0.0,1.0
6042,17,0,0,49,49,0.0,1.0
5924,17,0,0,50,50,0.0,1.0
6083,17,0,2,10,12,0.16666666666666666,0.8333333333333334
6178,17,0,0,225,225,0.0,1.0
6086,17,0,0,25,25,0.0,1.0
5945,17,0,0,95,95,0.0,1.0
5925,17,0,0,122,122,0.0,1.0
5935,17,0,0,3,3,0.0,1.0
6073,17,0,0,7,7,0.0,1.0
5980,17,0,0,12,12,0.0,1.0
5993,17,0,0,24,24,0.0,1.0
5979,17,0,0,33,33,0.0,1.0
5966,17,0,4,22,26,0.15384615384615385,0.8461538461538461
5967,17,0,3,98,101,0.0297029702970297,0.9702970297029703
5970,17,0,0,14,14,0.0,1.0
6188,17,0,2,1,3,0.6666666666666666,0.3333333333333333
6096,17,0,1,0,1,1.0,0.0
6069,17,0,0,17,17,0.0,1.0
5937,17,0,0,6,6,0.0,1.0
5990,17,0,0,50,50,0.0,1.0
5928,17,0,0,22,22,0.0,1.0
6058,17,0,6,63,69,0.08695652173913043,0.9130434782608695
6001,17,0,4,20,24,0.16666666666666666,0.8333333333333334
5964,17,0,0,10,10,0.0,1.0
5950,17,0,1,6,7,0.14285714285714285,0.8571428571428571
5991,17,0,0,20,20,0.0,1.0
6177,17,0,0,3,3,0.0,1.0
5961,17,0,0,45,45,0.0,1.0
5938,17,0,0,340,340,0.0,1.0
5960,17,0,0,36,36,0.0,1.0
5947,17,0,0,78,78,0.0,1.0
5957,17,0,3,4,7,0.42857142857142855,0.5714285714285714
6043,17,0,0,29,29,0.0,1.0
6014,17,0,8,2,10,0.8,0.2
6015,17,0,2,0,2,1.0,0.0
5978,17,0,2,14,16,0.125,0.875
5986,17,0,2,2,4,0.5,0.5
5969,17,0,0,4,4,0.0,1.0
5949,17,0,0,30,30,0.0,1.0
5959,17,0,3,37,40,0.075,0.925
6051,17,0,0,108,108,0.0,1.0
6029,17,0,0,20,20,0.0,1.0
6070,17,0,3,1,4,0.75,0.25
5942,17,0,0,108,108,0.0,1.0
5953,17,0,0,28,28,0.0,1.0
6076,17,0,0,14,14,0.0,1.0
5940,17,0,5,4,9,0.5555555555555556,0.4444444444444444
6109,17,0,3,92,95,0.031578947368421054,0.968421052631579
6187,17,0,0,6,6,0.0,1.0
6053,17,0,0,15,15,0.0,1.0
6104,17,0,4,0,4,1.0,0.0
5943,17,0,0,9,9,0.0,1.0
6168,17,0,0,240,240,0.0,1.0
5989,17,0,0,6,6,0.0,1.0
5963,17,0,1,19,20,0.05,0.95
6194,17,0,0,80,80,0.0,1.0
6003,17,0,0,238,238,0.0,1.0
6167,17,0,1,9,10,0.1,0.9
6004,17,0,2,133,135,0.014814814814814815,0.9851851851851852
6054,17,0,0,14,14,0.0,1.0
6170,17,0,2,32,34,0.058823529411764705,0.9411764705882353
6063,17,0,3,7,10,0.3,0.7
5988,17,0,0,17,17,0.0,1.0
6075,17,0,1,11,12,0.08333333333333333,0.9166666666666666
6061,17,0,0,26,26,0.0,1.0
5965,17,0,0,45,45,0.0,1.0
6040,17,0,5,7,12,0.4166666666666667,0.5833333333333334
6106,17,0,2,28,30,0.06666666666666667,0.9333333333333333
6082,17,0,2,11,13,0.15384615384615385,0.8461538461538461
6031,17,0,1,24,25,0.04,0.96
6039,17,0,0,58,58,0.0,1.0
6189,18,0,3,19,22,0.13636363636363635,0.8636363636363636
5936,18,0,0,31,31,0.0,1.0
6087,18,0,0,18,18,0.0,1.0
5973,18,0,0,34,34,0.0,1.0
6085,18,0,0,34,34,0.0,1.0
5948,18,0,0,42,42,0.0,1.0
5974,18,0,0,10,10,0.0,1.0
6090,18,0,0,1,1,0.0,1.0
6068,18,0,0,35,35,0.0,1.0
6024,18,0,2,0,2,1.0,0.0
5976,18,0,2,78,80,0.025,0.975
5962,18,0,0,59,59,0.0,1.0
6033,18,0,4,20,24,0.16666666666666666,0.8333333333333334
6038,18,0,0,7,7,0.0,1.0
6042,18,0,0,49,49,0.0,1.0
5924,18,0,0,50,50,0.0,1.0
6083,18,0,1,11,12,0.08333333333333333,0.9166666666666666
6178,18,0,0,225,225,0.0,1.0
6086,18,0,0,25,25,0.0,1.0
5945,18,0,0,95,95,0.0,1.0
5925,18,0,0,122,122,0.0,1.0
5935,18,0,0,3,3,0.0,1.0
6073,18,0,0,7,7,0.0,1.0
5980,18,0,0,12,12,0.0,1.0
5993,18,0,0,24,24,0.0,1.0
5979,18,0,0,33,33,0.0,1.0
5966,18,0,2,24,26,0.07692307692307693,0.9230769230769231
5967,18,0,5,96,101,0.04950495049504951,0.9504950495049505
5970,18,0,0,14,14,0.0,1.0
6188,18,0,1,2,3,0.3333333333333333,0.6666666666666666
6096,18,0,1,0,1,1.0,0.0
6069,18,0,0,17,17,0.0,1.0
5937,18,0,0,6,6,0.0,1.0
5990,18,0,0,50,50,0.0,1.0
5928,18,0,0,22,22,0.0,1.0
6058,18,0,4,65,69,0.057971014492753624,0.9420289855072463
6001,18,0,5,19,24,0.20833333333333334,0.7916666666666666
5964,18,0,1,9,10,0.1,0.9
5950,18,0,0,7,7,0.0,1.0
5991,18,0,0,20,20,0.0,1.0
6177,18,0,0,3,3,0.0,1.0
5961,18,0,0,45,45,0.0,1.0
5938,18,0,3,337,340,0.008823529411764706,0.9911764705882353
5960,18,0,0,36,36,0.0,1.0
5947,18,0,0,78,78,0.0,1.0
5957,18,0,2,5,7,0.2857142857142857,0.7142857142857143
6043,18,0,0,29,29,0.0,1.0
6014,18,0,6,4,10,0.6,0.4
6015,18,0,1,1,2,0.5,0.5
5978,18,0,3,13,16,0.1875,0.8125
5986,18,0,1,3,4,0.25,0.75
5969,18,0,0,4,4,0.0,1.0
5949,18,0,0,30,30,0.0,1.0
5959,18,0,2,38,40,0.05,0.95
6051,18,0,0,108,108,0.0,1.0
6029,18,0,0,20,20,0.0,1.0
6070,18,0,3,1,4,0.75,0.25
5942,18,0,0,108,108,0.0,1.0
5953,18,0,0,28,28,0.0,1.0
6076,18,0,1,13,14,0.07142857142857142,0.9285714285714286
5940,18,0,2,7,9,0.2222222222222222,0.7777777777777778
6109,18,0,1,94,95,0.010526315789473684,0.9894736842105263
6187,18,0,0,6,6,0.0,1.0
6053,18,0,0,15,15,0.0,1.0
6104,18,0,4,0,4,1.0,0.0
5943,18,0,0,9,9,0.0,1.0
6168,18,0,0,240,240,0.0,1.0
5989,18,0,0,6,6,0.0,1.0
5963,18,0,2,18,20,0.1,0.9
6194,18,0,0,80,80,0.0,1.0
6003,18,0,1,237,238,0.004201680672268907,0.9957983193277311
6167,18,0,2,8,10,0.2,0.8
6004,18,0,2,133,135,0.014814814814814815,0.9851851851851852
6054,18,0,0,14,14,0.0,1.0
6170,18,0,0,34,34,0.0,1.0
6063,18,0,3,7,10,0.3,0.7
5988,18,0,0,17,17,0.0,1.0
6075,18,0,1,11,12,0.08333333333333333,0.9166666666666666
6061,18,0,0,26,26,0.0,1.0
5965,18,0,0,45,45,0.0,1.0
6040,18,0,4,8,12,0.3333333333333333,0.6666666666666666
6106,18,0,2,28,30,0.06666666666666667,0.9333333333333333
6082,18,0,0,13,13,0.0,1.0
6031,18,0,0,25,25,0.0,1.0
6039,18,0,3,55,58,0.05172413793103448,0.9482758620689655
6189,19,0,2,20,22,0.09090909090909091,0.9090909090909091
5936,19,0,0,31,31,0.0,1.0
6087,19,0,0,18,18,0.0,1.0
5973,19,0,0,34,34,0.0,1.0
6085,19,0,0,34,34,0.0,1.0
5948,19,0,0,42,42,0.0,1.0
5974,19,0,0,10,10,0.0,1.0
6090,19,0,0,1,1,0.0,1.0
6068,19,0,0,35,35,0.0,1.0
6024,19,0,2,0,2,1.0,0.0
5976,19,0,2,78,80,0.025,0.975
5962,19,0,0,59,59,0.0,1.0
6033,19,0,2,22,24,0.08333333333333333,0.9166666666666666
6038,19,0,0,7,7,0.0,1.0
6042,19,0,0,49,49,0.0,1.0
5924,19,0,0,50,50,0.0,1.0
6083,19,0,2,10,12,0.16666666666666666,0.8333333333333334
6178,19,0,0,225,225,0.0,1.0
6086,19,0,0,25,25,0.0,1.0
5945,19,0,0,95,95,0.0,1.0
5925,19,0,0,122,122,0.0,1.0
5935,19,0,0,3,3,0.0,1.0
6073,19,0,0,7,7,0.0,1.0
5980,19,0,0,12,12,0.0,1.0
5993,19,0,0,24,24,0.0,1.0
5979,19,0,0,33,33,0.0,1.0
5966,19,0,2,24,26,0.07692307692307693,0.9230769230769231
5967,19,0,3,98,101,0.0297029702970297,0.9702970297029703
5970,19,0,0,14,14,0.0,1.0
6188,19,0,1,2,3,0.3333333333333333,0.6666666666666666
6096,19,0,1,0,1,1.0,0.0
6069,19,0,0,17,17,0.0,1.0
5937,19,0,0,6,6,0.0,1.0
5990,19,0,0,50,50,0.0,1.0
5928,19,0,0,22,22,0.0,1.0
6058,19,0,2,67,69,0.028985507246376812,0.9710144927536232
6001,19,0,2,22,24,0.08333333333333333,0.9166666666666666
5964,19,0,0,10,10,0.0,1.0
5950,19,0,0,7,7,0.0,1.0
5991,19,0,0,20,20,0.0,1.0
6177,19,0,0,3,3,0.0,1.0
5961,19,0,0,45,45,0.0,1.0
5938,19,0,0,340,340,0.0,1.0
5960,19,0,0,36,36,0.0,1.0
5947,19,0,0,78,78,0.0,1.0
5957,19,0,1,6,7,0.14285714285714285,0.8571428571428571
6043,19,0,0,29,29,0.0,1.0
6014,19,0,7,3,10,0.7,0.3
6015,19,0,1,1,2,0.5,0.5
5978,19,0,2,14,16,0.125,0.875
5986,19,0,2,2,4,0.5,0.5
5969,19,0,0,4,4,0.0,1.0
5949,19,0,0,30,30,0.0,1.0
5959,19,0,2,38,40,0.05,0.95
6051,19,0,0,108,108,0.0,1.0
6029,19,0,1,19,20,0.05,0.95
6070,19,0,3,1,4,0.75,0.25
5942,19,0,0,108,108,0.0,1.0
5953,19,0,0,28,28,0.0,1.0
6076,19,0,1,13,14,0.07142857142857142,0.9285714285714286
5940,19,0,3,6,9,0.3333333333333333,0.6666666666666666
6109,19,0,2,93,95,0.021052631578947368,0.9789473684210527
6187,19,0,0,6,6,0.0,1.0
6053,19,0,0,15,15,0.0,1.0
6104,19,0,3,1,4,0.75,0.25
5943,19,0,0,9,9,0.0,1.0
6168,19,0,0,240,240,0.0,1.0
5989,19,0,0,6,6,0.0,1.0
5963,19,0,0,20,20,0.0,1.0
6194,19,0,0,80,80,0.0,1.0
6003,19,0,1,237,238,0.004201680672268907,0.9957983193277311
6167,19,0,1,9,10,0.1,0.9
6004,19,0,1,134,135,0.007407407407407408,0.9925925925925926
6054,19,0,0,14,14,0.0,1.0
6170,19,0,4,30,34,0.11764705882352941,0.8823529411764706
6063,19,0,3,7,10,0.3,0.7
5988,19,0,0,17,17,0.0,1.0
6075,19,0,1,11,12,0.08333333333333333,0.9166666666666666
6061,19,0,0,26,26,0.0,1.0
5965,19,0,0,45,45,0.0,1.0
6040,19,0,6,6,12,0.5,0.5
6106,19,0,0,30,30,0.0,1.0
6082,19,0,0,13,13,0.0,1.0
6031,19,0,0,25,25,0.0,1.0
6039,19,0,4,54,58,0.06896551724137931,0.9310344827586207
6189,20,0,0,22,22,0.0,1.0
5936,20,0,0,31,31,0.0,1.0
6087,20,0,0,18,18,0.0,1.0
5973,20,0,0,34,34,0.0,1.0
6085,20,0,0,34,34,0.0,1.0
5948,20,0,0,42,42,0.0,1.0
5974,20,0,0,10,10,0.0,1.0
6090,20,0,0,1,1,0.0,1.0
6068,20,0,0,35,35,0.0,1.0
6024,20,0,1,1,2,0.5,0.5
5976,20,0,1,79,80,0.0125,0.9875
5962,20,0,0,59,59,0.0,1.0
6033,20,0,2,22,24,0.08333333333333333,0.9166666666666666
6038,20,0,0,7,7,0.0,1.0
6042,20,0,0,49,49,0.0,1.0
5924,20,0,0,50,50,0.0,1.0
6083,20,0,1,11,12,0.08333333333333333,0.9166666666666666
6178,20,0,1,224,225,0.0044444444444444444,0.9955555555555555
6086,20,0,0,25,25,0.0,1.0
5945,20,0,0,95,95,0.0,1.0
5925,20,0,0,122,122,0.0,1.0
5935,20,0,0,3,3,0.0,1.0
6073,20,0,3,4,7,0.42857142857142855,0.5714285714285714
5980,20,0,0,12,12,0.0,1.0
5993,20,0,0,24,24,0.0,1.0
5979,20,0,0,33,33,0.0,1.0
5966,20,0,2,24,26,0.07692307692307693,0.9230769230769231
5967,20,0,1,100,101,0.009900990099009901,0.9900990099009901
5970,20,0,0,14,14,0.0,1.0
6188,20,0,0,3,3,0.0,1.0
6096,20,0,1,0,1,1.0,0.0
6069,20,0,0,17,17,0.0,1.0
5937,20,0,0,6,6,0.0,1.0
5990,20,0,0,50,50,0.0,1.0
5928,20,0,0,22,22,0.0,1.0
6058,20,0,1,68,69,0.014492753623188406,0.9855072463768116
6001,20,0,1,23,24,0.041666666666666664,0.9583333333333334
5964,20,0,0,10,10,0.0,1.0
5950,20,0,1,6,7,0.14285714285714285,0.8571428571428571
5991,20,0,0,20,20,0.0,1.0
6177,20,0,0,3,3,0.0,1.0
5961,20,0,0,45,45,0.0,1.0
5938,20,0,0,340,340,0.0,1.0
5960,20,0,0,36,36,0.0,1.0
5947,20,0,0,78,78,0.0,1.0
5957,20,0,2,5,7,0.2857142857142857,0.7142857142857143
6043,20,0,0,29,29,0.0,1.0
6014,20,0,8,2,10,0.8,0.2
6015,20,0,1,1,2,0.5,0.5
5978,20,0,1,15,16,0.0625,0.9375
5986,20,0,2,2,4,0.5,0.5
5969,20,0,0,4,4,0.0,1.0
5949,20,0,0,30,30,0.0,1.0
5959,20,0,1,39,40,0.025,0.975
6051,20,0,0,108,108,0.0,1.0
6029,20,0,1,19,20,0.05,0.95
6070,20,0,2,2,4,0.5,0.5
5942,20,0,0,108,108,0.0,1.0
5953,20,0,0,28,28,0.0,1.0
6076,20,0,1,13,14,0.07142857142857142,0.9285714285714286
5940,20,0,3,6,9,0.3333333333333333,0.6666666666666666
6109,20,0,3,92,95,0.031578947368421054,0.968421052631579
6187,20,0,2,4,6,0.3333333333333333,0.6666666666666666
6053,20,0,4,11,15,0.26666666666666666,0.7333333333333333
6104,20,0,3,1,4,0.75,0.25
5943,20,0,0,9,9,0.0,1.0
6168,20,0,0,240,240,0.0,1.0
5989,20,0,0,6,6,0.0,1.0
5963,20,0,0,20,20,0.0,1.0
6194,20,0,0,80,80,0.0,1.0
6003,20,0,0,238,238,0.0,1.0
6167,20,0,1,9,10,0.1,0.9
6004,20,0,0,135,135,0.0,1.0
6054,20,0,0,14,14,0.0,1.0
6170,20,0,9,25,34,0.2647058823529412,0.7352941176470589
6063,20,0,1,9,10,0.1,0.9
5988,20,0,0,17,17,0.0,1.0
6075,20,0,1,11,12,0.08333333333333333,0.9166666666666666
6061,20,0,0,26,26,0.0,1.0
5965,20,0,0,45,45,0.0,1.0
6040,20,0,5,7,12,0.4166666666666667,0.5833333333333334
6106,20,0,1,29,30,0.03333333333333333,0.9666666666666667
6082,20,0,0,13,13,0.0,1.0
6031,20,0,0,25,25,0.0,1.0
6039,20,0,0,58,58,0.0,1.0
6189,21,0,0,22,22,0.0,1.0
5936,21,0,0,31,31,0.0,1.0
6087,21,0,0,18,18,0.0,1.0
5973,21,0,0,34,34,0.0,1.0
6085,21,0,0,34,34,0.0,1.0
5948,21,0,0,42,42,0.0,1.0
5974,21,0,0,10,10,0.0,1.0
6090,21,0,0,1,1,0.0,1.0
6068,21,0,0,35,35,0.0,1.0
6024,21,0,1,1,2,0.5,0.5
5976,21,0,0,80,80,0.0,1.0
5962,21,0,0,59,59,0.0,1.0
6033,21,0,6,18,24,0.25,0.75
6038,21,0,0,7,7,0.0,1.0
6042,21,0,0,49,49,0.0,1.0
5924,21,0,0,50,50,0.0,1.0
6083,21,0,3,9,12,0.25,0.75
6178,21,0,0,225,225,0.0,1.0
6086,21,0,0,25,25,0.0,1.0
5945,21,0,0,95,95,0.0,1.0
5925,21,0,0,122,122,0.0,1.0
5935,21,0,0,3,3,0.0,1.0
6073,21,0,2,5,7,0.2857142857142857,0.7142857142857143
5980,21,0,0,12,12,0.0,1.0
5993,21,0,0,24,24,0.0,1.0
5979,21,0,0,33,33,0.0,1.0
5966,21,0,0,26,26,0.0,1.0
5967,21,0,2,99,101,0.019801980198019802,0.9801980198019802
5970,21,0,0,14,14,0.0,1.0
6188,21,0,3,0,3,1.0,0.0
6096,21,0,1,0,1,1.0,0.0
6069,21,0,0,17,17,0.0,1.0
5937,21,0,0,6,6,0.0,1.0
5990,21,0,0,50,50,0.0,1.0
5928,21,0,0,22,22,0.0,1.0
6058,21,0,3,66,69,0.043478260869565216,0.9565217391304348
6001,21,0,2,22,24,0.08333333333333333,0.9166666666666666
5964,21,0,0,10,10,0.0,1.0
5950,21,0,1,6,7,0.14285714285714285,0.8571428571428571
5991,21,0,0,20,20,0.0,1.0
6177,21,0,0,3,3,0.0,1.0
5961,21,0,0,45,45,0.0,1.0
5938,21,0,0,340,340,0.0,1.0
5960,21,0,0,36,36,0.0,1.0
5947,21,0,0,78,78,0.0,1.0
5957,21,0,3,4,7,0.42857142857142855,0.5714285714285714
6043,21,0,0,29,29,0.0,1.0
6014,21,0,5,5,10,0.5,0.5
6015,21,0,2,0,2,1.0,0.0
5978,21,0,1,15,16,0.0625,0.9375
5986,21,0,2,2,4,0.5,0.5
5969,21,0,0,4,4,0.0,1.0
5949,21,0,3,27,30,0.1,0.9
5959,21,0,1,39,40,0.025,0.975
6051,21,0,0,108,108,0.0,1.0
6029,21,0,0,20,20,0.0,1.0
6070,21,0,2,2,4,0.5,0.5
5942,21,0,0,108,108,0.0,1.0
5953,21,0,0,28,28,0.0,1.0
6076,21,0,0,14,14,0.0,1.0
5940,21,0,5,4,9,0.5555555555555556,0.4444444444444444
6109,21,0,2,93,95,0.021052631578947368,0.9789473684210527
6187,21,0,0,6,6,0.0,1.0
6053,21,0,0,15,15,0.0,1.0
6104,21,0,2,2,4,0.5,0.5
5943,21,0,0,9,9,0.0,1.0
6168,21,0,0,240,240,0.0,1.0
5989,21,0,0,6,6,0.0,1.0
5963,21,0,0,20,20,0.0,1.0
6194,21,0,0,80,80,0.0,1.0
6003,21,0,0,238,238,0.0,1.0
6167,21,0,0,10,10,0.0,1.0
6004,21,0,0,135,135,0.0,1.0
6054,21,0,0,14,14,0.0,1.0
6170,21,0,1,33,34,0.029411764705882353,0.9705882352941176
6063,21,0,2,8,10,0.2,0.8
5988,21,0,0,17,17,0.0,1.0
6075,21,0,1,11,12,0.08333333333333333,0.9166666666666666
6061,21,0,0,26,26,0.0,1.0
5965,21,0,0,45,45,0.0,1.0
6040,21,0,4,8,12,0.3333333333333333,0.6666666666666666
6106,21,0,1,29,30,0.03333333333333333,0.9666666666666667
6082,21,0,0,13,13,0.0,1.0
6031,21,0,1,24,25,0.04,0.96
6039,21,0,0,58,58,0.0,1.0
6189,22,0,1,21,22,0.045454545454545456,0.9545454545454546
5936,22,0,0,31,31,0.0,1.0
6087,22,0,0,18,18,0.0,1.0
5973,22,0,0,34,34,0.0,1.0
6085,22,0,0,34,34,0.0,1.0
5948,22,0,0,42,42,0.0,1.0
5974,22,0,0,10,10,0.0,1.0
6090,22,0,0,1,1,0.0,1.0
6068,22,0,0,35,35,0.0,1.0
6024,22,0,2,0,2,1.0,0.0
5976,22,0,1,79,80,0.0125,0.9875
5962,22,0,0,59,59,0.0,1.0
6033,22,0,5,19,24,0.20833333333333334,0.7916666666666666
6038,22,0,0,7,7,0.0,1.0
6042,22,0,0,49,49,0.0,1.0
5924,22,0,0,50,50,0.0,1.0
6083,22,0,3,9,12,0.25,0.75
6178,22,0,0,225,225,0.0,1.0
6086,22,0,0,25,25,0.0,1.0
5945,22,0,0,95,95,0.0,1.0
5925,22,0,0,122,122,0.0,1.0
5935,22,0,0,3,3,0.0,1.0
6073,22,0,1,6,7,0.14285714285714285,0.8571428571428571
5980,22,0,0,12,12,0.0,1.0
5993,22,0,0,24,24,0.0,1.0
5979,22,0,0,33,33,0.0,1.0
5966,22,0,0,26,26,0.0,1.0
5967,22,0,1,100,101,0.009900990099009901,0.9900990099009901
5970,22,0,0,14,14,0.0,1.0
6188,22,0,0,3,3,0.0,1.0
6096,22,0,1,0,1,1.0,0.0
6069,22,0,0,17,17,0.0,1.0
5937,22,0,0,6,6,0.0,1.0
5990,22,0,0,50,50,0.0,1.0
5928,22,0,0,22,22,0.0,1.0
6058,22,0,0,69,69,0.0,1.0
6001,22,0,2,22,24,0.08333333333333333,0.9166666666666666
5964,22,0,0,10,10,0.0,1.0
5950,22,0,2,5,7,0.2857142857142857,0.7142857142857143
5991,22,0,0,20,20,0.0,1.0
6177,22,0,0,3,3,0.0,1.0
5961,22,0,0,45,45,0.0,1.0
5938,22,0,0,340,340,0.0,1.0
5960,22,0,0,36,36,0.0,1.0
5947,22,0,0,78,78,0.0,1.0
5957,22,0,0,7,7,0.0,1.0
6043,22,0,0,29,29,0.0,1.0
6014,22,0,6,4,10,0.6,0.4
6015,22,0,1,1,2,0.5,0.5
5978,22,0,2,14,16,0.125,0.875
5986,22,0,2,2,4,0.5,0.5
5969,22,0,0,4,4,0.0,1.0
5949,22,0,0,30,30,0.0,1.0
5959,22,0,1,39,40,0.025,0.975
6051,22,0,0,108,108,0.0,1.0
6029,22,0,0,20,20,0.0,1.0
6070,22,0,1,3,4,0.25,0.75
5942,22,0,0,108,108,0.0,1.0
5953,22,0,0,28,28,0.0,1.0
6076,22,0,1,13,14,0.07142857142857142,0.9285714285714286
5940,22,0,4,5,9,0.4444444444444444,0.5555555555555556
6109,22,0,1,94,95,0.010526315789473684,0.9894736842105263
6187,22,0,2,4,6,0.3333333333333333,0.6666666666666666
6053,22,0,0,15,15,0.0,1.0
6104,22,0,2,2,4,0.5,0.5
5943,22,0,0,9,9,0.0,1.0
6168,22,0,0,240,240,0.0,1.0
5989,22,0,0,6,6,0.0,1.0
5963,22,0,0,20,20,0.0,1.0
6194,22,0,0,80,80,0.0,1.0
6003,22,0,0,238,238,0.0,1.0
6167,22,0,2,8,10,0.2,0.8
6004,22,0,1,134,135,0.007407407407407408,0.9925925925925926
6054,22,0,0,14,14,0.0,1.0
6170,22,0,0,34,34,0.0,1.0
6063,22,0,2,8,10,0.2,0.8
5988,22,0,0,17,17,0.0,1.0
6075,22,0,1,11,12,0.08333333333333333,0.9166666666666666
6061,22,0,0,26,26,0.0,1.0
5965,22,0,0,45,45,0.0,1.0
6040,22,0,8,4,12,0.6666666666666666,0.3333333333333333
6106,22,0,0,30,30,0.0,1.0
6082,22,0,0,13,13,0.0,1.0
6031,22,0,2,23,25,0.08,0.92
6039,22,0,1,57,58,0.017241379310344827,0.9827586206896551
6189,23,0,0,22,22,0.0,1.0
5936,23,0,0,31,31,0.0,1.0
6087,23,0,0,18,18,0.0,1.0
5973,23,0,0,34,34,0.0,1.0
6085,23,0,0,34,34,0.0,1.0
5948,23,0,1,41,42,0.023809523809523808,0.9761904761904762
5974,23,0,0,10,10,0.0,1.0
6090,23,0,0,1,1,0.0,1.0
6068,23,0,0,35,35,0.0,1.0
6024,23,0,1,1,2,0.5,0.5
5976,23,0,1,79,80,0.0125,0.9875
5962,23,0,0,59,59,0.0,1.0
6033,23,0,2,22,24,0.08333333333333333,0.9166666666666666
6038,23,0,0,7,7,0.0,1.0
6042,23,0,0,49,49,0.0,1.0
5924,23,0,0,50,50,0.0,1.0
6083,23,0,4,8,12,0.3333333333333333,0.6666666666666666
6178,23,0,0,225,225,0.0,1.0
6086,23,0,0,25,25,0.0,1.0
5945,23,0,0,95,95,0.0,1.0
5925,23,0,0,122,122,0.0,1.0
5935,23,0,0,3,3,0.0,1.0
6073,23,0,1,6,7,0.14285714285714285,0.8571428571428571
5980,23,0,0,12,12,0.0,1.0
5993,23,0,3,21,24,0.125,0.875
5979,23,0,0,33,33,0.0,1.0
5966,23,0,1,25,26,0.038461538461538464,0.9615384615384616
5967,23,0,1,100,101,0.009900990099009901,0.9900990099009901
5970,23,0,0,14,14,0.0,1.0
6188,23,0,0,3,3,0.0,1.0
6096,23,0,1,0,1,1.0,0.0
6069,23,0,0,17,17,0.0,1.0
5937,23,0,0,6,6,0.0,1.0
5990,23,0,0,50,50,0.0,1.0
5928,23,0,0,22,22,0.0,1.0
6058,23,0,3,66,69,0.043478260869565216,0.9565217391304348
6001,23,0,3,21,24,0.125,0.875
5964,23,0,0,10,10,0.0,1.0
5950,23,0,0,7,7,0.0,1.0
5991,23,0,0,20,20,0.0,1.0
6177,23,0,0,3,3,0.0,1.0
5961,23,0,0,45,45,0.0,1.0
5938,23,0,0,340,340,0.0,1.0
5960,23,0,0,36,36,0.0,1.0
5947,23,0,0,78,78,0.0,1.0
5957,23,0,4,3,7,0.5714285714285714,0.42857142857142855
6043,23,0,0,29,29,0.0,1.0
6014,23,0,4,6,10,0.4,0.6
6015,23,0,1,1,2,0.5,0.5
5978,23,0,1,15,16,0.0625,0.9375
5986,23,0,2,2,4,0.5,0.5
5969,23,0,0,4,4,0.0,1.0
5949,23,0,0,30,30,0.0,1.0
5959,23,0,0,40,40,0.0,1.0
6051,23,0,0,108,108,0.0,1.0
6029,23,0,0,20,20,0.0,1.0
6070,23,0,1,3,4,0.25,0.75
5942,23,0,0,108,108,0.0,1.0
5953,23,0,0,28,28,0.0,1.0
6076,23,0,0,14,14,0.0,1.0
5940,23,0,3,6,9,0.3333333333333333,0.6666666666666666
6109,23,0,0,95,95,0.0,1.0
6187,23,0,2,4,6,0.3333333333333333,0.6666666666666666
6053,23,0,0,15,15,0.0,1.0
6104,23,0,2,2,4,0.5,0.5
5943,23,0,0,9,9,0.0,1.0
6168,23,0,0,240,240,0.0,1.0
5989,23,0,0,6,6,0.0,1.0
5963,23,0,0,20,20,0.0,1.0
6194,23,0,0,80,80,0.0,1.0
6003,23,0,1,237,238,0.004201680672268907,0.9957983193277311
6167,23,0,0,10,10,0.0,1.0
6004,23,0,1,134,135,0.007407407407407408,0.9925925925925926
6054,23,0,0,14,14,0.0,1.0
6170,23,0,1,33,34,0.029411764705882353,0.9705882352941176
6063,23,0,3,7,10,0.3,0.7
5988,23,0,0,17,17,0.0,1.0
6075,23,0,1,11,12,0.08333333333333333,0.9166666666666666
6061,23,0,0,26,26,0.0,1.0
5965,23,0,0,45,45,0.0,1.0
6040,23,0,3,9,12,0.25,0.75
6106,23,0,0,30,30,0.0,1.0
6082,23,0,0,13,13,0.0,1.0
6031,23,0,0,25,25,0.0,1.0
6039,23,0,0,58,58,0.0,1.0
6189,24,0,0,22,22,0.0,1.0
5936,24,0,0,31,31,0.0,1.0
6087,24,0,0,18,18,0.0,1.0
5973,24,0,0,34,34,0.0,1.0
6085,24,0,0,34,34,0.0,1.0
5948,24,0,1,41,42,0.023809523809523808,0.9761904761904762
5974,24,0,0,10,10,0.0,1.0
6090,24,0,0,1,1,0.0,1.0
6068,24,0,0,35,35,0.0,1.0
6024,24,0,1,1,2,0.5,0.5
5976,24,0,0,80,80,0.0,1.0
5962,24,0,0,59,59,0.0,1.0
6033,24,0,2,22,24,0.08333333333333333,0.9166666666666666
6038,24,0,0,7,7,0.0,1.0
6042,24,0,0,49,49,0.0,1.0
5924,24,0,0,50,50,0.0,1.0
6083,24,0,3,9,12,0.25,0.75
6178,24,0,0,225,225,0.0,1.0
6086,24,0,0,25,25,0.0,1.0
5945,24,0,0,95,95,0.0,1.0
5925,24,0,0,122,122,0.0,1.0
5935,24,0,0,3,3,0.0,1.0
6073,24,0,1,6,7,0.14285714285714285,0.8571428571428571
5980,24,0,2,10,12,0.16666666666666666,0.8333333333333334
5993,24,0,0,24,24,0.0,1.0
5979,24,0,0,33,33,0.0,1.0
5966,24,0,0,26,26,0.0,1.0
5967,24,0,1,100,101,0.009900990099009901,0.9900990099009901
5970,24,0,0,14,14,0.0,1.0
6188,24,0,0,3,3,0.0,1.0
6096,24,0,1,0,1,1.0,0.0
6069,24,0,0,17,17,0.0,1.0
5937,24,0,0,6,6,0.0,1.0
5990,24,0,0,50,50,0.0,1.0
5928,24,0,0,22,22,0.0,1.0
6058,24,0,2,67,69,0.028985507246376812,0.9710144927536232
6001,24,0,2,22,24,0.08333333333333333,0.9166666666666666
5964,24,0,1,9,10,0.1,0.9
5950,24,0,0,7,7,0.0,1.0
5991,24,0,0,20,20,0.0,1.0
6177,24,0,0,3,3,0.0,1.0
5961,24,0,0,45,45,0.0,1.0
5938,24,0,0,340,340,0.0,1.0
5960,24,0,0,36,36,0.0,1.0
5947,24,0,0,78,78,0.0,1.0
5957,24,0,3,4,7,0.42857142857142855,0.5714285714285714
6043,24,0,0,29,29,0.0,1.0
6014,24,0,4,6,10,0.4,0.6
6015,24,0,1,1,2,0.5,0.5
5978,24,0,1,15,16,0.0625,0.9375
5986,24,0,2,2,4,0.5,0.5
5969,24,0,0,4,4,0.0,1.0
5949,24,0,0,30,30,0.0,1.0
5959,24,0,1,39,40,0.025,0.975
6051,24,0,0,108,108,0.0,1.0
6029,24,0,0,20,20,0.0,1.0
6070,24,0,2,2,4,0.5,0.5
5942,24,0,0,108,108,0.0,1.0
5953,24,0,0,28,28,0.0,1.0
6076,24,0,1,13,14,0.07142857142857142,0.9285714285714286
5940,24,0,4,5,9,0.4444444444444444,0.5555555555555556
6109,24,0,0,95,95,0.0,1.0
6187,24,0,0,6,6,0.0,1.0
6053,24,0,0,15,15,0.0,1.0
6104,24,0,3,1,4,0.75,0.25
5943,24,0,0,9,9,0.0,1.0
6168,24,0,0,240,240,0.0,1.0
5989,24,0,0,6,6,0.0,1.0
5963,24,0,0,20,20,0.0,1.0
6194,24,0,0,80,80,0.0,1.0
6003,24,0,1,237,238,0.004201680672268907,0.9957983193277311
6167,24,0,0,10,10,0.0,1.0
6004,24,0,1,134,135,0.007407407407407408,0.9925925925925926
6054,24,0,0,14,14,0.0,1.0
6170,24,0,3,31,34,0.08823529411764706,0.9117647058823529
6063,24,0,3,7,10,0.3,0.7
5988,24,0,0,17,17,0.0,1.0
6075,24,0,0,12,12,0.0,1.0
6061,24,0,0,26,26,0.0,1.0
5965,24,0,0,45,45,0.0,1.0
6040,24,0,4,8,12,0.3333333333333333,0.6666666666666666
6106,24,0,1,29,30,0.03333333333333333,0.9666666666666667
6082,24,0,0,13,13,0.0,1.0
6031,24,0,2,23,25,0.08,0.92
6039,24,0,0,58,58,0.0,1.0
6189,25,0,1,21,22,0.045454545454545456,0.9545454545454546
5936,25,0,0,31,31,0.0,1.0
6087,25,0,0,18,18,0.0,1.0
5973,25,0,0,34,34,0.0,1.0
6085,25,0,0,34,34,0.0,1.0
5948,25,0,0,42,42,0.0,1.0
5974,25,0,0,10,10,0.0,1.0
6090,25,0,0,1,1,0.0,1.0
6068,25,0,0,35,35,0.0,1.0
6024,25,0,1,1,2,0.5,0.5
5976,25,0,1,79,80,0.0125,0.9875
5962,25,0,0,59,59,0.0,1.0
6033,25,0,0,24,24,0.0,1.0
6038,25,0,0,7,7,0.0,1.0
6042,25,0,0,49,49,0.0,1.0
5924,25,0,0,50,50,0.0,1.0
6083,25,0,2,10,12,0.16666666666666666,0.8333333333333334
6178,25,0,0,225,225,0.0,1.0
6086,25,0,0,25,25,0.0,1.0
5945,25,0,0,95,95,0.0,1.0
5925,25,0,0,122,122,0.0,1.0
5935,25,0,0,3,3,0.0,1.0
6073,25,0,1,6,7,0.14285714285714285,0.8571428571428571
5980,25,0,0,12,12,0.0,1.0
5993,25,0,3,21,24,0.125,0.875
5979,25,0,0,33,33,0.0,1.0
5966,25,0,0,26,26,0.0,1.0
5967,25,0,2,99,101,0.019801980198019802,0.9801980198019802
5970,25,0,0,14,14,0.0,1.0
6188,25,0,1,2,3,0.3333333333333333,0.6666666666666666
6096,25,0,1,0,1,1.0,0.0
6069,25,0,0,17,17,0.0,1.0
5937,25,0,0,6,6,0.0,1.0
5990,25,0,0,50,50,0.0,1.0
5928,25,0,0,22,22,0.0,1.0
6058,25,0,8,61,69,0.11594202898550725,0.8840579710144928
6001,25,0,4,20,24,0.16666666666666666,0.8333333333333334
5964,25,0,1,9,10,0.1,0.9
5950,25,0,0,7,7,0.0,1.0
5991,25,0,0,20,20,0.0,1.0
6177,25,0,0,3,3,0.0,1.0
5961,25,0,0,45,45,0.0,1.0
5938,25,0,0,340,340,0.0,1.0
5960,25,0,0,36,36,0.0,1.0
5947,25,0,0,78,78,0.0,1.0
5957,25,0,1,6,7,0.14285714285714285,0.8571428571428571
6043,25,0,0,29,29,0.0,1.0
6014,25,0,6,4,10,0.6,0.4
6015,25,0,1,1,2,0.5,0.5
5978,25,0,1,15,16,0.0625,0.9375
5986,25,0,3,1,4,0.75,0.25
5969,25,0,1,3,4,0.25,0.75
5949,25,0,0,30,30,0.0,1.0
5959,25,0,7,33,40,0.175,0.825
6051,25,0,0,108,108,0.0,1.0
6029,25,0,1,19,20,0.05,0.95
6070,25,0,0,4,4,0.0,1.0
5942,25,0,0,108,108,0.0,1.0
5953,25,0,0,28,28,0.0,1.0
6076,25,0,1,13,14,0.07142857142857142,0.9285714285714286
5940,25,0,5,4,9,0.5555555555555556,0.4444444444444444
6109,25,0,0,95,95,0.0,1.0
6187,25,0,2,4,6,0.3333333333333333,0.6666666666666666
6053,25,0,0,15,15,0.0,1.0
6104,25,0,3,1,4,0.75,0.25
5943,25,0,0,9,9,0.0,1.0
6168,25,0,0,240,240,0.0,1.0
5989,25,0,0,6,6,0.0,1.0
5963,25,0,1,19,20,0.05,0.95
6194,25,0,0,80,80,0.0,1.0
6003,25,0,0,238,238,0.0,1.0
6167,25,0,0,10,10,0.0,1.0
6004,25,0,0,135,135,0.0,1.0
6054,25,0,0,14,14,0.0,1.0
6170,25,0,4,30,34,0.11764705882352941,0.8823529411764706
6063,25,0,3,7,10,0.3,0.7
5988,25,0,0,17,17,0.0,1.0
6075,25,0,1,11,12,0.08333333333333333,0.9166666666666666
6061,25,0,0,26,26,0.0,1.0
5965,25,0,0,45,45,0.0,1.0
6040,25,0,4,8,12,0.3333333333333333,0.6666666666666666
6106,25,0,2,28,30,0.06666666666666667,0.9333333333333333
6082,25,0,0,13,13,0.0,1.0
6031,25,0,2,23,25,0.08,0.92
6039,25,0,4,54,58,0.06896551724137931,0.9310344827586207
6189,26,0,1,21,22,0.045454545454545456,0.9545454545454546
5936,26,0,0,31,31,0.0,1.0
6087,26,0,0,18,18,0.0,1.0
5973,26,0,0,34,34,0.0,1.0
6085,26,0,0,34,34,0.0,1.0
5948,26,0,1,41,42,0.023809523809523808,0.9761904761904762
5974,26,0,0,10,10,0.0,1.0
6090,26,0,0,1,1,0.0,1.0
6068,26,0,0,35,35,0.0,1.0
6024,26,0,1,1,2,0.5,0.5
5976,26,0,1,79,80,0.0125,0.9875
5962,26,0,0,59,59,0.0,1.0
6033,26,0,0,24,24,0.0,1.0
6038,26,0,0,7,7,0.0,1.0
6042,26,0,0,49,49,0.0,1.0
5924,26,0,0,50,50,0.0,1.0
6083,26,0,1,11,12,0.08333333333333333,0.9166666666666666
6178,26,0,0,225,225,0.0,1.0
6086,26,0,0,25,25,0.0,1.0
5945,26,0,0,95,95,0.0,1.0
5925,26,0,0,122,122,0.0,1.0
5935,26,0,0,3,3,0.0,1.0
6073,26,0,1,6,7,0.14285714285714285,0.8571428571428571
5980,26,0,0,12,12,0.0,1.0
5993,26,0,0,24,24,0.0,1.0
5979,26,0,0,33,33,0.0,1.0
5966,26,0,0,26,26,0.0,1.0
5967,26,0,0,101,101,0.0,1.0
5970,26,0,0,14,14,0.0,1.0
6188,26,0,0,3,3,0.0,1.0
6096,26,0,1,0,1,1.0,0.0
6069,26,0,0,17,17,0.0,1.0
5937,26,0,0,6,6,0.0,1.0
5990,26,0,0,50,50,0.0,1.0
5928,26,0,0,22,22,0.0,1.0
6058,26,0,2,67,69,0.028985507246376812,0.9710144927536232
6001,26,0,1,23,24,0.041666666666666664,0.9583333333333334
5964,26,0,0,10,10,0.0,1.0
5950,26,0,3,4,7,0.42857142857142855,0.5714285714285714
5991,26,0,0,20,20,0.0,1.0
6177,26,0,0,3,3,0.0,1.0
5961,26,0,0,45,45,0.0,1.0
5938,26,0,0,340,340,0.0,1.0
5960,26,0,0,36,36,0.0,1.0
5947,26,0,0,78,78,0.0,1.0
5957,26,0,2,5,7,0.2857142857142857,0.7142857142857143
6043,26,0,0,29,29,0.0,1.0
6014,26,0,5,5,10,0.5,0.5
6015,26,0,1,1,2,0.5,0.5
5978,26,0,0,16,16,0.0,1.0
5986,26,0,3,1,4,0.75,0.25
5969,26,0,0,4,4,0.0,1.0
5949,26,0,0,30,30,0.0,1.0
5959,26,0,0,40,40,0.0,1.0
6051,26,0,0,108,108,0.0,1.0
6029,26,0,0,20,20,0.0,1.0
6070,26,0,0,4,4,0.0,1.0
5942,26,0,0,108,108,0.0,1.0
5953,26,0,0,28,28,0.0,1.0
6076,26,0,1,13,14,0.07142857142857142,0.9285714285714286
5940,26,0,3,6,9,0.3333333333333333,0.6666666666666666
6109,26,0,0,95,95,0.0,1.0
6187,26,0,0,6,6,0.0,1.0
6053,26,0,0,15,15,0.0,1.0
6104,26,0,2,2,4,0.5,0.5
5943,26,0,0,9,9,0.0,1.0
6168,26,0,0,240,240,0.0,1.0
5989,26,0,0,6,6,0.0,1.0
5963,26,0,0,20,20,0.0,1.0
6194,26,0,0,80,80,0.0,1.0
6003,26,0,1,237,238,0.004201680672268907,0.9957983193277311
6167,26,0,1,9,10,0.1,0.9
6004,26,0,5,130,135,0.037037037037037035,0.9629629629629629
6054,26,0,0,14,14,0.0,1.0
6170,26,0,3,31,34,0.08823529411764706,0.9117647058823529
6063,26,0,2,8,10,0.2,0.8
5988,26,0,0,17,17,0.0,1.0
6075,26,0,0,12,12,0.0,1.0
6061,26,0,0,26,26,0.0,1.0
5965,26,0,0,45,45,0.0,1.0
6040,26,0,5,7,12,0.4166666666666667,0.5833333333333334
6106,26,0,1,29,30,0.03333333333333333,0.9666666666666667
6082,26,0,2,11,13,0.15384615384615385,0.8461538461538461
6031,26,0,1,24,25,0.04,0.96
6039,26,0,1,57,58,0.017241379310344827,0.9827586206896551
6189,27,0,3,19,22,0.13636363636363635,0.8636363636363636
5936,27,0,0,31,31,0.0,1.0
6087,27,0,0,18,18,0.0,1.0
5973,27,0,0,34,34,0.0,1.0
6085,27,0,0,34,34,0.0,1.0
5948,27,0,0,42,42,0.0,1.0
5974,27,0,0,10,10,0.0,1.0
6090,27,0,0,1,1,0.0,1.0
6068,27,0,0,35,35,0.0,1.0
6024,27,0,1,1,2,0.5,0.5
5976,27,0,0,80,80,0.0,1.0
5962,27,0,0,59,59,0.0,1.0
6033,27,0,6,18,24,0.25,0.75
6038,27,0,0,7,7,0.0,1.0
6042,27,0,0,49,49,0.0,1.0
5924,27,0,0,50,50,0.0,1.0
6083,27,0,3,9,12,0.25,0.75
6178,27,0,0,225,225,0.0,1.0
6086,27,0,0,25,25,0.0,1.0
5945,27,0,0,95,95,0.0,1.0
5925,27,0,0,122,122,0.0,1.0
5935,27,0,0,3,3,0.0,1.0
6073,27,0,1,6,7,0.14285714285714285,0.8571428571428571
5980,27,0,0,12,12,0.0,1.0
5993,27,0,0,24,24,0.0,1.0
5979,27,0,0,33,33,0.0,1.0
5966,27,0,0,26,26,0.0,1.0
5967,27,0,0,101,101,0.0,1.0
5970,27,0,0,14,14,0.0,1.0
6188,27,0,0,3,3,0.0,1.0
6096,27,0,1,0,1,1.0,0.0
6069,27,0,0,17,17,0.0,1.0
5937,27,0,0,6,6,0.0,1.0
5990,27,0,0,50,50,0.0,1.0
5928,27,0,0,22,22,0.0,1.0
6058,27,0,3,66,69,0.043478260869565216,0.9565217391304348
6001,27,0,3,21,24,0.125,0.875
5964,27,0,0,10,10,0.0,1.0
5950,27,0,2,5,7,0.2857142857142857,0.7142857142857143
5991,27,0,0,20,20,0.0,1.0
6177,27,0,0,3,3,0.0,1.0
5961,27,0,0,45,45,0.0,1.0
5938,27,0,1,339,340,0.0029411764705882353,0.9970588235294118
5960,27,0,0,36,36,0.0,1.0
5947,27,0,0,78,78,0.0,1.0
5957,27,0,5,2,7,0.7142857142857143,0.2857142857142857
6043,27,0,0,29,29,0.0,1.0
6014,27,0,6,4,10,0.6,0.4
6015,27,0,1,1,2,0.5,0.5
5978,27,0,0,16,16,0.0,1.0
5986,27,0,2,2,4,0.5,0.5
5969,27,0,0,4,4,0.0,1.0
5949,27,0,0,30,30,0.0,1.0
5959,27,0,0,40,40,0.0,1.0
6051,27,0,0,108,108,0.0,1.0
6029,27,0,1,19,20,0.05,0.95
6070,27,0,0,4,4,0.0,1.0
5942,27,0,0,108,108,0.0,1.0
5953,27,0,0,28,28,0.0,1.0
6076,27,0,0,14,14,0.0,1.0
5940,27,0,5,4,9,0.5555555555555556,0.4444444444444444
6109,27,0,0,95,95,0.0,1.0
6187,27,0,2,4,6,0.3333333333333333,0.6666666666666666
6053,27,0,0,15,15,0.0,1.0
6104,27,0,1,3,4,0.25,0.75
5943,27,0,0,9,9,0.0,1.0
6168,27,0,0,240,240,0.0,1.0
5989,27,0,0,6,6,0.0,1.0
5963,27,0,0,20,20,0.0,1.0
6194,27,0,0,80,80,0.0,1.0
6003,27,0,0,238,238,0.0,1.0
6167,27,0,0,10,10,0.0,1.0
6004,27,0,1,134,135,0.007407407407407408,0.9925925925925926
6054,27,0,0,14,14,0.0,1.0
6170,27,0,0,34,34,0.0,1.0
6063,27,0,1,9,10,0.1,0.9
5988,27,0,0,17,17,0.0,1.0
6075,27,0,1,11,12,0.08333333333333333,0.9166666666666666
6061,27,0,0,26,26,0.0,1.0
5965,27,0,0,45,45,0.0,1.0
6040,27,0,2,10,12,0.16666666666666666,0.8333333333333334
6106,27,0,2,28,30,0.06666666666666667,0.9333333333333333
6082,27,0,0,13,13,0.0,1.0
6031,27,0,1,24,25,0.04,0.96
6039,27,0,0,58,58,0.0,1.0
6189,28,0,0,22,22,0.0,1.0
5936,28,0,0,31,31,0.0,1.0
6087,28,0,0,18,18,0.0,1.0
5973,28,0,0,34,34,0.0,1.0
6085,28,0,0,34,34,0.0,1.0
5948,28,0,0,42,42,0.0,1.0
5974,28,0,0,10,10,0.0,1.0
6090,28,0,0,1,1,0.0,1.0
6068,28,0,0,35,35,0.0,1.0
6024,28,0,1,1,2,0.5,0.5
5976,28,0,1,79,80,0.0125,0.9875
5962,28,0,0,59,59,0.0,1.0
6033,28,0,0,24,24,0.0,1.0
6038,28,0,0,7,7,0.0,1.0
6042,28,0,0,49,49,0.0,1.0
5924,28,0,0,50,50,0.0,1.0
6083,28,0,4,8,12,0.3333333333333333,0.6666666666666666
6178,28,0,0,225,225,0.0,1.0
6086,28,0,0,25,25,0.0,1.0
5945,28,0,0,95,95,0.0,1.0
5925,28,0,0,122,122,0.0,1.0
5935,28,0,0,3,3,0.0,1.0
6073,28,0,1,6,7,0.14285714285714285,0.8571428571428571
5980,28,0,2,10,12,0.16666666666666666,0.8333333333333334
5993,28,0,3,21,24,0.125,0.875
5979,28,0,0,33,33,0.0,1.0
5966,28,0,0,26,26,0.0,1.0
5967,28,0,1,100,101,0.009900990099009901,0.9900990099009901
5970,28,0,0,14,14,0.0,1.0
6188,28,0,0,3,3,0.0,1.0
6096,28,0,1,0,1,1.0,0.0
6069,28,0,0,17,17,0.0,1.0
5937,28,0,0,6,6,0.0,1.0
5990,28,0,0,50,50,0.0,1.0
5928,28,0,0,22,22,0.0,1.0
6058,28,0,0,69,69,0.0,1.0
6001,28,0,2,22,24,0.08333333333333333,0.9166666666666666
5964,28,0,1,9,10,0.1,0.9
5950,28,0,0,7,7,0.0,1.0
5991,28,0,0,20,20,0.0,1.0
6177,28,0,0,3,3,0.0,1.0
5961,28,0,0,45,45,0.0,1.0
5938,28,0,0,340,340,0.0,1.0
5960,28,0,0,36,36,0.0,1.0
5947,28,0,0,78,78,0.0,1.0
5957,28,0,2,5,7,0.2857142857142857,0.7142857142857143
6043,28,0,0,29,29,0.0,1.0
6014,28,0,4,6,10,0.4,0.6
6015,28,0,1,1,2,0.5,0.5
5978,28,0,0,16,16,0.0,1.0
5986,28,0,1,3,4,0.25,0.75
5969,28,0,0,4,4,0.0,1.0
5949,28,0,0,30,30,0.0,1.0
5959,28,0,1,39,40,0.025,0.975
6051,28,0,0,108,108,0.0,1.0
6029,28,0,0,20,20,0.0,1.0
6070,28,0,2,2,4,0.5,0.5
5942,28,0,0,108,108,0.0,1.0
5953,28,0,0,28,28,0.0,1.0
6076,28,0,1,13,14,0.07142857142857142,0.9285714285714286
5940,28,0,5,4,9,0.5555555555555556,0.4444444444444444
6109,28,0,0,95,95,0.0,1.0
6187,28,0,2,4,6,0.3333333333333333,0.6666666666666666
6053,28,0,0,15,15,0.0,1.0
6104,28,0,3,1,4,0.75,0.25
5943,28,0,0,9,9,0.0,1.0
6168,28,0,0,240,240,0.0,1.0
5989,28,0,0,6,6,0.0,1.0
5963,28,0,0,20,20,0.0,1.0
6194,28,0,0,80,80,0.0,1.0
6003,28,0,1,237,238,0.004201680672268907,0.9957983193277311
6167,28,0,0,10,10,0.0,1.0
6004,28,0,1,134,135,0.007407407407407408,0.9925925925925926
6054,28,0,0,14,14,0.0,1.0
6170,28,0,1,33,34,0.029411764705882353,0.9705882352941176
6063,28,0,0,10,10,0.0,1.0
5988,28,0,0,17,17,0.0,1.0
6075,28,0,1,11,12,0.08333333333333333,0.9166666666666666
6061,28,0,0,26,26,0.0,1.0
5965,28,0,0,45,45,0.0,1.0
6040,28,0,3,9,12,0.25,0.75
6106,28,0,1,29,30,0.03333333333333333,0.9666666666666667
6082,28,0,0,13,13,0.0,1.0
6031,28,0,1,24,25,0.04,0.96
6039,28,0,4,54,58,0.06896551724137931,0.9310344827586207
6189,29,0,0,22,22,0.0,1.0
5936,29,0,0,31,31,0.0,1.0
6087,29,0,0,18,18,0.0,1.0
5973,29,0,0,34,34,0.0,1.0
6085,29,0,0,34,34,0.0,1.0
5948,29,0,0,42,42,0.0,1.0
5974,29,0,0,10,10,0.0,1.0
6090,29,0,0,1,1,0.0,1.0
6068,29,0,0,35,35,0.0,1.0
6024,29,0,1,1,2,0.5,0.5
5976,29,0,0,80,80,0.0,1.0
5962,29,0,0,59,59,0.0,1.0
6033,29,0,4,20,24,0.16666666666666666,0.8333333333333334
6038,29,0,0,7,7,0.0,1.0
6042,29,0,0,49,49,0.0,1.0
5924,29,0,0,50,50,0.0,1.0
6083,29,0,0,12,12,0.0,1.0
6178,29,0,0,225,225,0.0,1.0
6086,29,0,0,25,25,0.0,1.0
5945,29,0,0,95,95,0.0,1.0
5925,29,0,0,122,122,0.0,1.0
5935,29,0,0,3,3,0.0,1.0
6073,29,0,1,6,7,0.14285714285714285,0.8571428571428571
5980,29,0,0,12,12,0.0,1.0
5993,29,0,0,24,24,0.0,1.0
5979,29,0,0,33,33,0.0,1.0
5966,29,0,0,26,26,0.0,1.0
5967,29,0,2,99,101,0.019801980198019802,0.9801980198019802
5970,29,0,0,14,14,0.0,1.0
6188,29,0,0,3,3,0.0,1.0
6096,29,0,1,0,1,1.0,0.0
6069,29,0,0,17,17,0.0,1.0
5937,29,0,0,6,6,0.0,1.0
5990,29,0,0,50,50,0.0,1.0
5928,29,0,0,22,22,0.0,1.0
6058,29,0,0,69,69,0.0,1.0
6001,29,0,0,24,24,0.0,1.0
5964,29,0,1,9,10,0.1,0.9
5950,29,0,1,6,7,0.14285714285714285,0.8571428571428571
5991,29,0,0,20,20,0.0,1.0
6177,29,0,0,3,3,0.0,1.0
5961,29,0,0,45,45,0.0,1.0
5938,29,0,0,340,340,0.0,1.0
5960,29,0,0,36,36,0.0,1.0
5947,29,0,0,78,78,0.0,1.0
5957,29,0,0,7,7,0.0,1.0
6043,29,0,0,29,29,0.0,1.0
6014,29,0,5,5,10,0.5,0.5
6015,29,0,1,1,2,0.5,0.5
5978,29,0,1,15,16,0.0625,0.9375
5986,29,0,2,2,4,0.5,0.5
5969,29,0,0,4,4,0.0,1.0
5949,29,0,0,30,30,0.0,1.0
5959,29,0,0,40,40,0.0,1.0
6051,29,0,0,108,108,0.0,1.0
6029,29,0,0,20,20,0.0,1.0
6070,29,0,2,2,4,0.5,0.5
5942,29,0,0,108,108,0.0,1.0
5953,29,0,0,28,28,0.0,1.0
6076,29,0,0,14,14,0.0,1.0
5940,29,0,6,3,9,0.6666666666666666,0.3333333333333333
6109,29,0,1,94,95,0.010526315789473684,0.9894736842105263
6187,29,0,0,6,6,0.0,1.0
6053,29,0,0,15,15,0.0,1.0
6104,29,0,2,2,4,0.5,0.5
5943,29,0,0,9,9,0.0,1.0
6168,29,0,0,240,240,0.0,1.0
5989,29,0,0,6,6,0.0,1.0
5963,29,0,0,20,20,0.0,1.0
6194,29,0,0,80,80,0.0,1.0
6003,29,0,0,238,238,0.0,1.0
6167,29,0,0,10,10,0.0,1.0
6004,29,0,0,135,135,0.0,1.0
6054,29,0,0,14,14,0.0,1.0
6170,29,0,0,34,34,0.0,1.0
6063,29,0,2,8,10,0.2,0.8
5988,29,0,0,17,17,0.0,1.0
6075,29,0,2,10,12,0.16666666666666666,0.8333333333333334
6061,29,0,0,26,26,0.0,1.0
5965,29,0,0,45,45,0.0,1.0
6040,29,0,5,7,12,0.4166666666666667,0.5833333333333334
6106,29,0,1,29,30,0.03333333333333333,0.9666666666666667
6082,29,0,0,13,13,0.0,1.0
6031,29,0,2,23,25,0.08,0.92
6039,29,0,4,54,58,0.06896551724137931,0.9310344827586207
6189,0,1,9,13,22,0.4090909090909091,0.5909090909090909
5936,0,1,0,31,31,0.0,1.0
6087,0,1,0,18,18,0.0,1.0
5973,0,1,0,34,34,0.0,1.0
6085,0,1,0,34,34,0.0,1.0
5948,0,1,1,41,42,0.023809523809523808,0.9761904761904762
5974,0,1,0,10,10,0.0,1.0
6090,0,1,0,1,1,0.0,1.0
6068,0,1,0,35,35,0.0,1.0
6024,0,1,1,1,2,0.5,0.5
5976,0,1,76,4,80,0.95,0.05
5962,0,1,0,59,59,0.0,1.0
6033,0,1,2,22,24,0.08333333333333333,0.9166666666666666
6038,0,1,0,7,7,0.0,1.0
6042,0,1,0,49,49,0.0,1.0
5924,0,1,0,50,50,0.0,1.0
6083,0,1,4,8,12,0.3333333333333333,0.6666666666666666
6178,0,1,186,39,225,0.8266666666666667,0.17333333333333334
6086,0,1,0,25,25,0.0,1.0
5945,0,1,0,95,95,0.0,1.0
5925,0,1,0,122,122,0.0,1.0
5935,0,1,0,3,3,0.0,1.0
6073,0,1,4,3,7,0.5714285714285714,0.42857142857142855
5980,0,1,0,12,12,0.0,1.0
5993,0,1,0,24,24,0.0,1.0
5979,0,1,0,33,33,0.0,1.0
5966,0,1,25,1,26,0.9615384615384616,0.038461538461538464
5967,0,1,93,8,101,0.9207920792079208,0.07920792079207921
5970,0,1,0,14,14,0.0,1.0
6188,0,1,3,0,3,1.0,0.0
6096,0,1,1,0,1,1.0,0.0
6069,0,1,0,17,17,0.0,1.0
5937,0,1,0,6,6,0.0,1.0
5990,0,1,0,50,50,0.0,1.0
5928,0,1,0,22,22,0.0,1.0
6058,0,1,63,6,69,0.9130434782608695,0.08695652173913043
6001,0,1,0,24,24,0.0,1.0
5964,0,1,1,9,10,0.1,0.9
5950,0,1,0,7,7,0.0,1.0
5991,0,1,0,20,20,0.0,1.0
6177,0,1,0,3,3,0.0,1.0
5961,0,1,0,45,45,0.0,1.0
5938,0,1,223,117,340,0.6558823529411765,0.34411764705882353
5960,0,1,0,36,36,0.0,1.0
5947,0,1,0,78,78,0.0,1.0
5957,0,1,7,0,7,1.0,0.0
6043,0,1,0,29,29,0.0,1.0
6014,0,1,10,0,10,1.0,0.0
6015,0,1,2,0,2,1.0,0.0
5978,0,1,16,0,16,1.0,0.0
5986,0,1,4,0,4,1.0,0.0
5969,0,1,4,0,4,1.0,0.0
5949,0,1,0,30,30,0.0,1.0
5959,0,1,40,0,40,1.0,0.0
6051,0,1,0,108,108,0.0,1.0
6029,0,1,0,20,20,0.0,1.0
6070,0,1,3,1,4,0.75,0.25
5942,0,1,0,108,108,0.0,1.0
5953,0,1,0,28,28,0.0,1.0
6076,0,1,10,4,14,0.7142857142857143,0.2857142857142857
5940,0,1,9,0,9,1.0,0.0
6109,0,1,92,3,95,0.968421052631579,0.031578947368421054
6187,0,1,2,4,6,0.3333333333333333,0.6666666666666666
6053,0,1,0,15,15,0.0,1.0
6104,0,1,3,1,4,0.75,0.25
5943,0,1,0,9,9,0.0,1.0
6168,0,1,0,240,240,0.0,1.0
5989,0,1,0,6,6,0.0,1.0
5963,0,1,20,0,20,1.0,0.0
6194,0,1,0,80,80,0.0,1.0
6003,0,1,110,128,238,0.46218487394957986,0.5378151260504201
6167,0,1,10,0,10,1.0,0.0
6004,0,1,77,58,135,0.5703703703703704,0.42962962962962964
6054,0,1,0,14,14,0.0,1.0
6170,0,1,8,26,34,0.23529411764705882,0.7647058823529411
6063,0,1,8,2,10,0.8,0.2
5988,0,1,0,17,17,0.0,1.0
6075,0,1,2,10,12,0.16666666666666666,0.8333333333333334
6061,0,1,0,26,26,0.0,1.0
5965,0,1,0,45,45,0.0,1.0
6040,0,1,12,0,12,1.0,0.0
6106,0,1,6,24,30,0.2,0.8
6082,0,1,0,13,13,0.0,1.0
6031,0,1,2,23,25,0.08,0.92
6039,0,1,0,58,58,0.0,1.0
6189,1,1,7,15,22,0.3181818181818182,0.6818181818181818
5936,1,1,0,31,31,0.0,1.0
6087,1,1,0,18,18,0.0,1.0
5973,1,1,0,34,34,0.0,1.0
6085,1,1,0,34,34,0.0,1.0
5948,1,1,1,41,42,0.023809523809523808,0.9761904761904762
5974,1,1,0,10,10,0.0,1.0
6090,1,1,0,1,1,0.0,1.0
6068,1,1,0,35,35,0.0,1.0
6024,1,1,2,0,2,1.0,0.0
5976,1,1,71,9,80,0.8875,0.1125
5962,1,1,0,59,59,0.0,1.0
6033,1,1,2,22,24,0.08333333333333333,0.9166666666666666
6038,1,1,0,7,7,0.0,1.0
6042,1,1,0,49,49,0.0,1.0
5924,1,1,0,50,50,0.0,1.0
6083,1,1,1,11,12,0.08333333333333333,0.9166666666666666
6178,1,1,162,63,225,0.72,0.28
6086,1,1,0,25,25,0.0,1.0
5945,1,1,0,95,95,0.0,1.0
5925,1,1,0,122,122,0.0,1.0
5935,1,1,0,3,3,0.0,1.0
6073,1,1,6,1,7,0.8571428571428571,0.14285714285714285
5980,1,1,0,12,12,0.0,1.0
5993,1,1,0,24,24,0.0,1.0
5979,1,1,0,33,33,0.0,1.0
5966,1,1,24,2,26,0.9230769230769231,0.07692307692307693
5967,1,1,84,17,101,0.8316831683168316,0.16831683168316833
5970,1,1,0,14,14,0.0,1.0
6188,1,1,3,0,3,1.0,0.0
6096,1,1,1,0,1,1.0,0.0
6069,1,1,0,17,17,0.0,1.0
5937,1,1,0,6,6,0.0,1.0
5990,1,1,0,50,50,0.0,1.0
5928,1,1,0,22,22,0.0,1.0
6058,1,1,66,3,69,0.9565217391304348,0.043478260869565216
6001,1,1,7,17,24,0.2916666666666667,0.7083333333333334
5964,1,1,0,10,10,0.0,1.0
5950,1,1,1,6,7,0.14285714285714285,0.8571428571428571
5991,1,1,0,20,20,0.0,1.0
6177,1,1,0,3,3,0.0,1.0
5961,1,1,0,45,45,0.0,1.0
5938,1,1,128,212,340,0.3764705882352941,0.6235294117647059
5960,1,1,0,36,36,0.0,1.0
5947,1,1,0,78,78,0.0,1.0
5957,1,1,7,0,7,1.0,0.0
6043,1,1,0,29,29,0.0,1.0
6014,1,1,10,0,10,1.0,0.0
6015,1,1,2,0,2,1.0,0.0
5978,1,1,16,0,16,1.0,0.0
5986,1,1,4,0,4,1.0,0.0
5969,1,1,4,0,4,1.0,0.0
5949,1,1,0,30,30,0.0,1.0
5959,1,1,37,3,40,0.925,0.075
6051,1,1,0,108,108,0.0,1.0
6029,1,1,1,19,20,0.05,0.95
6070,1,1,4,0,4,1.0,0.0
5942,1,1,0,108,108,0.0,1.0
5953,1,1,0,28,28,0.0,1.0
6076,1,1,11,3,14,0.7857142857142857,0.21428571428571427
5940,1,1,8,1,9,0.8888888888888888,0.1111111111111111
6109,1,1,82,13,95,0.8631578947368421,0.1368421052631579
6187,1,1,0,6,6,0.0,1.0
6053,1,1,0,15,15,0.0,1.0
6104,1,1,4,0,4,1.0,0.0
5943,1,1,0,9,9,0.0,1.0
6168,1,1,0,240,240,0.0,1.0
5989,1,1,0,6,6,0.0,1.0
5963,1,1,20,0,20,1.0,0.0
6194,1,1,0,80,80,0.0,1.0
6003,1,1,75,163,238,0.31512605042016806,0.6848739495798319
6167,1,1,8,2,10,0.8,0.2
6004,1,1,49,86,135,0.362962962962963,0.6370370370370371
6054,1,1,0,14,14,0.0,1.0
6170,1,1,5,29,34,0.14705882352941177,0.8529411764705882
6063,1,1,9,1,10,0.9,0.1
5988,1,1,0,17,17,0.0,1.0
6075,1,1,1,11,12,0.08333333333333333,0.9166666666666666
6061,1,1,0,26,26,0.0,1.0
5965,1,1,0,45,45,0.0,1.0
6040,1,1,12,0,12,1.0,0.0
6106,1,1,0,30,30,0.0,1.0
6082,1,1,0,13,13,0.0,1.0
6031,1,1,2,23,25,0.08,0.92
6039,1,1,1,57,58,0.017241379310344827,0.9827586206896551
6189,2,1,8,14,22,0.36363636363636365,0.6363636363636364
5936,2,1,0,31,31,0.0,1.0
6087,2,1,0,18,18,0.0,1.0
5973,2,1,0,34,34,0.0,1.0
6085,2,1,0,34,34,0.0,1.0
5948,2,1,0,42,42,0.0,1.0
5974,2,1,0,10,10,0.0,1.0
6090,2,1,0,1,1,0.0,1.0
6068,2,1,0,35,35,0.0,1.0
6024,2,1,1,1,2,0.5,0.5
5976,2,1,47,33,80,0.5875,0.4125
5962,2,1,0,59,59,0.0,1.0
6033,2,1,2,22,24,0.08333333333333333,0.9166666666666666
6038,2,1,0,7,7,0.0,1.0
6042,2,1,0,49,49,0.0,1.0
5924,2,1,0,50,50,0.0,1.0
6083,2,1,1,11,12,0.08333333333333333,0.9166666666666666
6178,2,1,71,154,225,0.31555555555555553,0.6844444444444444
6086,2,1,0,25,25,0.0,1.0
5945,2,1,0,95,95,0.0,1.0
5925,2,1,0,122,122,0.0,1.0
5935,2,1,0,3,3,0.0,1.0
6073,2,1,7,0,7,1.0,0.0
5980,2,1,0,12,12,0.0,1.0
5993,2,1,0,24,24,0.0,1.0
5979,2,1,0,33,33,0.0,1.0
5966,2,1,22,4,26,0.8461538461538461,0.15384615384615385
5967,2,1,51,50,101,0.504950495049505,0.49504950495049505
5970,2,1,0,14,14,0.0,1.0
6188,2,1,3,0,3,1.0,0.0
6096,2,1,1,0,1,1.0,0.0
6069,2,1,0,17,17,0.0,1.0
5937,2,1,0,6,6,0.0,1.0
5990,2,1,0,50,50,0.0,1.0
5928,2,1,0,22,22,0.0,1.0
6058,2,1,45,24,69,0.6521739130434783,0.34782608695652173
6001,2,1,5,19,24,0.20833333333333334,0.7916666666666666
5964,2,1,1,9,10,0.1,0.9
5950,2,1,2,5,7,0.2857142857142857,0.7142857142857143
5991,2,1,0,20,20,0.0,1.0
6177,2,1,0,3,3,0.0,1.0
5961,2,1,0,45,45,0.0,1.0
5938,2,1,32,308,340,0.09411764705882353,0.9058823529411765
5960,2,1,0,36,36,0.0,1.0
5947,2,1,0,78,78,0.0,1.0
5957,2,1,6,1,7,0.8571428571428571,0.14285714285714285
6043,2,1,0,29,29,0.0,1.0
6014,2,1,10,0,10,1.0,0.0
6015,2,1,2,0,2,1.0,0.0
5978,2,1,15,1,16,0.9375,0.0625
5986,2,1,4,0,4,1.0,0.0
5969,2,1,3,1,4,0.75,0.25
5949,2,1,0,30,30,0.0,1.0
5959,2,1,23,17,40,0.575,0.425
6051,2,1,0,108,108,0.0,1.0
6029,2,1,1,19,20,0.05,0.95
6070,2,1,3,1,4,0.75,0.25
5942,2,1,0,108,108,0.0,1.0
5953,2,1,0,28,28,0.0,1.0
6076,2,1,10,4,14,0.7142857142857143,0.2857142857142857
5940,2,1,9,0,9,1.0,0.0
6109,2,1,50,45,95,0.5263157894736842,0.47368421052631576
6187,2,1,0,6,6,0.0,1.0
6053,2,1,0,15,15,0.0,1.0
6104,2,1,4,0,4,1.0,0.0
5943,2,1,0,9,9,0.0,1.0
6168,2,1,0,240,240,0.0,1.0
5989,2,1,0,6,6,0.0,1.0
5963,2,1,17,3,20,0.85,0.15
6194,2,1,0,80,80,0.0,1.0
6003,2,1,51,187,238,0.21428571428571427,0.7857142857142857
6167,2,1,9,1,10,0.9,0.1
6004,2,1,28,107,135,0.2074074074074074,0.7925925925925926
6054,2,1,0,14,14,0.0,1.0
6170,2,1,5,29,34,0.14705882352941177,0.8529411764705882
6063,2,1,8,2,10,0.8,0.2
5988,2,1,0,17,17,0.0,1.0
6075,2,1,1,11,12,0.08333333333333333,0.9166666666666666
6061,2,1,0,26,26,0.0,1.0
5965,2,1,0,45,45,0.0,1.0
6040,2,1,12,0,12,1.0,0.0
6106,2,1,1,29,30,0.03333333333333333,0.9666666666666667
6082,2,1,2,11,13,0.15384615384615385,0.8461538461538461
6031,2,1,1,24,25,0.04,0.96
6039,2,1,3,55,58,0.05172413793103448,0.9482758620689655
6189,3,1,8,14,22,0.36363636363636365,0.6363636363636364
5936,3,1,0,31,31,0.0,1.0
6087,3,1,0,18,18,0.0,1.0
5973,3,1,0,34,34,0.0,1.0
6085,3,1,0,34,34,0.0,1.0
5948,3,1,1,41,42,0.023809523809523808,0.9761904761904762
5974,3,1,0,10,10,0.0,1.0
6090,3,1,0,1,1,0.0,1.0
6068,3,1,0,35,35,0.0,1.0
6024,3,1,1,1,2,0.5,0.5
5976,3,1,31,49,80,0.3875,0.6125
5962,3,1,0,59,59,0.0,1.0
6033,3,1,2,22,24,0.08333333333333333,0.9166666666666666
6038,3,1,0,7,7,0.0,1.0
6042,3,1,0,49,49,0.0,1.0
5924,3,1,0,50,50,0.0,1.0
6083,3,1,2,10,12,0.16666666666666666,0.8333333333333334
6178,3,1,34,191,225,0.1511111111111111,0.8488888888888889
6086,3,1,0,25,25,0.0,1.0
5945,3,1,0,95,95,0.0,1.0
5925,3,1,0,122,122,0.0,1.0
5935,3,1,0,3,3,0.0,1.0
6073,3,1,4,3,7,0.5714285714285714,0.42857142857142855
5980,3,1,2,10,12,0.16666666666666666,0.8333333333333334
5993,3,1,0,24,24,0.0,1.0
5979,3,1,0,33,33,0.0,1.0
5966,3,1,17,9,26,0.6538461538461539,0.34615384615384615
5967,3,1,29,72,101,0.2871287128712871,0.7128712871287128
5970,3,1,0,14,14,0.0,1.0
6188,3,1,3,0,3,1.0,0.0
6096,3,1,1,0,1,1.0,0.0
6069,3,1,0,17,17,0.0,1.0
5937,3,1,0,6,6,0.0,1.0
5990,3,1,0,50,50,0.0,1.0
5928,3,1,0,22,22,0.0,1.0
6058,3,1,44,25,69,0.6376811594202898,0.36231884057971014
6001,3,1,4,20,24,0.16666666666666666,0.8333333333333334
5964,3,1,1,9,10,0.1,0.9
5950,3,1,0,7,7,0.0,1.0
5991,3,1,0,20,20,0.0,1.0
6177,3,1,0,3,3,0.0,1.0
5961,3,1,0,45,45,0.0,1.0
5938,3,1,16,324,340,0.047058823529411764,0.9529411764705882
5960,3,1,0,36,36,0.0,1.0
5947,3,1,0,78,78,0.0,1.0
5957,3,1,6,1,7,0.8571428571428571,0.14285714285714285
6043,3,1,0,29,29,0.0,1.0
6014,3,1,10,0,10,1.0,0.0
6015,3,1,2,0,2,1.0,0.0
5978,3,1,12,4,16,0.75,0.25
5986,3,1,4,0,4,1.0,0.0
5969,3,1,3,1,4,0.75,0.25
5949,3,1,0,30,30,0.0,1.0
5959,3,1,19,21,40,0.475,0.525
6051,3,1,0,108,108,0.0,1.0
6029,3,1,1,19,20,0.05,0.95
6070,3,1,4,0,4,1.0,0.0
5942,3,1,0,108,108,0.0,1.0
5953,3,1,0,28,28,0.0,1.0
6076,3,1,10,4,14,0.7142857142857143,0.2857142857142857
5940,3,1,8,1,9,0.8888888888888888,0.1111111111111111
6109,3,1,28,67,95,0.29473684210526313,0.7052631578947368
6187,3,1,0,6,6,0.0,1.0
6053,3,1,0,15,15,0.0,1.0
6104,3,1,3,1,4,0.75,0.25
5943,3,1,0,9,9,0.0,1.0
6168,3,1,0,240,240,0.0,1.0
5989,3,1,0,6,6,0.0,1.0
5963,3,1,17,3,20,0.85,0.15
6194,3,1,0,80,80,0.0,1.0
6003,3,1,32,206,238,0.13445378151260504,0.865546218487395
6167,3,1,5,5,10,0.5,0.5
6004,3,1,16,119,135,0.11851851851851852,0.8814814814814815
6054,3,1,0,14,14,0.0,1.0
6170,3,1,6,28,34,0.17647058823529413,0.8235294117647058
6063,3,1,9,1,10,0.9,0.1
5988,3,1,0,17,17,0.0,1.0
6075,3,1,1,11,12,0.08333333333333333,0.9166666666666666
6061,3,1,0,26,26,0.0,1.0
5965,3,1,0,45,45,0.0,1.0
6040,3,1,11,1,12,0.9166666666666666,0.08333333333333333
6106,3,1,0,30,30,0.0,1.0
6082,3,1,0,13,13,0.0,1.0
6031,3,1,2,23,25,0.08,0.92
6039,3,1,0,58,58,0.0,1.0
6189,4,1,5,17,22,0.22727272727272727,0.7727272727272727
5936,4,1,0,31,31,0.0,1.0
6087,4,1,0,18,18,0.0,1.0
5973,4,1,0,34,34,0.0,1.0
6085,4,1,0,34,34,0.0,1.0
5948,4,1,1,41,42,0.023809523809523808,0.9761904761904762
5974,4,1,0,10,10,0.0,1.0
6090,4,1,0,1,1,0.0,1.0
6068,4,1,0,35,35,0.0,1.0
6024,4,1,1,1,2,0.5,0.5
5976,4,1,25,55,80,0.3125,0.6875
5962,4,1,0,59,59,0.0,1.0
6033,4,1,2,22,24,0.08333333333333333,0.9166666666666666
6038,4,1,0,7,7,0.0,1.0
6042,4,1,0,49,49,0.0,1.0
5924,4,1,0,50,50,0.0,1.0
6083,4,1,1,11,12,0.08333333333333333,0.9166666666666666
6178,4,1,28,197,225,0.12444444444444444,0.8755555555555555
6086,4,1,0,25,25,0.0,1.0
5945,4,1,0,95,95,0.0,1.0
5925,4,1,0,122,122,0.0,1.0
5935,4,1,0,3,3,0.0,1.0
6073,4,1,3,4,7,0.42857142857142855,0.5714285714285714
5980,4,1,0,12,12,0.0,1.0
5993,4,1,0,24,24,0.0,1.0
5979,4,1,0,33,33,0.0,1.0
5966,4,1,13,13,26,0.5,0.5
5967,4,1,18,83,101,0.1782178217821782,0.8217821782178217
5970,4,1,0,14,14,0.0,1.0
6188,4,1,3,0,3,1.0,0.0
6096,4,1,1,0,1,1.0,0.0
6069,4,1,0,17,17,0.0,1.0
5937,4,1,0,6,6,0.0,1.0
5990,4,1,0,50,50,0.0,1.0
5928,4,1,0,22,22,0.0,1.0
6058,4,1,22,47,69,0.3188405797101449,0.6811594202898551
6001,4,1,3,21,24,0.125,0.875
5964,4,1,0,10,10,0.0,1.0
5950,4,1,0,7,7,0.0,1.0
5991,4,1,0,20,20,0.0,1.0
6177,4,1,0,3,3,0.0,1.0
5961,4,1,0,45,45,0.0,1.0
5938,4,1,12,328,340,0.03529411764705882,0.9647058823529412
5960,4,1,0,36,36,0.0,1.0
5947,4,1,0,78,78,0.0,1.0
5957,4,1,5,2,7,0.7142857142857143,0.2857142857142857
6043,4,1,0,29,29,0.0,1.0
6014,4,1,10,0,10,1.0,0.0
6015,4,1,2,0,2,1.0,0.0
5978,4,1,8,8,16,0.5,0.5
5986,4,1,4,0,4,1.0,0.0
5969,4,1,4,0,4,1.0,0.0
5949,4,1,0,30,30,0.0,1.0
5959,4,1,18,22,40,0.45,0.55
6051,4,1,0,108,108,0.0,1.0
6029,4,1,1,19,20,0.05,0.95
6070,4,1,3,1,4,0.75,0.25
5942,4,1,0,108,108,0.0,1.0
5953,4,1,0,28,28,0.0,1.0
6076,4,1,7,7,14,0.5,0.5
5940,4,1,8,1,9,0.8888888888888888,0.1111111111111111
6109,4,1,27,68,95,0.28421052631578947,0.7157894736842105
6187,4,1,0,6,6,0.0,1.0
6053,4,1,0,15,15,0.0,1.0
6104,4,1,3,1,4,0.75,0.25
5943,4,1,0,9,9,0.0,1.0
6168,4,1,0,240,240,0.0,1.0
5989,4,1,0,6,6,0.0,1.0
5963,4,1,13,7,20,0.65,0.35
6194,4,1,0,80,80,0.0,1.0
6003,4,1,18,220,238,0.07563025210084033,0.9243697478991597
6167,4,1,4,6,10,0.4,0.6
6004,4,1,11,124,135,0.08148148148148149,0.9185185185185185
6054,4,1,0,14,14,0.0,1.0
6170,4,1,4,30,34,0.11764705882352941,0.8823529411764706
6063,4,1,8,2,10,0.8,0.2
5988,4,1,0,17,17,0.0,1.0
6075,4,1,1,11,12,0.08333333333333333,0.9166666666666666
6061,4,1,0,26,26,0.0,1.0
5965,4,1,0,45,45,0.0,1.0
6040,4,1,10,2,12,0.8333333333333334,0.16666666666666666
6106,4,1,1,29,30,0.03333333333333333,0.9666666666666667
6082,4,1,2,11,13,0.15384615384615385,0.8461538461538461
6031,4,1,0,25,25,0.0,1.0
6039,4,1,1,57,58,0.017241379310344827,0.9827586206896551
6189,5,1,5,17,22,0.22727272727272727,0.7727272727272727
5936,5,1,0,31,31,0.0,1.0
6087,5,1,0,18,18,0.0,1.0
5973,5,1,0,34,34,0.0,1.0
6085,5,1,0,34,34,0.0,1.0
5948,5,1,0,42,42,0.0,1.0
5974,5,1,0,10,10,0.0,1.0
6090,5,1,0,1,1,0.0,1.0
6068,5,1,0,35,35,0.0,1.0
6024,5,1,2,0,2,1.0,0.0
5976,5,1,14,66,80,0.175,0.825
5962,5,1,0,59,59,0.0,1.0
6033,5,1,4,20,24,0.16666666666666666,0.8333333333333334
6038,5,1,0,7,7,0.0,1.0
6042,5,1,0,49,49,0.0,1.0
5924,5,1,0,50,50,0.0,1.0
6083,5,1,0,12,12,0.0,1.0
6178,5,1,16,209,225,0.07111111111111111,0.9288888888888889
6086,5,1,0,25,25,0.0,1.0
5945,5,1,0,95,95,0.0,1.0
5925,5,1,0,122,122,0.0,1.0
5935,5,1,0,3,3,0.0,1.0
6073,5,1,3,4,7,0.42857142857142855,0.5714285714285714
5980,5,1,0,12,12,0.0,1.0
5993,5,1,0,24,24,0.0,1.0
5979,5,1,0,33,33,0.0,1.0
5966,5,1,11,15,26,0.4230769230769231,0.5769230769230769
5967,5,1,14,87,101,0.13861386138613863,0.8613861386138614
5970,5,1,0,14,14,0.0,1.0
6188,5,1,3,0,3,1.0,0.0
6096,5,1,1,0,1,1.0,0.0
6069,5,1,0,17,17,0.0,1.0
5937,5,1,0,6,6,0.0,1.0
5990,5,1,0,50,50,0.0,1.0
5928,5,1,0,22,22,0.0,1.0
6058,5,1,28,41,69,0.4057971014492754,0.5942028985507246
6001,5,1,5,19,24,0.20833333333333334,0.7916666666666666
5964,5,1,1,9,10,0.1,0.9
5950,5,1,1,6,7,0.14285714285714285,0.8571428571428571
5991,5,1,0,20,20,0.0,1.0
6177,5,1,0,3,3,0.0,1.0
5961,5,1,0,45,45,0.0,1.0
5938,5,1,5,335,340,0.014705882352941176,0.9852941176470589
5960,5,1,0,36,36,0.0,1.0
5947,5,1,0,78,78,0.0,1.0
5957,5,1,4,3,7,0.5714285714285714,0.42857142857142855
6043,5,1,0,29,29,0.0,1.0
6014,5,1,10,0,10,1.0,0.0
6015,5,1,2,0,2,1.0,0.0
5978,5,1,11,5,16,0.6875,0.3125
5986,5,1,4,0,4,1.0,0.0
5969,5,1,4,0,4,1.0,0.0
5949,5,1,0,30,30,0.0,1.0
5959,5,1,14,26,40,0.35,0.65
6051,5,1,0,108,108,0.0,1.0
6029,5,1,1,19,20,0.05,0.95
6070,5,1,4,0,4,1.0,0.0
5942,5,1,0,108,108,0.0,1.0
5953,5,1,0,28,28,0.0,1.0
6076,5,1,10,4,14,0.7142857142857143,0.2857142857142857
5940,5,1,8,1,9,0.8888888888888888,0.1111111111111111
6109,5,1,18,77,95,0.18947368421052632,0.8105263157894737
6187,5,1,0,6,6,0.0,1.0
6053,5,1,0,15,15,0.0,1.0
6104,5,1,4,0,4,1.0,0.0
5943,5,1,4,5,9,0.4444444444444444,0.5555555555555556
6168,5,1,0,240,240,0.0,1.0
5989,5,1,0,6,6,0.0,1.0
5963,5,1,14,6,20,0.7,0.3
6194,5,1,0,80,80,0.0,1.0
6003,5,1,10,228,238,0.04201680672268908,0.957983193277311
6167,5,1,5,5,10,0.5,0.5
6004,5,1,16,119,135,0.11851851851851852,0.8814814814814815
6054,5,1,0,14,14,0.0,1.0
6170,5,1,6,28,34,0.17647058823529413,0.8235294117647058
6063,5,1,9,1,10,0.9,0.1
5988,5,1,0,17,17,0.0,1.0
6075,5,1,1,11,12,0.08333333333333333,0.9166666666666666
6061,5,1,0,26,26,0.0,1.0
5965,5,1,0,45,45,0.0,1.0
6040,5,1,11,1,12,0.9166666666666666,0.08333333333333333
6106,5,1,0,30,30,0.0,1.0
6082,5,1,2,11,13,0.15384615384615385,0.8461538461538461
6031,5,1,0,25,25,0.0,1.0
6039,5,1,0,58,58,0.0,1.0
6189,6,1,3,19,22,0.13636363636363635,0.8636363636363636
5936,6,1,0,31,31,0.0,1.0
6087,6,1,0,18,18,0.0,1.0
5973,6,1,0,34,34,0.0,1.0
6085,6,1,0,34,34,0.0,1.0
5948,6,1,1,41,42,0.023809523809523808,0.9761904761904762
5974,6,1,0,10,10,0.0,1.0
6090,6,1,0,1,1,0.0,1.0
6068,6,1,0,35,35,0.0,1.0
6024,6,1,2,0,2,1.0,0.0
5976,6,1,15,65,80,0.1875,0.8125
5962,6,1,0,59,59,0.0,1.0
6033,6,1,0,24,24,0.0,1.0
6038,6,1,0,7,7,0.0,1.0
6042,6,1,0,49,49,0.0,1.0
5924,6,1,0,50,50,0.0,1.0
6083,6,1,0,12,12,0.0,1.0
6178,6,1,14,211,225,0.06222222222222222,0.9377777777777778
6086,6,1,0,25,25,0.0,1.0
5945,6,1,0,95,95,0.0,1.0
5925,6,1,0,122,122,0.0,1.0
5935,6,1,0,3,3,0.0,1.0
6073,6,1,5,2,7,0.7142857142857143,0.2857142857142857
5980,6,1,0,12,12,0.0,1.0
5993,6,1,0,24,24,0.0,1.0
5979,6,1,0,33,33,0.0,1.0
5966,6,1,5,21,26,0.19230769230769232,0.8076923076923077
5967,6,1,13,88,101,0.12871287128712872,0.8712871287128713
5970,6,1,0,14,14,0.0,1.0
6188,6,1,3,0,3,1.0,0.0
6096,6,1,1,0,1,1.0,0.0
6069,6,1,0,17,17,0.0,1.0
5937,6,1,0,6,6,0.0,1.0
5990,6,1,0,50,50,0.0,1.0
5928,6,1,0,22,22,0.0,1.0
6058,6,1,21,48,69,0.30434782608695654,0.6956521739130435
6001,6,1,2,22,24,0.08333333333333333,0.9166666666666666
5964,6,1,0,10,10,0.0,1.0
5950,6,1,0,7,7,0.0,1.0
5991,6,1,0,20,20,0.0,1.0
6177,6,1,0,3,3,0.0,1.0
5961,6,1,0,45,45,0.0,1.0
5938,6,1,6,334,340,0.01764705882352941,0.9823529411764705
5960,6,1,0,36,36,0.0,1.0
5947,6,1,0,78,78,0.0,1.0
5957,6,1,5,2,7,0.7142857142857143,0.2857142857142857
6043,6,1,0,29,29,0.0,1.0
6014,6,1,10,0,10,1.0,0.0
6015,6,1,2,0,2,1.0,0.0
5978,6,1,11,5,16,0.6875,0.3125
5986,6,1,4,0,4,1.0,0.0
5969,6,1,3,1,4,0.75,0.25
5949,6,1,0,30,30,0.0,1.0
5959,6,1,13,27,40,0.325,0.675
6051,6,1,0,108,108,0.0,1.0
6029,6,1,0,20,20,0.0,1.0
6070,6,1,4,0,4,1.0,0.0
5942,6,1,0,108,108,0.0,1.0
5953,6,1,0,28,28,0.0,1.0
6076,6,1,9,5,14,0.6428571428571429,0.35714285714285715
5940,6,1,6,3,9,0.6666666666666666,0.3333333333333333
6109,6,1,17,78,95,0.17894736842105263,0.8210526315789474
6187,6,1,0,6,6,0.0,1.0
6053,6,1,0,15,15,0.0,1.0
6104,6,1,3,1,4,0.75,0.25
5943,6,1,0,9,9,0.0,1.0
6168,6,1,0,240,240,0.0,1.0
5989,6,1,0,6,6,0.0,1.0
5963,6,1,16,4,20,0.8,0.2
6194,6,1,0,80,80,0.0,1.0
6003,6,1,8,230,238,0.03361344537815126,0.9663865546218487
6167,6,1,4,6,10,0.4,0.6
6004,6,1,6,129,135,0.044444444444444446,0.9555555555555556
6054,6,1,0,14,14,0.0,1.0
6170,6,1,3,31,34,0.08823529411764706,0.9117647058823529
6063,6,1,9,1,10,0.9,0.1
5988,6,1,0,17,17,0.0,1.0
6075,6,1,0,12,12,0.0,1.0
6061,6,1,0,26,26,0.0,1.0
5965,6,1,0,45,45,0.0,1.0
6040,6,1,6,6,12,0.5,0.5
6106,6,1,1,29,30,0.03333333333333333,0.9666666666666667
6082,6,1,2,11,13,0.15384615384615385,0.8461538461538461
6031,6,1,2,23,25,0.08,0.92
6039,6,1,1,57,58,0.017241379310344827,0.9827586206896551
6189,7,1,2,20,22,0.09090909090909091,0.9090909090909091
5936,7,1,0,31,31,0.0,1.0
6087,7,1,0,18,18,0.0,1.0
5973,7,1,0,34,34,0.0,1.0
6085,7,1,0,34,34,0.0,1.0
5948,7,1,0,42,42,0.0,1.0
5974,7,1,0,10,10,0.0,1.0
6090,7,1,0,1,1,0.0,1.0
6068,7,1,0,35,35,0.0,1.0
6024,7,1,1,1,2,0.5,0.5
5976,7,1,9,71,80,0.1125,0.8875
5962,7,1,0,59,59,0.0,1.0
6033,7,1,0,24,24,0.0,1.0
6038,7,1,0,7,7,0.0,1.0
6042,7,1,0,49,49,0.0,1.0
5924,7,1,0,50,50,0.0,1.0
6083,7,1,3,9,12,0.25,0.75
6178,7,1,11,214,225,0.04888888888888889,0.9511111111111111
6086,7,1,0,25,25,0.0,1.0
5945,7,1,0,95,95,0.0,1.0
5925,7,1,0,122,122,0.0,1.0
5935,7,1,0,3,3,0.0,1.0
6073,7,1,6,1,7,0.8571428571428571,0.14285714285714285
5980,7,1,0,12,12,0.0,1.0
5993,7,1,0,24,24,0.0,1.0
5979,7,1,0,33,33,0.0,1.0
5966,7,1,4,22,26,0.15384615384615385,0.8461538461538461
5967,7,1,17,84,101,0.16831683168316833,0.8316831683168316
5970,7,1,0,14,14,0.0,1.0
6188,7,1,1,2,3,0.3333333333333333,0.6666666666666666
6096,7,1,1,0,1,1.0,0.0
6069,7,1,0,17,17,0.0,1.0
5937,7,1,0,6,6,0.0,1.0
5990,7,1,0,50,50,0.0,1.0
5928,7,1,0,22,22,0.0,1.0
6058,7,1,22,47,69,0.3188405797101449,0.6811594202898551
6001,7,1,2,22,24,0.08333333333333333,0.9166666666666666
5964,7,1,1,9,10,0.1,0.9
5950,7,1,3,4,7,0.42857142857142855,0.5714285714285714
5991,7,1,0,20,20,0.0,1.0
6177,7,1,0,3,3,0.0,1.0
5961,7,1,0,45,45,0.0,1.0
5938,7,1,1,339,340,0.0029411764705882353,0.9970588235294118
5960,7,1,0,36,36,0.0,1.0
5947,7,1,0,78,78,0.0,1.0
5957,7,1,3,4,7,0.42857142857142855,0.5714285714285714
6043,7,1,0,29,29,0.0,1.0
6014,7,1,9,1,10,0.9,0.1
6015,7,1,2,0,2,1.0,0.0
5978,7,1,8,8,16,0.5,0.5
5986,7,1,3,1,4,0.75,0.25
5969,7,1,3,1,4,0.75,0.25
5949,7,1,0,30,30,0.0,1.0
5959,7,1,6,34,40,0.15,0.85
6051,7,1,0,108,108,0.0,1.0
6029,7,1,0,20,20,0.0,1.0
6070,7,1,3,1,4,0.75,0.25
5942,7,1,0,108,108,0.0,1.0
5953,7,1,0,28,28,0.0,1.0
6076,7,1,4,10,14,0.2857142857142857,0.7142857142857143
5940,7,1,5,4,9,0.5555555555555556,0.4444444444444444
6109,7,1,15,80,95,0.15789473684210525,0.8421052631578947
6187,7,1,0,6,6,0.0,1.0
6053,7,1,0,15,15,0.0,1.0
6104,7,1,4,0,4,1.0,0.0
5943,7,1,0,9,9,0.0,1.0
6168,7,1,0,240,240,0.0,1.0
5989,7,1,0,6,6,0.0,1.0
5963,7,1,13,7,20,0.65,0.35
6194,7,1,0,80,80,0.0,1.0
6003,7,1,3,235,238,0.012605042016806723,0.9873949579831933
6167,7,1,3,7,10,0.3,0.7
6004,7,1,6,129,135,0.044444444444444446,0.9555555555555556
6054,7,1,0,14,14,0.0,1.0
6170,7,1,4,30,34,0.11764705882352941,0.8823529411764706
6063,7,1,7,3,10,0.7,0.3
5988,7,1,0,17,17,0.0,1.0
6075,7,1,2,10,12,0.16666666666666666,0.8333333333333334
6061,7,1,0,26,26,0.0,1.0
5965,7,1,0,45,45,0.0,1.0
6040,7,1,9,3,12,0.75,0.25
6106,7,1,2,28,30,0.06666666666666667,0.9333333333333333
6082,7,1,2,11,13,0.15384615384615385,0.8461538461538461
6031,7,1,0,25,25,0.0,1.0
6039,7,1,0,58,58,0.0,1.0
6189,8,1,2,20,22,0.09090909090909091,0.9090909090909091
5936,8,1,0,31,31,0.0,1.0
6087,8,1,0,18,18,0.0,1.0
5973,8,1,0,34,34,0.0,1.0
6085,8,1,0,34,34,0.0,1.0
5948,8,1,1,41,42,0.023809523809523808,0.9761904761904762
5974,8,1,0,10,10,0.0,1.0
6090,8,1,0,1,1,0.0,1.0
6068,8,1,0,35,35,0.0,1.0
6024,8,1,1,1,2,0.5,0.5
5976,8,1,6,74,80,0.075,0.925
5962,8,1,0,59,59,0.0,1.0
6033,8,1,6,18,24,0.25,0.75
6038,8,1,0,7,7,0.0,1.0
6042,8,1,0,49,49,0.0,1.0
5924,8,1,0,50,50,0.0,1.0
6083,8,1,4,8,12,0.3333333333333333,0.6666666666666666
6178,8,1,7,218,225,0.03111111111111111,0.9688888888888889
6086,8,1,0,25,25,0.0,1.0
5945,8,1,0,95,95,0.0,1.0
5925,8,1,0,122,122,0.0,1.0
5935,8,1,0,3,3,0.0,1.0
6073,8,1,4,3,7,0.5714285714285714,0.42857142857142855
5980,8,1,0,12,12,0.0,1.0
5993,8,1,0,24,24,0.0,1.0
5979,8,1,0,33,33,0.0,1.0
5966,8,1,7,19,26,0.2692307692307692,0.7307692307692307
5967,8,1,8,93,101,0.07920792079207921,0.9207920792079208
5970,8,1,0,14,14,0.0,1.0
6188,8,1,1,2,3,0.3333333333333333,0.6666666666666666
6096,8,1,1,0,1,1.0,0.0
6069,8,1,0,17,17,0.0,1.0
5937,8,1,0,6,6,0.0,1.0
5990,8,1,0,50,50,0.0,1.0
5928,8,1,0,22,22,0.0,1.0
6058,8,1,18,51,69,0.2608695652173913,0.7391304347826086
6001,8,1,5,19,24,0.20833333333333334,0.7916666666666666
5964,8,1,1,9,10,0.1,0.9
5950,8,1,0,7,7,0.0,1.0
5991,8,1,0,20,20,0.0,1.0
6177,8,1,0,3,3,0.0,1.0
5961,8,1,0,45,45,0.0,1.0
5938,8,1,6,334,340,0.01764705882352941,0.9823529411764705
5960,8,1,0,36,36,0.0,1.0
5947,8,1,0,78,78,0.0,1.0
5957,8,1,3,4,7,0.42857142857142855,0.5714285714285714
6043,8,1,0,29,29,0.0,1.0
6014,8,1,8,2,10,0.8,0.2
6015,8,1,2,0,2,1.0,0.0
5978,8,1,5,11,16,0.3125,0.6875
5986,8,1,3,1,4,0.75,0.25
5969,8,1,2,2,4,0.5,0.5
5949,8,1,0,30,30,0.0,1.0
5959,8,1,11,29,40,0.275,0.725
6051,8,1,0,108,108,0.0,1.0
6029,8,1,1,19,20,0.05,0.95
6070,8,1,3,1,4,0.75,0.25
5942,8,1,0,108,108,0.0,1.0
5953,8,1,0,28,28,0.0,1.0
6076,8,1,5,9,14,0.35714285714285715,0.6428571428571429
5940,8,1,6,3,9,0.6666666666666666,0.3333333333333333
6109,8,1,13,82,95,0.1368421052631579,0.8631578947368421
6187,8,1,0,6,6,0.0,1.0
6053,8,1,4,11,15,0.26666666666666666,0.7333333333333333
6104,8,1,4,0,4,1.0,0.0
5943,8,1,0,9,9,0.0,1.0
6168,8,1,0,240,240,0.0,1.0
5989,8,1,0,6,6,0.0,1.0
5963,8,1,12,8,20,0.6,0.4
6194,8,1,0,80,80,0.0,1.0
6003,8,1,2,236,238,0.008403361344537815,0.9915966386554622
6167,8,1,2,8,10,0.2,0.8
6004,8,1,7,128,135,0.05185185185185185,0.9481481481481482
6054,8,1,0,14,14,0.0,1.0
6170,8,1,5,29,34,0.14705882352941177,0.8529411764705882
6063,8,1,7,3,10,0.7,0.3
5988,8,1,0,17,17,0.0,1.0
6075,8,1,0,12,12,0.0,1.0
6061,8,1,0,26,26,0.0,1.0
5965,8,1,0,45,45,0.0,1.0
6040,8,1,8,4,12,0.6666666666666666,0.3333333333333333
6106,8,1,1,29,30,0.03333333333333333,0.9666666666666667
6082,8,1,0,13,13,0.0,1.0
6031,8,1,2,23,25,0.08,0.92
6039,8,1,4,54,58,0.06896551724137931,0.9310344827586207
6189,9,1,4,18,22,0.18181818181818182,0.8181818181818182
5936,9,1,0,31,31,0.0,1.0
6087,9,1,0,18,18,0.0,1.0
5973,9,1,0,34,34,0.0,1.0
6085,9,1,0,34,34,0.0,1.0
5948,9,1,0,42,42,0.0,1.0
5974,9,1,0,10,10,0.0,1.0
6090,9,1,0,1,1,0.0,1.0
6068,9,1,0,35,35,0.0,1.0
6024,9,1,2,0,2,1.0,0.0
5976,9,1,10,70,80,0.125,0.875
5962,9,1,0,59,59,0.0,1.0
6033,9,1,2,22,24,0.08333333333333333,0.9166666666666666
6038,9,1,0,7,7,0.0,1.0
6042,9,1,0,49,49,0.0,1.0
5924,9,1,0,50,50,0.0,1.0
6083,9,1,2,10,12,0.16666666666666666,0.8333333333333334
6178,9,1,5,220,225,0.022222222222222223,0.9777777777777777
6086,9,1,0,25,25,0.0,1.0
5945,9,1,0,95,95,0.0,1.0
5925,9,1,0,122,122,0.0,1.0
5935,9,1,0,3,3,0.0,1.0
6073,9,1,4,3,7,0.5714285714285714,0.42857142857142855
5980,9,1,0,12,12,0.0,1.0
5993,9,1,0,24,24,0.0,1.0
5979,9,1,0,33,33,0.0,1.0
5966,9,1,1,25,26,0.038461538461538464,0.9615384615384616
5967,9,1,8,93,101,0.07920792079207921,0.9207920792079208
5970,9,1,0,14,14,0.0,1.0
6188,9,1,3,0,3,1.0,0.0
6096,9,1,1,0,1,1.0,0.0
6069,9,1,0,17,17,0.0,1.0
5937,9,1,0,6,6,0.0,1.0
5990,9,1,0,50,50,0.0,1.0
5928,9,1,0,22,22,0.0,1.0
6058,9,1,11,58,69,0.15942028985507245,0.8405797101449275
6001,9,1,3,21,24,0.125,0.875
5964,9,1,0,10,10,0.0,1.0
5950,9,1,2,5,7,0.2857142857142857,0.7142857142857143
5991,9,1,0,20,20,0.0,1.0
6177,9,1,0,3,3,0.0,1.0
5961,9,1,0,45,45,0.0,1.0
5938,9,1,3,337,340,0.008823529411764706,0.9911764705882353
5960,9,1,0,36,36,0.0,1.0
5947,9,1,0,78,78,0.0,1.0
5957,9,1,4,3,7,0.5714285714285714,0.42857142857142855
6043,9,1,0,29,29,0.0,1.0
6014,9,1,10,0,10,1.0,0.0
6015,9,1,2,0,2,1.0,0.0
5978,9,1,4,12,16,0.25,0.75
5986,9,1,3,1,4,0.75,0.25
5969,9,1,3,1,4,0.75,0.25
5949,9,1,0,30,30,0.0,1.0
5959,9,1,3,37,40,0.075,0.925
6051,9,1,0,108,108,0.0,1.0
6029,9,1,0,20,20,0.0,1.0
6070,9,1,3,1,4,0.75,0.25
5942,9,1,0,108,108,0.0,1.0
5953,9,1,0,28,28,0.0,1.0
6076,9,1,1,13,14,0.07142857142857142,0.9285714285714286
5940,9,1,4,5,9,0.4444444444444444,0.5555555555555556
6109,9,1,11,84,95,0.11578947368421053,0.8842105263157894
6187,9,1,2,4,6,0.3333333333333333,0.6666666666666666
6053,9,1,4,11,15,0.26666666666666666,0.7333333333333333
6104,9,1,3,1,4,0.75,0.25
5943,9,1,0,9,9,0.0,1.0
6168,9,1,0,240,240,0.0,1.0
5989,9,1,0,6,6,0.0,1.0
5963,9,1,8,12,20,0.4,0.6
6194,9,1,0,80,80,0.0,1.0
6003,9,1,1,237,238,0.004201680672268907,0.9957983193277311
6167,9,1,2,8,10,0.2,0.8
6004,9,1,4,131,135,0.02962962962962963,0.9703703703703703
6054,9,1,0,14,14,0.0,1.0
6170,9,1,5,29,34,0.14705882352941177,0.8529411764705882
6063,9,1,5,5,10,0.5,0.5
5988,9,1,0,17,17,0.0,1.0
6075,9,1,1,11,12,0.08333333333333333,0.9166666666666666
6061,9,1,0,26,26,0.0,1.0
5965,9,1,0,45,45,0.0,1.0
6040,9,1,8,4,12,0.6666666666666666,0.3333333333333333
6106,9,1,2,28,30,0.06666666666666667,0.9333333333333333
6082,9,1,0,13,13,0.0,1.0
6031,9,1,1,24,25,0.04,0.96
6039,9,1,1,57,58,0.017241379310344827,0.9827586206896551
6189,10,1,1,21,22,0.045454545454545456,0.9545454545454546
5936,10,1,0,31,31,0.0,1.0
6087,10,1,0,18,18,0.0,1.0
5973,10,1,0,34,34,0.0,1.0
6085,10,1,0,34,34,0.0,1.0
5948,10,1,0,42,42,0.0,1.0
5974,10,1,0,10,10,0.0,1.0
6090,10,1,0,1,1,0.0,1.0
6068,10,1,0,35,35,0.0,1.0
6024,10,1,1,1,2,0.5,0.5
5976,10,1,4,76,80,0.05,0.95
5962,10,1,0,59,59,0.0,1.0
6033,10,1,0,24,24,0.0,1.0
6038,10,1,0,7,7,0.0,1.0
6042,10,1,0,49,49,0.0,1.0
5924,10,1,0,50,50,0.0,1.0
6083,10,1,4,8,12,0.3333333333333333,0.6666666666666666
6178,10,1,4,221,225,0.017777777777777778,0.9822222222222222
6086,10,1,0,25,25,0.0,1.0
5945,10,1,0,95,95,0.0,1.0
5925,10,1,0,122,122,0.0,1.0
5935,10,1,0,3,3,0.0,1.0
6073,10,1,2,5,7,0.2857142857142857,0.7142857142857143
5980,10,1,0,12,12,0.0,1.0
5993,10,1,0,24,24,0.0,1.0
5979,10,1,0,33,33,0.0,1.0
5966,10,1,7,19,26,0.2692307692307692,0.7307692307692307
5967,10,1,5,96,101,0.04950495049504951,0.9504950495049505
5970,10,1,0,14,14,0.0,1.0
6188,10,1,2,1,3,0.6666666666666666,0.3333333333333333
6096,10,1,1,0,1,1.0,0.0
6069,10,1,0,17,17,0.0,1.0
5937,10,1,0,6,6,0.0,1.0
5990,10,1,0,50,50,0.0,1.0
5928,10,1,0,22,22,0.0,1.0
6058,10,1,12,57,69,0.17391304347826086,0.8260869565217391
6001,10,1,2,22,24,0.08333333333333333,0.9166666666666666
5964,10,1,1,9,10,0.1,0.9
5950,10,1,1,6,7,0.14285714285714285,0.8571428571428571
5991,10,1,0,20,20,0.0,1.0
6177,10,1,0,3,3,0.0,1.0
5961,10,1,0,45,45,0.0,1.0
5938,10,1,3,337,340,0.008823529411764706,0.9911764705882353
5960,10,1,0,36,36,0.0,1.0
5947,10,1,0,78,78,0.0,1.0
5957,10,1,3,4,7,0.42857142857142855,0.5714285714285714
6043,10,1,0,29,29,0.0,1.0
6014,10,1,9,1,10,0.9,0.1
6015,10,1,2,0,2,1.0,0.0
5978,10,1,3,13,16,0.1875,0.8125
5986,10,1,4,0,4,1.0,0.0
5969,10,1,3,1,4,0.75,0.25
5949,10,1,3,27,30,0.1,0.9
5959,10,1,1,39,40,0.025,0.975
6051,10,1,0,108,108,0.0,1.0
6029,10,1,1,19,20,0.05,0.95
6070,10,1,4,0,4,1.0,0.0
5942,10,1,0,108,108,0.0,1.0
5953,10,1,0,28,28,0.0,1.0
6076,10,1,4,10,14,0.2857142857142857,0.7142857142857143
5940,10,1,5,4,9,0.5555555555555556,0.4444444444444444
6109,10,1,12,83,95,0.12631578947368421,0.8736842105263158
6187,10,1,2,4,6,0.3333333333333333,0.6666666666666666
6053,10,1,0,15,15,0.0,1.0
6104,10,1,4,0,4,1.0,0.0
5943,10,1,0,9,9,0.0,1.0
6168,10,1,0,240,240,0.0,1.0
5989,10,1,0,6,6,0.0,1.0
5963,10,1,10,10,20,0.5,0.5
6194,10,1,0,80,80,0.0,1.0
6003,10,1,0,238,238,0.0,1.0
6167,10,1,2,8,10,0.2,0.8
6004,10,1,2,133,135,0.014814814814814815,0.9851851851851852
6054,10,1,0,14,14,0.0,1.0
6170,10,1,2,32,34,0.058823529411764705,0.9411764705882353
6063,10,1,2,8,10,0.2,0.8
5988,10,1,0,17,17,0.0,1.0
6075,10,1,1,11,12,0.08333333333333333,0.9166666666666666
6061,10,1,0,26,26,0.0,1.0
5965,10,1,0,45,45,0.0,1.0
6040,10,1,4,8,12,0.3333333333333333,0.6666666666666666
6106,10,1,2,28,30,0.06666666666666667,0.9333333333333333
6082,10,1,0,13,13,0.0,1.0
6031,10,1,1,24,25,0.04,0.96
6039,10,1,1,57,58,0.017241379310344827,0.9827586206896551
6189,11,1,3,19,22,0.13636363636363635,0.8636363636363636
5936,11,1,0,31,31,0.0,1.0
6087,11,1,0,18,18,0.0,1.0
5973,11,1,0,34,34,0.0,1.0
6085,11,1,0,34,34,0.0,1.0
5948,11,1,1,41,42,0.023809523809523808,0.9761904761904762
5974,11,1,0,10,10,0.0,1.0
6090,11,1,0,1,1,0.0,1.0
6068,11,1,0,35,35,0.0,1.0
6024,11,1,2,0,2,1.0,0.0
5976,11,1,6,74,80,0.075,0.925
5962,11,1,0,59,59,0.0,1.0
6033,11,1,0,24,24,0.0,1.0
6038,11,1,0,7,7,0.0,1.0
6042,11,1,0,49,49,0.0,1.0
5924,11,1,0,50,50,0.0,1.0
6083,11,1,1,11,12,0.08333333333333333,0.9166666666666666
6178,11,1,0,225,225,0.0,1.0
6086,11,1,0,25,25,0.0,1.0
5945,11,1,0,95,95,0.0,1.0
5925,11,1,0,122,122,0.0,1.0
5935,11,1,0,3,3,0.0,1.0
6073,11,1,3,4,7,0.42857142857142855,0.5714285714285714
5980,11,1,2,10,12,0.16666666666666666,0.8333333333333334
5993,11,1,0,24,24,0.0,1.0
5979,11,1,0,33,33,0.0,1.0
5966,11,1,4,22,26,0.15384615384615385,0.8461538461538461
5967,11,1,3,98,101,0.0297029702970297,0.9702970297029703
5970,11,1,0,14,14,0.0,1.0
6188,11,1,2,1,3,0.6666666666666666,0.3333333333333333
6096,11,1,1,0,1,1.0,0.0
6069,11,1,0,17,17,0.0,1.0
5937,11,1,0,6,6,0.0,1.0
5990,11,1,0,50,50,0.0,1.0
5928,11,1,0,22,22,0.0,1.0
6058,11,1,5,64,69,0.07246376811594203,0.927536231884058
6001,11,1,4,20,24,0.16666666666666666,0.8333333333333334
5964,11,1,1,9,10,0.1,0.9
5950,11,1,0,7,7,0.0,1.0
5991,11,1,0,20,20,0.0,1.0
6177,11,1,0,3,3,0.0,1.0
5961,11,1,0,45,45,0.0,1.0
5938,11,1,2,338,340,0.0058823529411764705,0.9941176470588236
5960,11,1,0,36,36,0.0,1.0
5947,11,1,0,78,78,0.0,1.0
5957,11,1,3,4,7,0.42857142857142855,0.5714285714285714
6043,11,1,0,29,29,0.0,1.0
6014,11,1,10,0,10,1.0,0.0
6015,11,1,2,0,2,1.0,0.0
5978,11,1,2,14,16,0.125,0.875
5986,11,1,2,2,4,0.5,0.5
5969,11,1,3,1,4,0.75,0.25
5949,11,1,0,30,30,0.0,1.0
5959,11,1,4,36,40,0.1,0.9
6051,11,1,0,108,108,0.0,1.0
6029,11,1,0,20,20,0.0,1.0
6070,11,1,3,1,4,0.75,0.25
5942,11,1,0,108,108,0.0,1.0
5953,11,1,0,28,28,0.0,1.0
6076,11,1,5,9,14,0.35714285714285715,0.6428571428571429
5940,11,1,5,4,9,0.5555555555555556,0.4444444444444444
6109,11,1,4,91,95,0.042105263157894736,0.9578947368421052
6187,11,1,0,6,6,0.0,1.0
6053,11,1,0,15,15,0.0,1.0
6104,11,1,3,1,4,0.75,0.25
5943,11,1,0,9,9,0.0,1.0
6168,11,1,0,240,240,0.0,1.0
5989,11,1,0,6,6,0.0,1.0
5963,11,1,8,12,20,0.4,0.6
6194,11,1,0,80,80,0.0,1.0
6003,11,1,1,237,238,0.004201680672268907,0.9957983193277311
6167,11,1,1,9,10,0.1,0.9
6004,11,1,1,134,135,0.007407407407407408,0.9925925925925926
6054,11,1,0,14,14,0.0,1.0
6170,11,1,7,27,34,0.20588235294117646,0.7941176470588235
6063,11,1,5,5,10,0.5,0.5
5988,11,1,0,17,17,0.0,1.0
6075,11,1,1,11,12,0.08333333333333333,0.9166666666666666
6061,11,1,0,26,26,0.0,1.0
5965,11,1,0,45,45,0.0,1.0
6040,11,1,6,6,12,0.5,0.5
6106,11,1,2,28,30,0.06666666666666667,0.9333333333333333
6082,11,1,0,13,13,0.0,1.0
6031,11,1,1,24,25,0.04,0.96
6039,11,1,0,58,58,0.0,1.0
6189,12,1,2,20,22,0.09090909090909091,0.9090909090909091
5936,12,1,0,31,31,0.0,1.0
6087,12,1,0,18,18,0.0,1.0
5973,12,1,0,34,34,0.0,1.0
6085,12,1,0,34,34,0.0,1.0
5948,12,1,0,42,42,0.0,1.0
5974,12,1,0,10,10,0.0,1.0
6090,12,1,0,1,1,0.0,1.0
6068,12,1,0,35,35,0.0,1.0
6024,12,1,1,1,2,0.5,0.5
5976,12,1,5,75,80,0.0625,0.9375
5962,12,1,0,59,59,0.0,1.0
6033,12,1,0,24,24,0.0,1.0
6038,12,1,0,7,7,0.0,1.0
6042,12,1,0,49,49,0.0,1.0
5924,12,1,0,50,50,0.0,1.0
6083,12,1,2,10,12,0.16666666666666666,0.8333333333333334
6178,12,1,2,223,225,0.008888888888888889,0.9911111111111112
6086,12,1,0,25,25,0.0,1.0
5945,12,1,0,95,95,0.0,1.0
5925,12,1,0,122,122,0.0,1.0
5935,12,1,0,3,3,0.0,1.0
6073,12,1,2,5,7,0.2857142857142857,0.7142857142857143
5980,12,1,0,12,12,0.0,1.0
5993,12,1,0,24,24,0.0,1.0
5979,12,1,0,33,33,0.0,1.0
5966,12,1,3,23,26,0.11538461538461539,0.8846153846153846
5967,12,1,3,98,101,0.0297029702970297,0.9702970297029703
5970,12,1,0,14,14,0.0,1.0
6188,12,1,1,2,3,0.3333333333333333,0.6666666666666666
6096,12,1,1,0,1,1.0,0.0
6069,12,1,0,17,17,0.0,1.0
5937,12,1,0,6,6,0.0,1.0
5990,12,1,0,50,50,0.0,1.0
5928,12,1,0,22,22,0.0,1.0
6058,12,1,12,57,69,0.17391304347826086,0.8260869565217391
6001,12,1,3,21,24,0.125,0.875
5964,12,1,1,9,10,0.1,0.9
5950,12,1,1,6,7,0.14285714285714285,0.8571428571428571
5991,12,1,0,20,20,0.0,1.0
6177,12,1,0,3,3,0.0,1.0
5961,12,1,0,45,45,0.0,1.0
5938,12,1,2,338,340,0.0058823529411764705,0.9941176470588236
5960,12,1,0,36,36,0.0,1.0
5947,12,1,0,78,78,0.0,1.0
5957,12,1,4,3,7,0.5714285714285714,0.42857142857142855
6043,12,1,0,29,29,0.0,1.0
6014,12,1,7,3,10,0.7,0.3
6015,12,1,2,0,2,1.0,0.0
5978,12,1,1,15,16,0.0625,0.9375
5986,12,1,3,1,4,0.75,0.25
5969,12,1,3,1,4,0.75,0.25
5949,12,1,0,30,30,0.0,1.0
5959,12,1,1,39,40,0.025,0.975
6051,12,1,0,108,108,0.0,1.0
6029,12,1,0,20,20,0.0,1.0
6070,12,1,3,1,4,0.75,0.25
5942,12,1,0,108,108,0.0,1.0
5953,12,1,0,28,28,0.0,1.0
6076,12,1,1,13,14,0.07142857142857142,0.9285714285714286
5940,12,1,3,6,9,0.3333333333333333,0.6666666666666666
6109,12,1,7,88,95,0.07368421052631578,0.9263157894736842
6187,12,1,0,6,6,0.0,1.0
6053,12,1,0,15,15,0.0,1.0
6104,12,1,4,0,4,1.0,0.0
5943,12,1,0,9,9,0.0,1.0
6168,12,1,0,240,240,0.0,1.0
5989,12,1,0,6,6,0.0,1.0
5963,12,1,5,15,20,0.25,0.75
6194,12,1,0,80,80,0.0,1.0
6003,12,1,1,237,238,0.004201680672268907,0.9957983193277311
6167,12,1,2,8,10,0.2,0.8
6004,12,1,1,134,135,0.007407407407407408,0.9925925925925926
6054,12,1,0,14,14,0.0,1.0
6170,12,1,0,34,34,0.0,1.0
6063,12,1,4,6,10,0.4,0.6
5988,12,1,0,17,17,0.0,1.0
6075,12,1,0,12,12,0.0,1.0
6061,12,1,0,26,26,0.0,1.0
5965,12,1,0,45,45,0.0,1.0
6040,12,1,5,7,12,0.4166666666666667,0.5833333333333334
6106,12,1,0,30,30,0.0,1.0
6082,12,1,0,13,13,0.0,1.0
6031,12,1,1,24,25,0.04,0.96
6039,12,1,1,57,58,0.017241379310344827,0.9827586206896551
6189,13,1,1,21,22,0.045454545454545456,0.9545454545454546
5936,13,1,0,31,31,0.0,1.0
6087,13,1,0,18,18,0.0,1.0
5973,13,1,0,34,34,0.0,1.0
6085,13,1,0,34,34,0.0,1.0
5948,13,1,1,41,42,0.023809523809523808,0.9761904761904762
5974,13,1,0,10,10,0.0,1.0
6090,13,1,0,1,1,0.0,1.0
6068,13,1,0,35,35,0.0,1.0
6024,13,1,1,1,2,0.5,0.5
5976,13,1,3,77,80,0.0375,0.9625
5962,13,1,0,59,59,0.0,1.0
6033,13,1,0,24,24,0.0,1.0
6038,13,1,0,7,7,0.0,1.0
6042,13,1,0,49,49,0.0,1.0
5924,13,1,0,50,50,0.0,1.0
6083,13,1,0,12,12,0.0,1.0
6178,13,1,1,224,225,0.0044444444444444444,0.9955555555555555
6086,13,1,0,25,25,0.0,1.0
5945,13,1,0,95,95,0.0,1.0
5925,13,1,0,122,122,0.0,1.0
5935,13,1,0,3,3,0.0,1.0
6073,13,1,2,5,7,0.2857142857142857,0.7142857142857143
5980,13,1,0,12,12,0.0,1.0
5993,13,1,0,24,24,0.0,1.0
5979,13,1,0,33,33,0.0,1.0
5966,13,1,3,23,26,0.11538461538461539,0.8846153846153846
5967,13,1,2,99,101,0.019801980198019802,0.9801980198019802
5970,13,1,0,14,14,0.0,1.0
6188,13,1,1,2,3,0.3333333333333333,0.6666666666666666
6096,13,1,1,0,1,1.0,0.0
6069,13,1,0,17,17,0.0,1.0
5937,13,1,0,6,6,0.0,1.0
5990,13,1,0,50,50,0.0,1.0
5928,13,1,0,22,22,0.0,1.0
6058,13,1,6,63,69,0.08695652173913043,0.9130434782608695
6001,13,1,3,21,24,0.125,0.875
5964,13,1,0,10,10,0.0,1.0
5950,13,1,1,6,7,0.14285714285714285,0.8571428571428571
5991,13,1,0,20,20,0.0,1.0
6177,13,1,0,3,3,0.0,1.0
5961,13,1,0,45,45,0.0,1.0
5938,13,1,0,340,340,0.0,1.0
5960,13,1,0,36,36,0.0,1.0
5947,13,1,0,78,78,0.0,1.0
5957,13,1,3,4,7,0.42857142857142855,0.5714285714285714
6043,13,1,0,29,29,0.0,1.0
6014,13,1,8,2,10,0.8,0.2
6015,13,1,1,1,2,0.5,0.5
5978,13,1,5,11,16,0.3125,0.6875
5986,13,1,3,1,4,0.75,0.25
5969,13,1,1,3,4,0.25,0.75
5949,13,1,0,30,30,0.0,1.0
5959,13,1,4,36,40,0.1,0.9
6051,13,1,0,108,108,0.0,1.0
6029,13,1,1,19,20,0.05,0.95
6070,13,1,4,0,4,1.0,0.0
5942,13,1,0,108,108,0.0,1.0
5953,13,1,0,28,28,0.0,1.0
6076,13,1,7,7,14,0.5,0.5
5940,13,1,6,3,9,0.6666666666666666,0.3333333333333333
6109,13,1,9,86,95,0.09473684210526316,0.9052631578947369
6187,13,1,0,6,6,0.0,1.0
6053,13,1,0,15,15,0.0,1.0
6104,13,1,3,1,4,0.75,0.25
5943,13,1,0,9,9,0.0,1.0
6168,13,1,0,240,240,0.0,1.0
5989,13,1,0,6,6,0.0,1.0
5963,13,1,4,16,20,0.2,0.8
6194,13,1,0,80,80,0.0,1.0
6003,13,1,1,237,238,0.004201680672268907,0.9957983193277311
6167,13,1,1,9,10,0.1,0.9
6004,13,1,1,134,135,0.007407407407407408,0.9925925925925926
6054,13,1,0,14,14,0.0,1.0
6170,13,1,1,33,34,0.029411764705882353,0.9705882352941176
6063,13,1,5,5,10,0.5,0.5
5988,13,1,0,17,17,0.0,1.0
6075,13,1,1,11,12,0.08333333333333333,0.9166666666666666
6061,13,1,0,26,26,0.0,1.0
5965,13,1,0,45,45,0.0,1.0
6040,13,1,6,6,12,0.5,0.5
6106,13,1,5,25,30,0.16666666666666666,0.8333333333333334
6082,13,1,2,11,13,0.15384615384615385,0.8461538461538461
6031,13,1,0,25,25,0.0,1.0
6039,13,1,0,58,58,0.0,1.0
6189,14,1,2,20,22,0.09090909090909091,0.9090909090909091
5936,14,1,0,31,31,0.0,1.0
6087,14,1,0,18,18,0.0,1.0
5973,14,1,0,34,34,0.0,1.0
6085,14,1,0,34,34,0.0,1.0
5948,14,1,1,41,42,0.023809523809523808,0.9761904761904762
5974,14,1,0,10,10,0.0,1.0
6090,14,1,0,1,1,0.0,1.0
6068,14,1,0,35,35,0.0,1.0
6024,14,1,2,0,2,1.0,0.0
5976,14,1,2,78,80,0.025,0.975
5962,14,1,0,59,59,0.0,1.0
6033,14,1,4,20,24,0.16666666666666666,0.8333333333333334
6038,14,1,0,7,7,0.0,1.0
6042,14,1,0,49,49,0.0,1.0
5924,14,1,0,50,50,0.0,1.0
6083,14,1,4,8,12,0.3333333333333333,0.6666666666666666
6178,14,1,1,224,225,0.0044444444444444444,0.9955555555555555
6086,14,1,0,25,25,0.0,1.0
5945,14,1,0,95,95,0.0,1.0
5925,14,1,0,122,122,0.0,1.0
5935,14,1,0,3,3,0.0,1.0
6073,14,1,2,5,7,0.2857142857142857,0.7142857142857143
5980,14,1,0,12,12,0.0,1.0
5993,14,1,0,24,24,0.0,1.0
5979,14,1,0,33,33,0.0,1.0
5966,14,1,2,24,26,0.07692307692307693,0.9230769230769231
5967,14,1,5,96,101,0.04950495049504951,0.9504950495049505
5970,14,1,0,14,14,0.0,1.0
6188,14,1,1,2,3,0.3333333333333333,0.6666666666666666
6096,14,1,1,0,1,1.0,0.0
6069,14,1,0,17,17,0.0,1.0
5937,14,1,0,6,6,0.0,1.0
5990,14,1,0,50,50,0.0,1.0
5928,14,1,0,22,22,0.0,1.0
6058,14,1,10,59,69,0.14492753623188406,0.855072463768116
6001,14,1,3,21,24,0.125,0.875
5964,14,1,0,10,10,0.0,1.0
5950,14,1,0,7,7,0.0,1.0
5991,14,1,0,20,20,0.0,1.0
6177,14,1,0,3,3,0.0,1.0
5961,14,1,0,45,45,0.0,1.0
5938,14,1,3,337,340,0.008823529411764706,0.9911764705882353
5960,14,1,0,36,36,0.0,1.0
5947,14,1,0,78,78,0.0,1.0
5957,14,1,2,5,7,0.2857142857142857,0.7142857142857143
6043,14,1,0,29,29,0.0,1.0
6014,14,1,8,2,10,0.8,0.2
6015,14,1,1,1,2,0.5,0.5
5978,14,1,2,14,16,0.125,0.875
5986,14,1,2,2,4,0.5,0.5
5969,14,1,0,4,4,0.0,1.0
5949,14,1,0,30,30,0.0,1.0
5959,14,1,0,40,40,0.0,1.0
6051,14,1,0,108,108,0.0,1.0
6029,14,1,0,20,20,0.0,1.0
6070,14,1,4,0,4,1.0,0.0
5942,14,1,0,108,108,0.0,1.0
5953,14,1,0,28,28,0.0,1.0
6076,14,1,1,13,14,0.07142857142857142,0.9285714285714286
5940,14,1,6,3,9,0.6666666666666666,0.3333333333333333
6109,14,1,4,91,95,0.042105263157894736,0.9578947368421052
6187,14,1,0,6,6,0.0,1.0
6053,14,1,0,15,15,0.0,1.0
6104,14,1,4,0,4,1.0,0.0
5943,14,1,0,9,9,0.0,1.0
6168,14,1,0,240,240,0.0,1.0
5989,14,1,0,6,6,0.0,1.0
5963,14,1,3,17,20,0.15,0.85
6194,14,1,0,80,80,0.0,1.0
6003,14,1,0,238,238,0.0,1.0
6167,14,1,0,10,10,0.0,1.0
6004,14,1,0,135,135,0.0,1.0
6054,14,1,0,14,14,0.0,1.0
6170,14,1,0,34,34,0.0,1.0
6063,14,1,4,6,10,0.4,0.6
5988,14,1,0,17,17,0.0,1.0
6075,14,1,0,12,12,0.0,1.0
6061,14,1,0,26,26,0.0,1.0
5965,14,1,0,45,45,0.0,1.0
6040,14,1,3,9,12,0.25,0.75
6106,14,1,1,29,30,0.03333333333333333,0.9666666666666667
6082,14,1,0,13,13,0.0,1.0
6031,14,1,1,24,25,0.04,0.96
6039,14,1,3,55,58,0.05172413793103448,0.9482758620689655
6189,15,1,1,21,22,0.045454545454545456,0.9545454545454546
5936,15,1,0,31,31,0.0,1.0
6087,15,1,0,18,18,0.0,1.0
5973,15,1,0,34,34,0.0,1.0
6085,15,1,0,34,34,0.0,1.0
5948,15,1,0,42,42,0.0,1.0
5974,15,1,0,10,10,0.0,1.0
6090,15,1,0,1,1,0.0,1.0
6068,15,1,0,35,35,0.0,1.0
6024,15,1,1,1,2,0.5,0.5
5976,15,1,1,79,80,0.0125,0.9875
5962,15,1,0,59,59,0.0,1.0
6033,15,1,6,18,24,0.25,0.75
6038,15,1,0,7,7,0.0,1.0
6042,15,1,0,49,49,0.0,1.0
5924,15,1,0,50,50,0.0,1.0
6083,15,1,3,9,12,0.25,0.75
6178,15,1,1,224,225,0.0044444444444444444,0.9955555555555555
6086,15,1,0,25,25,0.0,1.0
5945,15,1,0,95,95,0.0,1.0
5925,15,1,0,122,122,0.0,1.0
5935,15,1,0,3,3,0.0,1.0
6073,15,1,3,4,7,0.42857142857142855,0.5714285714285714
5980,15,1,0,12,12,0.0,1.0
5993,15,1,0,24,24,0.0,1.0
5979,15,1,0,33,33,0.0,1.0
5966,15,1,3,23,26,0.11538461538461539,0.8846153846153846
5967,15,1,2,99,101,0.019801980198019802,0.9801980198019802
5970,15,1,0,14,14,0.0,1.0
6188,15,1,2,1,3,0.6666666666666666,0.3333333333333333
6096,15,1,1,0,1,1.0,0.0
6069,15,1,0,17,17,0.0,1.0
5937,15,1,0,6,6,0.0,1.0
5990,15,1,0,50,50,0.0,1.0
5928,15,1,0,22,22,0.0,1.0
6058,15,1,3,66,69,0.043478260869565216,0.9565217391304348
6001,15,1,2,22,24,0.08333333333333333,0.9166666666666666
5964,15,1,1,9,10,0.1,0.9
5950,15,1,2,5,7,0.2857142857142857,0.7142857142857143
5991,15,1,0,20,20,0.0,1.0
6177,15,1,0,3,3,0.0,1.0
5961,15,1,0,45,45,0.0,1.0
5938,15,1,0,340,340,0.0,1.0
5960,15,1,0,36,36,0.0,1.0
5947,15,1,0,78,78,0.0,1.0
5957,15,1,2,5,7,0.2857142857142857,0.7142857142857143
6043,15,1,0,29,29,0.0,1.0
6014,15,1,9,1,10,0.9,0.1
6015,15,1,2,0,2,1.0,0.0
5978,15,1,1,15,16,0.0625,0.9375
5986,15,1,3,1,4,0.75,0.25
5969,15,1,2,2,4,0.5,0.5
5949,15,1,0,30,30,0.0,1.0
5959,15,1,3,37,40,0.075,0.925
6051,15,1,0,108,108,0.0,1.0
6029,15,1,1,19,20,0.05,0.95
6070,15,1,3,1,4,0.75,0.25
5942,15,1,0,108,108,0.0,1.0
5953,15,1,0,28,28,0.0,1.0
6076,15,1,1,13,14,0.07142857142857142,0.9285714285714286
5940,15,1,4,5,9,0.4444444444444444,0.5555555555555556
6109,15,1,4,91,95,0.042105263157894736,0.9578947368421052
6187,15,1,2,4,6,0.3333333333333333,0.6666666666666666
6053,15,1,0,15,15,0.0,1.0
6104,15,1,2,2,4,0.5,0.5
5943,15,1,0,9,9,0.0,1.0
6168,15,1,0,240,240,0.0,1.0
5989,15,1,0,6,6,0.0,1.0
5963,15,1,1,19,20,0.05,0.95
6194,15,1,0,80,80,0.0,1.0
6003,15,1,0,238,238,0.0,1.0
6167,15,1,1,9,10,0.1,0.9
6004,15,1,1,134,135,0.007407407407407408,0.9925925925925926
6054,15,1,0,14,14,0.0,1.0
6170,15,1,3,31,34,0.08823529411764706,0.9117647058823529
6063,15,1,3,7,10,0.3,0.7
5988,15,1,0,17,17,0.0,1.0
6075,15,1,0,12,12,0.0,1.0
6061,15,1,0,26,26,0.0,1.0
5965,15,1,0,45,45,0.0,1.0
6040,15,1,4,8,12,0.3333333333333333,0.6666666666666666
6106,15,1,2,28,30,0.06666666666666667,0.9333333333333333
6082,15,1,0,13,13,0.0,1.0
6031,15,1,2,23,25,0.08,0.92
6039,15,1,1,57,58,0.017241379310344827,0.9827586206896551
6189,16,1,2,20,22,0.09090909090909091,0.9090909090909091
5936,16,1,0,31,31,0.0,1.0
6087,16,1,0,18,18,0.0,1.0
5973,16,1,0,34,34,0.0,1.0
6085,16,1,0,34,34,0.0,1.0
5948,16,1,1,41,42,0.023809523809523808,0.9761904761904762
5974,16,1,0,10,10,0.0,1.0
6090,16,1,0,1,1,0.0,1.0
6068,16,1,0,35,35,0.0,1.0
6024,16,1,1,1,2,0.5,0.5
5976,16,1,2,78,80,0.025,0.975
5962,16,1,0,59,59,0.0,1.0
6033,16,1,4,20,24,0.16666666666666666,0.8333333333333334
6038,16,1,0,7,7,0.0,1.0
6042,16,1,0,49,49,0.0,1.0
5924,16,1,0,50,50,0.0,1.0
6083,16,1,1,11,12,0.08333333333333333,0.9166666666666666
6178,16,1,0,225,225,0.0,1.0
6086,16,1,0,25,25,0.0,1.0
5945,16,1,0,95,95,0.0,1.0
5925,16,1,0,122,122,0.0,1.0
5935,16,1,0,3,3,0.0,1.0
6073,16,1,1,6,7,0.14285714285714285,0.8571428571428571
5980,16,1,0,12,12,0.0,1.0
5993,16,1,0,24,24,0.0,1.0
5979,16,1,0,33,33,0.0,1.0
5966,16,1,2,24,26,0.07692307692307693,0.9230769230769231
5967,16,1,0,101,101,0.0,1.0
5970,16,1,0,14,14,0.0,1.0
6188,16,1,1,2,3,0.3333333333333333,0.6666666666666666
6096,16,1,1,0,1,1.0,0.0
6069,16,1,0,17,17,0.0,1.0
5937,16,1,0,6,6,0.0,1.0
5990,16,1,0,50,50,0.0,1.0
5928,16,1,0,22,22,0.0,1.0
6058,16,1,5,64,69,0.07246376811594203,0.927536231884058
6001,16,1,1,23,24,0.041666666666666664,0.9583333333333334
5964,16,1,1,9,10,0.1,0.9
5950,16,1,1,6,7,0.14285714285714285,0.8571428571428571
5991,16,1,0,20,20,0.0,1.0
6177,16,1,0,3,3,0.0,1.0
5961,16,1,0,45,45,0.0,1.0
5938,16,1,3,337,340,0.008823529411764706,0.9911764705882353
5960,16,1,0,36,36,0.0,1.0
5947,16,1,0,78,78,0.0,1.0
5957,16,1,2,5,7,0.2857142857142857,0.7142857142857143
6043,16,1,0,29,29,0.0,1.0
6014,16,1,6,4,10,0.6,0.4
6015,16,1,1,1,2,0.5,0.5
5978,16,1,1,15,16,0.0625,0.9375
5986,16,1,3,1,4,0.75,0.25
5969,16,1,0,4,4,0.0,1.0
5949,16,1,3,27,30,0.1,0.9
5959,16,1,1,39,40,0.025,0.975
6051,16,1,0,108,108,0.0,1.0
6029,16,1,0,20,20,0.0,1.0
6070,16,1,3,1,4,0.75,0.25
5942,16,1,0,108,108,0.0,1.0
5953,16,1,0,28,28,0.0,1.0
6076,16,1,1,13,14,0.07142857142857142,0.9285714285714286
5940,16,1,3,6,9,0.3333333333333333,0.6666666666666666
6109,16,1,3,92,95,0.031578947368421054,0.968421052631579
6187,16,1,0,6,6,0.0,1.0
6053,16,1,0,15,15,0.0,1.0
6104,16,1,4,0,4,1.0,0.0
5943,16,1,0,9,9,0.0,1.0
6168,16,1,0,240,240,0.0,1.0
5989,16,1,0,6,6,0.0,1.0
5963,16,1,2,18,20,0.1,0.9
6194,16,1,0,80,80,0.0,1.0
6003,16,1,0,238,238,0.0,1.0
6167,16,1,0,10,10,0.0,1.0
6004,16,1,1,134,135,0.007407407407407408,0.9925925925925926
6054,16,1,0,14,14,0.0,1.0
6170,16,1,2,32,34,0.058823529411764705,0.9411764705882353
6063,16,1,2,8,10,0.2,0.8
5988,16,1,0,17,17,0.0,1.0
6075,16,1,1,11,12,0.08333333333333333,0.9166666666666666
6061,16,1,0,26,26,0.0,1.0
5965,16,1,0,45,45,0.0,1.0
6040,16,1,7,5,12,0.5833333333333334,0.4166666666666667
6106,16,1,0,30,30,0.0,1.0
6082,16,1,0,13,13,0.0,1.0
6031,16,1,0,25,25,0.0,1.0
6039,16,1,1,57,58,0.017241379310344827,0.9827586206896551
6189,17,1,2,20,22,0.09090909090909091,0.9090909090909091
5936,17,1,0,31,31,0.0,1.0
6087,17,1,0,18,18,0.0,1.0
5973,17,1,0,34,34,0.0,1.0
6085,17,1,0,34,34,0.0,1.0
5948,17,1,0,42,42,0.0,1.0
5974,17,1,0,10,10,0.0,1.0
6090,17,1,0,1,1,0.0,1.0
6068,17,1,0,35,35,0.0,1.0
6024,17,1,1,1,2,0.5,0.5
5976,17,1,1,79,80,0.0125,0.9875
5962,17,1,0,59,59,0.0,1.0
6033,17,1,0,24,24,0.0,1.0
6038,17,1,0,7,7,0.0,1.0
6042,17,1,0,49,49,0.0,1.0
5924,17,1,0,50,50,0.0,1.0
6083,17,1,3,9,12,0.25,0.75
6178,17,1,0,225,225,0.0,1.0
6086,17,1,0,25,25,0.0,1.0
5945,17,1,0,95,95,0.0,1.0
5925,17,1,0,122,122,0.0,1.0
5935,17,1,0,3,3,0.0,1.0
6073,17,1,1,6,7,0.14285714285714285,0.8571428571428571
5980,17,1,2,10,12,0.16666666666666666,0.8333333333333334
5993,17,1,3,21,24,0.125,0.875
5979,17,1,0,33,33,0.0,1.0
5966,17,1,2,24,26,0.07692307692307693,0.9230769230769231
5967,17,1,2,99,101,0.019801980198019802,0.9801980198019802
5970,17,1,0,14,14,0.0,1.0
6188,17,1,1,2,3,0.3333333333333333,0.6666666666666666
6096,17,1,1,0,1,1.0,0.0
6069,17,1,0,17,17,0.0,1.0
5937,17,1,0,6,6,0.0,1.0
5990,17,1,0,50,50,0.0,1.0
5928,17,1,0,22,22,0.0,1.0
6058,17,1,6,63,69,0.08695652173913043,0.9130434782608695
6001,17,1,2,22,24,0.08333333333333333,0.9166666666666666
5964,17,1,1,9,10,0.1,0.9
5950,17,1,1,6,7,0.14285714285714285,0.8571428571428571
5991,17,1,0,20,20,0.0,1.0
6177,17,1,0,3,3,0.0,1.0
5961,17,1,0,45,45,0.0,1.0
5938,17,1,2,338,340,0.0058823529411764705,0.9941176470588236
5960,17,1,0,36,36,0.0,1.0
5947,17,1,0,78,78,0.0,1.0
5957,17,1,2,5,7,0.2857142857142857,0.7142857142857143
6043,17,1,0,29,29,0.0,1.0
6014,17,1,8,2,10,0.8,0.2
6015,17,1,2,0,2,1.0,0.0
5978,17,1,1,15,16,0.0625,0.9375
5986,17,1,3,1,4,0.75,0.25
5969,17,1,0,4,4,0.0,1.0
5949,17,1,0,30,30,0.0,1.0
5959,17,1,2,38,40,0.05,0.95
6051,17,1,0,108,108,0.0,1.0
6029,17,1,1,19,20,0.05,0.95
6070,17,1,4,0,4,1.0,0.0
5942,17,1,0,108,108,0.0,1.0
5953,17,1,0,28,28,0.0,1.0
6076,17,1,0,14,14,0.0,1.0
5940,17,1,5,4,9,0.5555555555555556,0.4444444444444444
6109,17,1,2,93,95,0.021052631578947368,0.9789473684210527
6187,17,1,0,6,6,0.0,1.0
6053,17,1,0,15,15,0.0,1.0
6104,17,1,3,1,4,0.75,0.25
5943,17,1,4,5,9,0.4444444444444444,0.5555555555555556
6168,17,1,0,240,240,0.0,1.0
5989,17,1,0,6,6,0.0,1.0
5963,17,1,2,18,20,0.1,0.9
6194,17,1,0,80,80,0.0,1.0
6003,17,1,2,236,238,0.008403361344537815,0.9915966386554622
6167,17,1,1,9,10,0.1,0.9
6004,17,1,5,130,135,0.037037037037037035,0.9629629629629629
6054,17,1,0,14,14,0.0,1.0
6170,17,1,2,32,34,0.058823529411764705,0.9411764705882353
6063,17,1,6,4,10,0.6,0.4
5988,17,1,0,17,17,0.0,1.0
6075,17,1,1,11,12,0.08333333333333333,0.9166666666666666
6061,17,1,0,26,26,0.0,1.0
5965,17,1,0,45,45,0.0,1.0
6040,17,1,6,6,12,0.5,0.5
6106,17,1,1,29,30,0.03333333333333333,0.9666666666666667
6082,17,1,0,13,13,0.0,1.0
6031,17,1,1,24,25,0.04,0.96
6039,17,1,1,57,58,0.017241379310344827,0.9827586206896551
6189,18,1,2,20,22,0.09090909090909091,0.9090909090909091
5936,18,1,0,31,31,0.0,1.0
6087,18,1,0,18,18,0.0,1.0
5973,18,1,0,34,34,0.0,1.0
6085,18,1,0,34,34,0.0,1.0
5948,18,1,1,41,42,0.023809523809523808,0.9761904761904762
5974,18,1,0,10,10,0.0,1.0
6090,18,1,0,1,1,0.0,1.0
6068,18,1,0,35,35,0.0,1.0
6024,18,1,1,1,2,0.5,0.5
5976,18,1,3,77,80,0.0375,0.9625
5962,18,1,0,59,59,0.0,1.0
6033,18,1,2,22,24,0.08333333333333333,0.9166666666666666
6038,18,1,0,7,7,0.0,1.0
6042,18,1,0,49,49,0.0,1.0
5924,18,1,0,50,50,0.0,1.0
6083,18,1,1,11,12,0.08333333333333333,0.9166666666666666
6178,18,1,0,225,225,0.0,1.0
6086,18,1,0,25,25,0.0,1.0
5945,18,1,0,95,95,0.0,1.0
5925,18,1,0,122,122,0.0,1.0
5935,18,1,0,3,3,0.0,1.0
6073,18,1,2,5,7,0.2857142857142857,0.7142857142857143
5980,18,1,0,12,12,0.0,1.0
5993,18,1,0,24,24,0.0,1.0
5979,18,1,0,33,33,0.0,1.0
5966,18,1,1,25,26,0.038461538461538464,0.9615384615384616
5967,18,1,1,100,101,0.009900990099009901,0.9900990099009901
5970,18,1,0,14,14,0.0,1.0
6188,18,1,1,2,3,0.3333333333333333,0.6666666666666666
6096,18,1,1,0,1,1.0,0.0
6069,18,1,0,17,17,0.0,1.0
5937,18,1,0,6,6,0.0,1.0
5990,18,1,0,50,50,0.0,1.0
5928,18,1,0,22,22,0.0,1.0
6058,18,1,2,67,69,0.028985507246376812,0.9710144927536232
6001,18,1,2,22,24,0.08333333333333333,0.9166666666666666
5964,18,1,1,9,10,0.1,0.9
5950,18,1,1,6,7,0.14285714285714285,0.8571428571428571
5991,18,1,0,20,20,0.0,1.0
6177,18,1,0,3,3,0.0,1.0
5961,18,1,0,45,45,0.0,1.0
5938,18,1,0,340,340,0.0,1.0
5960,18,1,0,36,36,0.0,1.0
5947,18,1,0,78,78,0.0,1.0
5957,18,1,1,6,7,0.14285714285714285,0.8571428571428571
6043,18,1,0,29,29,0.0,1.0
6014,18,1,6,4,10,0.6,0.4
6015,18,1,1,1,2,0.5,0.5
5978,18,1,2,14,16,0.125,0.875
5986,18,1,2,2,4,0.5,0.5
5969,18,1,0,4,4,0.0,1.0
5949,18,1,3,27,30,0.1,0.9
5959,18,1,1,39,40,0.025,0.975
6051,18,1,0,108,108,0.0,1.0
6029,18,1,1,19,20,0.05,0.95
6070,18,1,3,1,4,0.75,0.25
5942,18,1,0,108,108,0.0,1.0
5953,18,1,0,28,28,0.0,1.0
6076,18,1,1,13,14,0.07142857142857142,0.9285714285714286
5940,18,1,3,6,9,0.3333333333333333,0.6666666666666666
6109,18,1,1,94,95,0.010526315789473684,0.9894736842105263
6187,18,1,2,4,6,0.3333333333333333,0.6666666666666666
6053,18,1,0,15,15,0.0,1.0
6104,18,1,4,0,4,1.0,0.0
5943,18,1,0,9,9,0.0,1.0
6168,18,1,0,240,240,0.0,1.0
5989,18,1,0,6,6,0.0,1.0
5963,18,1,0,20,20,0.0,1.0
6194,18,1,0,80,80,0.0,1.0
6003,18,1,2,236,238,0.008403361344537815,0.9915966386554622
6167,18,1,2,8,10,0.2,0.8
6004,18,1,1,134,135,0.007407407407407408,0.9925925925925926
6054,18,1,0,14,14,0.0,1.0
6170,18,1,1,33,34,0.029411764705882353,0.9705882352941176
6063,18,1,3,7,10,0.3,0.7
5988,18,1,0,17,17,0.0,1.0
6075,18,1,2,10,12,0.16666666666666666,0.8333333333333334
6061,18,1,0,26,26,0.0,1.0
5965,18,1,0,45,45,0.0,1.0
6040,18,1,7,5,12,0.5833333333333334,0.4166666666666667
6106,18,1,2,28,30,0.06666666666666667,0.9333333333333333
6082,18,1,2,11,13,0.15384615384615385,0.8461538461538461
6031,18,1,2,23,25,0.08,0.92
6039,18,1,1,57,58,0.017241379310344827,0.9827586206896551
6189,19,1,0,22,22,0.0,1.0
5936,19,1,0,31,31,0.0,1.0
6087,19,1,0,18,18,0.0,1.0
5973,19,1,0,34,34,0.0,1.0
6085,19,1,0,34,34,0.0,1.0
5948,19,1,0,42,42,0.0,1.0
5974,19,1,0,10,10,0.0,1.0
6090,19,1,0,1,1,0.0,1.0
6068,19,1,0,35,35,0.0,1.0
6024,19,1,2,0,2,1.0,0.0
5976,19,1,2,78,80,0.025,0.975
5962,19,1,0,59,59,0.0,1.0
6033,19,1,4,20,24,0.16666666666666666,0.8333333333333334
6038,19,1,0,7,7,0.0,1.0
6042,19,1,0,49,49,0.0,1.0
5924,19,1,0,50,50,0.0,1.0
6083,19,1,2,10,12,0.16666666666666666,0.8333333333333334
6178,19,1,0,225,225,0.0,1.0
6086,19,1,0,25,25,0.0,1.0
5945,19,1,0,95,95,0.0,1.0
5925,19,1,0,122,122,0.0,1.0
5935,19,1,0,3,3,0.0,1.0
6073,19,1,1,6,7,0.14285714285714285,0.8571428571428571
5980,19,1,0,12,12,0.0,1.0
5993,19,1,0,24,24,0.0,1.0
5979,19,1,0,33,33,0.0,1.0
5966,19,1,2,24,26,0.07692307692307693,0.9230769230769231
5967,19,1,3,98,101,0.0297029702970297,0.9702970297029703
5970,19,1,0,14,14,0.0,1.0
6188,19,1,1,2,3,0.3333333333333333,0.6666666666666666
6096,19,1,1,0,1,1.0,0.0
6069,19,1,0,17,17,0.0,1.0
5937,19,1,0,6,6,0.0,1.0
5990,19,1,0,50,50,0.0,1.0
5928,19,1,0,22,22,0.0,1.0
6058,19,1,4,65,69,0.057971014492753624,0.9420289855072463
6001,19,1,4,20,24,0.16666666666666666,0.8333333333333334
5964,19,1,0,10,10,0.0,1.0
5950,19,1,2,5,7,0.2857142857142857,0.7142857142857143
5991,19,1,0,20,20,0.0,1.0
6177,19,1,0,3,3,0.0,1.0
5961,19,1,0,45,45,0.0,1.0
5938,19,1,0,340,340,0.0,1.0
5960,19,1,0,36,36,0.0,1.0
5947,19,1,0,78,78,0.0,1.0
5957,19,1,3,4,7,0.42857142857142855,0.5714285714285714
6043,19,1,0,29,29,0.0,1.0
6014,19,1,6,4,10,0.6,0.4
6015,19,1,1,1,2,0.5,0.5
5978,19,1,1,15,16,0.0625,0.9375
5986,19,1,3,1,4,0.75,0.25
5969,19,1,0,4,4,0.0,1.0
5949,19,1,0,30,30,0.0,1.0
5959,19,1,0,40,40,0.0,1.0
6051,19,1,0,108,108,0.0,1.0
6029,19,1,0,20,20,0.0,1.0
6070,19,1,4,0,4,1.0,0.0
5942,19,1,0,108,108,0.0,1.0
5953,19,1,0,28,28,0.0,1.0
6076,19,1,1,13,14,0.07142857142857142,0.9285714285714286
5940,19,1,5,4,9,0.5555555555555556,0.4444444444444444
6109,19,1,1,94,95,0.010526315789473684,0.9894736842105263
6187,19,1,2,4,6,0.3333333333333333,0.6666666666666666
6053,19,1,0,15,15,0.0,1.0
6104,19,1,3,1,4,0.75,0.25
5943,19,1,0,9,9,0.0,1.0
6168,19,1,0,240,240,0.0,1.0
5989,19,1,0,6,6,0.0,1.0
5963,19,1,1,19,20,0.05,0.95
6194,19,1,0,80,80,0.0,1.0
6003,19,1,1,237,238,0.004201680672268907,0.9957983193277311
6167,19,1,1,9,10,0.1,0.9
6004,19,1,0,135,135,0.0,1.0
6054,19,1,0,14,14,0.0,1.0
6170,19,1,3,31,34,0.08823529411764706,0.9117647058823529
6063,19,1,4,6,10,0.4,0.6
5988,19,1,0,17,17,0.0,1.0
6075,19,1,2,10,12,0.16666666666666666,0.8333333333333334
6061,19,1,0,26,26,0.0,1.0
5965,19,1,0,45,45,0.0,1.0
6040,19,1,7,5,12,0.5833333333333334,0.4166666666666667
6106,19,1,2,28,30,0.06666666666666667,0.9333333333333333
6082,19,1,0,13,13,0.0,1.0
6031,19,1,0,25,25,0.0,1.0
6039,19,1,4,54,58,0.06896551724137931,0.9310344827586207
6189,20,1,1,21,22,0.045454545454545456,0.9545454545454546
5936,20,1,0,31,31,0.0,1.0
6087,20,1,0,18,18,0.0,1.0
5973,20,1,0,34,34,0.0,1.0
6085,20,1,0,34,34,0.0,1.0
5948,20,1,0,42,42,0.0,1.0
5974,20,1,0,10,10,0.0,1.0
6090,20,1,0,1,1,0.0,1.0
6068,20,1,0,35,35,0.0,1.0
6024,20,1,2,0,2,1.0,0.0
5976,20,1,1,79,80,0.0125,0.9875
5962,20,1,0,59,59,0.0,1.0
6033,20,1,2,22,24,0.08333333333333333,0.9166666666666666
6038,20,1,0,7,7,0.0,1.0
6042,20,1,0,49,49,0.0,1.0
5924,20,1,0,50,50,0.0,1.0
6083,20,1,2,10,12,0.16666666666666666,0.8333333333333334
6178,20,1,0,225,225,0.0,1.0
6086,20,1,0,25,25,0.0,1.0
5945,20,1,0,95,95,0.0,1.0
5925,20,1,0,122,122,0.0,1.0
5935,20,1,0,3,3,0.0,1.0
6073,20,1,2,5,7,0.2857142857142857,0.7142857142857143
5980,20,1,0,12,12,0.0,1.0
5993,20,1,3,21,24,0.125,0.875
5979,20,1,0,33,33,0.0,1.0
5966,20,1,2,24,26,0.07692307692307693,0.9230769230769231
5967,20,1,1,100,101,0.009900990099009901,0.9900990099009901
5970,20,1,0,14,14,0.0,1.0
6188,20,1,2,1,3,0.6666666666666666,0.3333333333333333
6096,20,1,1,0,1,1.0,0.0
6069,20,1,0,17,17,0.0,1.0
5937,20,1,0,6,6,0.0,1.0
5990,20,1,0,50,50,0.0,1.0
5928,20,1,0,22,22,0.0,1.0
6058,20,1,5,64,69,0.07246376811594203,0.927536231884058
6001,20,1,1,23,24,0.041666666666666664,0.9583333333333334
5964,20,1,0,10,10,0.0,1.0
5950,20,1,0,7,7,0.0,1.0
5991,20,1,0,20,20,0.0,1.0
6177,20,1,0,3,3,0.0,1.0
5961,20,1,0,45,45,0.0,1.0
5938,20,1,0,340,340,0.0,1.0
5960,20,1,0,36,36,0.0,1.0
5947,20,1,0,78,78,0.0,1.0
5957,20,1,3,4,7,0.42857142857142855,0.5714285714285714
6043,20,1,0,29,29,0.0,1.0
6014,20,1,6,4,10,0.6,0.4
6015,20,1,1,1,2,0.5,0.5
5978,20,1,1,15,16,0.0625,0.9375
5986,20,1,2,2,4,0.5,0.5
5969,20,1,0,4,4,0.0,1.0
5949,20,1,3,27,30,0.1,0.9
5959,20,1,1,39,40,0.025,0.975
6051,20,1,0,108,108,0.0,1.0
6029,20,1,0,20,20,0.0,1.0
6070,20,1,2,2,4,0.5,0.5
5942,20,1,0,108,108,0.0,1.0
5953,20,1,0,28,28,0.0,1.0
6076,20,1,1,13,14,0.07142857142857142,0.9285714285714286
5940,20,1,3,6,9,0.3333333333333333,0.6666666666666666
6109,20,1,2,93,95,0.021052631578947368,0.9789473684210527
6187,20,1,0,6,6,0.0,1.0
6053,20,1,0,15,15,0.0,1.0
6104,20,1,2,2,4,0.5,0.5
5943,20,1,0,9,9,0.0,1.0
6168,20,1,0,240,240,0.0,1.0
5989,20,1,0,6,6,0.0,1.0
5963,20,1,0,20,20,0.0,1.0
6194,20,1,0,80,80,0.0,1.0
6003,20,1,0,238,238,0.0,1.0
6167,20,1,1,9,10,0.1,0.9
6004,20,1,1,134,135,0.007407407407407408,0.9925925925925926
6054,20,1,0,14,14,0.0,1.0
6170,20,1,0,34,34,0.0,1.0
6063,20,1,6,4,10,0.6,0.4
5988,20,1,0,17,17,0.0,1.0
6075,20,1,1,11,12,0.08333333333333333,0.9166666666666666
6061,20,1,0,26,26,0.0,1.0
5965,20,1,0,45,45,0.0,1.0
6040,20,1,7,5,12,0.5833333333333334,0.4166666666666667
6106,20,1,2,28,30,0.06666666666666667,0.9333333333333333
6082,20,1,0,13,13,0.0,1.0
6031,20,1,2,23,25,0.08,0.92
6039,20,1,4,54,58,0.06896551724137931,0.9310344827586207
6189,21,1,1,21,22,0.045454545454545456,0.9545454545454546
5936,21,1,0,31,31,0.0,1.0
6087,21,1,0,18,18,0.0,1.0
5973,21,1,0,34,34,0.0,1.0
6085,21,1,0,34,34,0.0,1.0
5948,21,1,1,41,42,0.023809523809523808,0.9761904761904762
5974,21,1,0,10,10,0.0,1.0
6090,21,1,0,1,1,0.0,1.0
6068,21,1,0,35,35,0.0,1.0
6024,21,1,1,1,2,0.5,0.5
5976,21,1,2,78,80,0.025,0.975
5962,21,1,0,59,59,0.0,1.0
6033,21,1,2,22,24,0.08333333333333333,0.9166666666666666
6038,21,1,0,7,7,0.0,1.0
6042,21,1,0,49,49,0.0,1.0
5924,21,1,0,50,50,0.0,1.0
6083,21,1,4,8,12,0.3333333333333333,0.6666666666666666
6178,21,1,0,225,225,0.0,1.0
6086,21,1,0,25,25,0.0,1.0
5945,21,1,0,95,95,0.0,1.0
5925,21,1,0,122,122,0.0,1.0
5935,21,1,0,3,3,0.0,1.0
6073,21,1,3,4,7,0.42857142857142855,0.5714285714285714
5980,21,1,0,12,12,0.0,1.0
5993,21,1,0,24,24,0.0,1.0
5979,21,1,0,33,33,0.0,1.0
5966,21,1,1,25,26,0.038461538461538464,0.9615384615384616
5967,21,1,2,99,101,0.019801980198019802,0.9801980198019802
5970,21,1,0,14,14,0.0,1.0
6188,21,1,3,0,3,1.0,0.0
6096,21,1,1,0,1,1.0,0.0
6069,21,1,0,17,17,0.0,1.0
5937,21,1,0,6,6,0.0,1.0
5990,21,1,0,50,50,0.0,1.0
5928,21,1,0,22,22,0.0,1.0
6058,21,1,5,64,69,0.07246376811594203,0.927536231884058
6001,21,1,1,23,24,0.041666666666666664,0.9583333333333334
5964,21,1,1,9,10,0.1,0.9
5950,21,1,1,6,7,0.14285714285714285,0.8571428571428571
5991,21,1,0,20,20,0.0,1.0
6177,21,1,0,3,3,0.0,1.0
5961,21,1,0,45,45,0.0,1.0
5938,21,1,0,340,340,0.0,1.0
5960,21,1,0,36,36,0.0,1.0
5947,21,1,0,78,78,0.0,1.0
5957,21,1,1,6,7,0.14285714285714285,0.8571428571428571
6043,21,1,0,29,29,0.0,1.0
6014,21,1,7,3,10,0.7,0.3
6015,21,1,1,1,2,0.5,0.5
5978,21,1,1,15,16,0.0625,0.9375
5986,21,1,4,0,4,1.0,0.0
5969,21,1,0,4,4,0.0,1.0
5949,21,1,0,30,30,0.0,1.0
5959,21,1,0,40,40,0.0,1.0
6051,21,1,0,108,108,0.0,1.0
6029,21,1,1,19,20,0.05,0.95
6070,21,1,1,3,4,0.25,0.75
5942,21,1,0,108,108,0.0,1.0
5953,21,1,0,28,28,0.0,1.0
6076,21,1,0,14,14,0.0,1.0
5940,21,1,4,5,9,0.4444444444444444,0.5555555555555556
6109,21,1,0,95,95,0.0,1.0
6187,21,1,0,6,6,0.0,1.0
6053,21,1,0,15,15,0.0,1.0
6104,21,1,3,1,4,0.75,0.25
5943,21,1,0,9,9,0.0,1.0
6168,21,1,0,240,240,0.0,1.0
5989,21,1,0,6,6,0.0,1.0
5963,21,1,0,20,20,0.0,1.0
6194,21,1,0,80,80,0.0,1.0
6003,21,1,1,237,238,0.004201680672268907,0.9957983193277311
6167,21,1,1,9,10,0.1,0.9
6004,21,1,1,134,135,0.007407407407407408,0.9925925925925926
6054,21,1,0,14,14,0.0,1.0
6170,21,1,3,31,34,0.08823529411764706,0.9117647058823529
6063,21,1,3,7,10,0.3,0.7
5988,21,1,0,17,17,0.0,1.0
6075,21,1,1,11,12,0.08333333333333333,0.9166666666666666
6061,21,1,0,26,26,0.0,1.0
5965,21,1,0,45,45,0.0,1.0
6040,21,1,4,8,12,0.3333333333333333,0.6666666666666666
6106,21,1,1,29,30,0.03333333333333333,0.9666666666666667
6082,21,1,0,13,13,0.0,1.0
6031,21,1,2,23,25,0.08,0.92
6039,21,1,1,57,58,0.017241379310344827,0.9827586206896551
6189,22,1,1,21,22,0.045454545454545456,0.9545454545454546
5936,22,1,0,31,31,0.0,1.0
6087,22,1,0,18,18,0.0,1.0
5973,22,1,0,34,34,0.0,1.0
6085,22,1,0,34,34,0.0,1.0
5948,22,1,0,42,42,0.0,1.0
5974,22,1,0,10,10,0.0,1.0
6090,22,1,0,1,1,0.0,1.0
6068,22,1,0,35,35,0.0,1.0
6024,22,1,1,1,2,0.5,0.5
5976,22,1,2,78,80,0.025,0.975
5962,22,1,0,59,59,0.0,1.0
6033,22,1,0,24,24,0.0,1.0
6038,22,1,0,7,7,0.0,1.0
6042,22,1,0,49,49,0.0,1.0
5924,22,1,0,50,50,0.0,1.0
6083,22,1,3,9,12,0.25,0.75
6178,22,1,0,225,225,0.0,1.0
6086,22,1,0,25,25,0.0,1.0
5945,22,1,0,95,95,0.0,1.0
5925,22,1,0,122,122,0.0,1.0
5935,22,1,0,3,3,0.0,1.0
6073,22,1,1,6,7,0.14285714285714285,0.8571428571428571
5980,22,1,0,12,12,0.0,1.0
5993,22,1,0,24,24,0.0,1.0
5979,22,1,0,33,33,0.0,1.0
5966,22,1,0,26,26,0.0,1.0
5967,22,1,3,98,101,0.0297029702970297,0.9702970297029703
5970,22,1,0,14,14,0.0,1.0
6188,22,1,0,3,3,0.0,1.0
6096,22,1,1,0,1,1.0,0.0
6069,22,1,0,17,17,0.0,1.0
5937,22,1,0,6,6,0.0,1.0
5990,22,1,0,50,50,0.0,1.0
5928,22,1,0,22,22,0.0,1.0
6058,22,1,5,64,69,0.07246376811594203,0.927536231884058
6001,22,1,1,23,24,0.041666666666666664,0.9583333333333334
5964,22,1,4,6,10,0.4,0.6
5950,22,1,0,7,7,0.0,1.0
5991,22,1,0,20,20,0.0,1.0
6177,22,1,0,3,3,0.0,1.0
5961,22,1,0,45,45,0.0,1.0
5938,22,1,3,337,340,0.008823529411764706,0.9911764705882353
5960,22,1,0,36,36,0.0,1.0
5947,22,1,0,78,78,0.0,1.0
5957,22,1,2,5,7,0.2857142857142857,0.7142857142857143
6043,22,1,0,29,29,0.0,1.0
6014,22,1,8,2,10,0.8,0.2
6015,22,1,1,1,2,0.5,0.5
5978,22,1,1,15,16,0.0625,0.9375
5986,22,1,4,0,4,1.0,0.0
5969,22,1,0,4,4,0.0,1.0
5949,22,1,0,30,30,0.0,1.0
5959,22,1,1,39,40,0.025,0.975
6051,22,1,0,108,108,0.0,1.0
6029,22,1,0,20,20,0.0,1.0
6070,22,1,3,1,4,0.75,0.25
5942,22,1,0,108,108,0.0,1.0
5953,22,1,0,28,28,0.0,1.0
6076,22,1,0,14,14,0.0,1.0
5940,22,1,4,5,9,0.4444444444444444,0.5555555555555556
6109,22,1,0,95,95,0.0,1.0
6187,22,1,0,6,6,0.0,1.0
6053,22,1,0,15,15,0.0,1.0
6104,22,1,2,2,4,0.5,0.5
5943,22,1,0,9,9,0.0,1.0
6168,22,1,0,240,240,0.0,1.0
5989,22,1,0,6,6,0.0,1.0
5963,22,1,0,20,20,0.0,1.0
6194,22,1,0,80,80,0.0,1.0
6003,22,1,1,237,238,0.004201680672268907,0.9957983193277311
6167,22,1,2,8,10,0.2,0.8
6004,22,1,0,135,135,0.0,1.0
6054,22,1,0,14,14,0.0,1.0
6170,22,1,1,33,34,0.029411764705882353,0.9705882352941176
6063,22,1,4,6,10,0.4,0.6
5988,22,1,0,17,17,0.0,1.0
6075,22,1,2,10,12,0.16666666666666666,0.8333333333333334
6061,22,1,0,26,26,0.0,1.0
5965,22,1,0,45,45,0.0,1.0
6040,22,1,5,7,12,0.4166666666666667,0.5833333333333334
6106,22,1,1,29,30,0.03333333333333333,0.9666666666666667
6082,22,1,0,13,13,0.0,1.0
6031,22,1,1,24,25,0.04,0.96
6039,22,1,0,58,58,0.0,1.0
6189,23,1,0,22,22,0.0,1.0
5936,23,1,0,31,31,0.0,1.0
6087,23,1,0,18,18,0.0,1.0
5973,23,1,0,34,34,0.0,1.0
6085,23,1,0,34,34,0.0,1.0
5948,23,1,0,42,42,0.0,1.0
5974,23,1,0,10,10,0.0,1.0
6090,23,1,0,1,1,0.0,1.0
6068,23,1,0,35,35,0.0,1.0
6024,23,1,1,1,2,0.5,0.5
5976,23,1,0,80,80,0.0,1.0
5962,23,1,0,59,59,0.0,1.0
6033,23,1,2,22,24,0.08333333333333333,0.9166666666666666
6038,23,1,0,7,7,0.0,1.0
6042,23,1,0,49,49,0.0,1.0
5924,23,1,0,50,50,0.0,1.0
6083,23,1,5,7,12,0.4166666666666667,0.5833333333333334
6178,23,1,0,225,225,0.0,1.0
6086,23,1,0,25,25,0.0,1.0
5945,23,1,0,95,95,0.0,1.0
5925,23,1,0,122,122,0.0,1.0
5935,23,1,0,3,3,0.0,1.0
6073,23,1,2,5,7,0.2857142857142857,0.7142857142857143
5980,23,1,0,12,12,0.0,1.0
5993,23,1,3,21,24,0.125,0.875
5979,23,1,0,33,33,0.0,1.0
5966,23,1,3,23,26,0.11538461538461539,0.8846153846153846
5967,23,1,2,99,101,0.019801980198019802,0.9801980198019802
5970,23,1,0,14,14,0.0,1.0
6188,23,1,1,2,3,0.3333333333333333,0.6666666666666666
6096,23,1,1,0,1,1.0,0.0
6069,23,1,0,17,17,0.0,1.0
5937,23,1,0,6,6,0.0,1.0
5990,23,1,0,50,50,0.0,1.0
5928,23,1,0,22,22,0.0,1.0
6058,23,1,2,67,69,0.028985507246376812,0.9710144927536232
6001,23,1,4,20,24,0.16666666666666666,0.8333333333333334
5964,23,1,0,10,10,0.0,1.0
5950,23,1,0,7,7,0.0,1.0
5991,23,1,0,20,20,0.0,1.0
6177,23,1,0,3,3,0.0,1.0
5961,23,1,0,45,45,0.0,1.0
5938,23,1,0,340,340,0.0,1.0
5960,23,1,0,36,36,0.0,1.0
5947,23,1,0,78,78,0.0,1.0
5957,23,1,1,6,7,0.14285714285714285,0.8571428571428571
6043,23,1,0,29,29,0.0,1.0
6014,23,1,5,5,10,0.5,0.5
6015,23,1,1,1,2,0.5,0.5
5978,23,1,1,15,16,0.0625,0.9375
5986,23,1,3,1,4,0.75,0.25
5969,23,1,0,4,4,0.0,1.0
5949,23,1,0,30,30,0.0,1.0
5959,23,1,6,34,40,0.15,0.85
6051,23,1,0,108,108,0.0,1.0
6029,23,1,1,19,20,0.05,0.95
6070,23,1,3,1,4,0.75,0.25
5942,23,1,0,108,108,0.0,1.0
5953,23,1,0,28,28,0.0,1.0
6076,23,1,1,13,14,0.07142857142857142,0.9285714285714286
5940,23,1,3,6,9,0.3333333333333333,0.6666666666666666
6109,23,1,1,94,95,0.010526315789473684,0.9894736842105263
6187,23,1,0,6,6,0.0,1.0
6053,23,1,0,15,15,0.0,1.0
6104,23,1,2,2,4,0.5,0.5
5943,23,1,0,9,9,0.0,1.0
6168,23,1,0,240,240,0.0,1.0
5989,23,1,0,6,6,0.0,1.0
5963,23,1,1,19,20,0.05,0.95
6194,23,1,0,80,80,0.0,1.0
6003,23,1,1,237,238,0.004201680672268907,0.9957983193277311
6167,23,1,0,10,10,0.0,1.0
6004,23,1,0,135,135,0.0,1.0
6054,23,1,0,14,14,0.0,1.0
6170,23,1,5,29,34,0.14705882352941177,0.8529411764705882
6063,23,1,3,7,10,0.3,0.7
5988,23,1,0,17,17,0.0,1.0
6075,23,1,1,11,12,0.08333333333333333,0.9166666666666666
6061,23,1,0,26,26,0.0,1.0
5965,23,1,0,45,45,0.0,1.0
6040,23,1,6,6,12,0.5,0.5
6106,23,1,1,29,30,0.03333333333333333,0.9666666666666667
6082,23,1,0,13,13,0.0,1.0
6031,23,1,2,23,25,0.08,0.92
6039,23,1,1,57,58,0.017241379310344827,0.9827586206896551
6189,24,1,0,22,22,0.0,1.0
5936,24,1,0,31,31,0.0,1.0
6087,24,1,0,18,18,0.0,1.0
5973,24,1,0,34,34,0.0,1.0
6085,24,1,0,34,34,0.0,1.0
5948,24,1,1,41,42,0.023809523809523808,0.9761904761904762
5974,24,1,0,10,10,0.0,1.0
6090,24,1,0,1,1,0.0,1.0
6068,24,1,0,35,35,0.0,1.0
6024,24,1,1,1,2,0.5,0.5
5976,24,1,1,79,80,0.0125,0.9875
5962,24,1,0,59,59,0.0,1.0
6033,24,1,0,24,24,0.0,1.0
6038,24,1,0,7,7,0.0,1.0
6042,24,1,0,49,49,0.0,1.0
5924,24,1,0,50,50,0.0,1.0
6083,24,1,6,6,12,0.5,0.5
6178,24,1,0,225,225,0.0,1.0
6086,24,1,0,25,25,0.0,1.0
5945,24,1,0,95,95,0.0,1.0
5925,24,1,0,122,122,0.0,1.0
5935,24,1,0,3,3,0.0,1.0
6073,24,1,4,3,7,0.5714285714285714,0.42857142857142855
5980,24,1,0,12,12,0.0,1.0
5993,24,1,0,24,24,0.0,1.0
5979,24,1,0,33,33,0.0,1.0
5966,24,1,0,26,26,0.0,1.0
5967,24,1,1,100,101,0.009900990099009901,0.9900990099009901
5970,24,1,0,14,14,0.0,1.0
6188,24,1,0,3,3,0.0,1.0
6096,24,1,1,0,1,1.0,0.0
6069,24,1,0,17,17,0.0,1.0
5937,24,1,0,6,6,0.0,1.0
5990,24,1,0,50,50,0.0,1.0
5928,24,1,0,22,22,0.0,1.0
6058,24,1,5,64,69,0.07246376811594203,0.927536231884058
6001,24,1,3,21,24,0.125,0.875
5964,24,1,1,9,10,0.1,0.9
5950,24,1,1,6,7,0.14285714285714285,0.8571428571428571
5991,24,1,0,20,20,0.0,1.0
6177,24,1,0,3,3,0.0,1.0
5961,24,1,0,45,45,0.0,1.0
5938,24,1,0,340,340,0.0,1.0
5960,24,1,0,36,36,0.0,1.0
5947,24,1,0,78,78,0.0,1.0
5957,24,1,1,6,7,0.14285714285714285,0.8571428571428571
6043,24,1,0,29,29,0.0,1.0
6014,24,1,4,6,10,0.4,0.6
6015,24,1,1,1,2,0.5,0.5
5978,24,1,1,15,16,0.0625,0.9375
5986,24,1,2,2,4,0.5,0.5
5969,24,1,1,3,4,0.25,0.75
5949,24,1,0,30,30,0.0,1.0
5959,24,1,1,39,40,0.025,0.975
6051,24,1,0,108,108,0.0,1.0
6029,24,1,0,20,20,0.0,1.0
6070,24,1,2,2,4,0.5,0.5
5942,24,1,0,108,108,0.0,1.0
5953,24,1,0,28,28,0.0,1.0
6076,24,1,1,13,14,0.07142857142857142,0.9285714285714286
5940,24,1,5,4,9,0.5555555555555556,0.4444444444444444
6109,24,1,0,95,95,0.0,1.0
6187,24,1,0,6,6,0.0,1.0
6053,24,1,0,15,15,0.0,1.0
6104,24,1,2,2,4,0.5,0.5
5943,24,1,0,9,9,0.0,1.0
6168,24,1,0,240,240,0.0,1.0
5989,24,1,0,6,6,0.0,1.0
5963,24,1,1,19,20,0.05,0.95
6194,24,1,0,80,80,0.0,1.0
6003,24,1,0,238,238,0.0,1.0
6167,24,1,0,10,10,0.0,1.0
6004,24,1,0,135,135,0.0,1.0
6054,24,1,0,14,14,0.0,1.0
6170,24,1,1,33,34,0.029411764705882353,0.9705882352941176
6063,24,1,2,8,10,0.2,0.8
5988,24,1,0,17,17,0.0,1.0
6075,24,1,1,11,12,0.08333333333333333,0.9166666666666666
6061,24,1,0,26,26,0.0,1.0
5965,24,1,0,45,45,0.0,1.0
6040,24,1,7,5,12,0.5833333333333334,0.4166666666666667
6106,24,1,2,28,30,0.06666666666666667,0.9333333333333333
6082,24,1,0,13,13,0.0,1.0
6031,24,1,2,23,25,0.08,0.92
6039,24,1,1,57,58,0.017241379310344827,0.9827586206896551
6189,25,1,1,21,22,0.045454545454545456,0.9545454545454546
5936,25,1,0,31,31,0.0,1.0
6087,25,1,0,18,18,0.0,1.0
5973,25,1,0,34,34,0.0,1.0
6085,25,1,0,34,34,0.0,1.0
5948,25,1,0,42,42,0.0,1.0
5974,25,1,0,10,10,0.0,1.0
6090,25,1,0,1,1,0.0,1.0
6068,25,1,0,35,35,0.0,1.0
6024,25,1,1,1,2,0.5,0.5
5976,25,1,0,80,80,0.0,1.0
5962,25,1,0,59,59,0.0,1.0
6033,25,1,2,22,24,0.08333333333333333,0.9166666666666666
6038,25,1,0,7,7,0.0,1.0
6042,25,1,0,49,49,0.0,1.0
5924,25,1,0,50,50,0.0,1.0
6083,25,1,1,11,12,0.08333333333333333,0.9166666666666666
6178,25,1,0,225,225,0.0,1.0
6086,25,1,0,25,25,0.0,1.0
5945,25,1,0,95,95,0.0,1.0
5925,25,1,0,122,122,0.0,1.0
5935,25,1,0,3,3,0.0,1.0
6073,25,1,0,7,7,0.0,1.0
5980,25,1,0,12,12,0.0,1.0
5993,25,1,0,24,24,0.0,1.0
5979,25,1,0,33,33,0.0,1.0
5966,25,1,3,23,26,0.11538461538461539,0.8846153846153846
5967,25,1,0,101,101,0.0,1.0
5970,25,1,0,14,14,0.0,1.0
6188,25,1,0,3,3,0.0,1.0
6096,25,1,1,0,1,1.0,0.0
6069,25,1,0,17,17,0.0,1.0
5937,25,1,0,6,6,0.0,1.0
5990,25,1,0,50,50,0.0,1.0
5928,25,1,0,22,22,0.0,1.0
6058,25,1,4,65,69,0.057971014492753624,0.9420289855072463
6001,25,1,2,22,24,0.08333333333333333,0.9166666666666666
5964,25,1,1,9,10,0.1,0.9
5950,25,1,1,6,7,0.14285714285714285,0.8571428571428571
5991,25,1,0,20,20,0.0,1.0
6177,25,1,0,3,3,0.0,1.0
5961,25,1,0,45,45,0.0,1.0
5938,25,1,2,338,340,0.0058823529411764705,0.9941176470588236
5960,25,1,0,36,36,0.0,1.0
5947,25,1,0,78,78,0.0,1.0
5957,25,1,0,7,7,0.0,1.0
6043,25,1,0,29,29,0.0,1.0
6014,25,1,7,3,10,0.7,0.3
6015,25,1,1,1,2,0.5,0.5
5978,25,1,1,15,16,0.0625,0.9375
5986,25,1,2,2,4,0.5,0.5
5969,25,1,0,4,4,0.0,1.0
5949,25,1,0,30,30,0.0,1.0
5959,25,1,0,40,40,0.0,1.0
6051,25,1,0,108,108,0.0,1.0
6029,25,1,0,20,20,0.0,1.0
6070,25,1,0,4,4,0.0,1.0
5942,25,1,0,108,108,0.0,1.0
5953,25,1,0,28,28,0.0,1.0
6076,25,1,0,14,14,0.0,1.0
5940,25,1,3,6,9,0.3333333333333333,0.6666666666666666
6109,25,1,1,94,95,0.010526315789473684,0.9894736842105263
6187,25,1,2,4,6,0.3333333333333333,0.6666666666666666
6053,25,1,0,15,15,0.0,1.0
6104,25,1,3,1,4,0.75,0.25
5943,25,1,0,9,9,0.0,1.0
6168,25,1,0,240,240,0.0,1.0
5989,25,1,0,6,6,0.0,1.0
5963,25,1,1,19,20,0.05,0.95
6194,25,1,0,80,80,0.0,1.0
6003,25,1,0,238,238,0.0,1.0
6167,25,1,1,9,10,0.1,0.9
6004,25,1,1,134,135,0.007407407407407408,0.9925925925925926
6054,25,1,0,14,14,0.0,1.0
6170,25,1,6,28,34,0.17647058823529413,0.8235294117647058
6063,25,1,3,7,10,0.3,0.7
5988,25,1,0,17,17,0.0,1.0
6075,25,1,1,11,12,0.08333333333333333,0.9166666666666666
6061,25,1,0,26,26,0.0,1.0
5965,25,1,0,45,45,0.0,1.0
6040,25,1,3,9,12,0.25,0.75
6106,25,1,0,30,30,0.0,1.0
6082,25,1,0,13,13,0.0,1.0
6031,25,1,1,24,25,0.04,0.96
6039,25,1,4,54,58,0.06896551724137931,0.9310344827586207
6189,26,1,0,22,22,0.0,1.0
5936,26,1,0,31,31,0.0,1.0
6087,26,1,0,18,18,0.0,1.0
5973,26,1,0,34,34,0.0,1.0
6085,26,1,0,34,34,0.0,1.0
5948,26,1,1,41,42,0.023809523809523808,0.9761904761904762
5974,26,1,0,10,10,0.0,1.0
6090,26,1,0,1,1,0.0,1.0
6068,26,1,0,35,35,0.0,1.0
6024,26,1,1,1,2,0.5,0.5
5976,26,1,0,80,80,0.0,1.0
5962,26,1,0,59,59,0.0,1.0
6033,26,1,2,22,24,0.08333333333333333,0.9166666666666666
6038,26,1,0,7,7,0.0,1.0
6042,26,1,0,49,49,0.0,1.0
5924,26,1,0,50,50,0.0,1.0
6083,26,1,2,10,12,0.16666666666666666,0.8333333333333334
6178,26,1,0,225,225,0.0,1.0
6086,26,1,0,25,25,0.0,1.0
5945,26,1,0,95,95,0.0,1.0
5925,26,1,0,122,122,0.0,1.0
5935,26,1,0,3,3,0.0,1.0
6073,26,1,2,5,7,0.2857142857142857,0.7142857142857143
5980,26,1,0,12,12,0.0,1.0
5993,26,1,0,24,24,0.0,1.0
5979,26,1,0,33,33,0.0,1.0
5966,26,1,0,26,26,0.0,1.0
5967,26,1,1,100,101,0.009900990099009901,0.9900990099009901
5970,26,1,0,14,14,0.0,1.0
6188,26,1,1,2,3,0.3333333333333333,0.6666666666666666
6096,26,1,1,0,1,1.0,0.0
6069,26,1,0,17,17,0.0,1.0
5937,26,1,0,6,6,0.0,1.0
5990,26,1,0,50,50,0.0,1.0
5928,26,1,0,22,22,0.0,1.0
6058,26,1,3,66,69,0.043478260869565216,0.9565217391304348
6001,26,1,3,21,24,0.125,0.875
5964,26,1,0,10,10,0.0,1.0
5950,26,1,0,7,7,0.0,1.0
5991,26,1,0,20,20,0.0,1.0
6177,26,1,0,3,3,0.0,1.0
5961,26,1,0,45,45,0.0,1.0
5938,26,1,0,340,340,0.0,1.0
5960,26,1,0,36,36,0.0,1.0
5947,26,1,0,78,78,0.0,1.0
5957,26,1,3,4,7,0.42857142857142855,0.5714285714285714
6043,26,1,0,29,29,0.0,1.0
6014,26,1,3,7,10,0.3,0.7
6015,26,1,1,1,2,0.5,0.5
5978,26,1,1,15,16,0.0625,0.9375
5986,26,1,2,2,4,0.5,0.5
5969,26,1,0,4,4,0.0,1.0
5949,26,1,0,30,30,0.0,1.0
5959,26,1,3,37,40,0.075,0.925
6051,26,1,0,108,108,0.0,1.0
6029,26,1,1,19,20,0.05,0.95
6070,26,1,0,4,4,0.0,1.0
5942,26,1,0,108,108,0.0,1.0
5953,26,1,0,28,28,0.0,1.0
6076,26,1,0,14,14,0.0,1.0
5940,26,1,3,6,9,0.3333333333333333,0.6666666666666666
6109,26,1,0,95,95,0.0,1.0
6187,26,1,0,6,6,0.0,1.0
6053,26,1,0,15,15,0.0,1.0
6104,26,1,2,2,4,0.5,0.5
5943,26,1,0,9,9,0.0,1.0
6168,26,1,0,240,240,0.0,1.0
5989,26,1,0,6,6,0.0,1.0
5963,26,1,0,20,20,0.0,1.0
6194,26,1,0,80,80,0.0,1.0
6003,26,1,1,237,238,0.004201680672268907,0.9957983193277311
6167,26,1,0,10,10,0.0,1.0
6004,26,1,1,134,135,0.007407407407407408,0.9925925925925926
6054,26,1,0,14,14,0.0,1.0
6170,26,1,3,31,34,0.08823529411764706,0.9117647058823529
6063,26,1,2,8,10,0.2,0.8
5988,26,1,0,17,17,0.0,1.0
6075,26,1,1,11,12,0.08333333333333333,0.9166666666666666
6061,26,1,0,26,26,0.0,1.0
5965,26,1,0,45,45,0.0,1.0
6040,26,1,3,9,12,0.25,0.75
6106,26,1,1,29,30,0.03333333333333333,0.9666666666666667
6082,26,1,0,13,13,0.0,1.0
6031,26,1,2,23,25,0.08,0.92
6039,26,1,0,58,58,0.0,1.0
6189,27,1,0,22,22,0.0,1.0
5936,27,1,0,31,31,0.0,1.0
6087,27,1,0,18,18,0.0,1.0
5973,27,1,0,34,34,0.0,1.0
6085,27,1,0,34,34,0.0,1.0
5948,27,1,1,41,42,0.023809523809523808,0.9761904761904762
5974,27,1,0,10,10,0.0,1.0
6090,27,1,0,1,1,0.0,1.0
6068,27,1,0,35,35,0.0,1.0
6024,27,1,1,1,2,0.5,0.5
5976,27,1,1,79,80,0.0125,0.9875
5962,27,1,0,59,59,0.0,1.0
6033,27,1,2,22,24,0.08333333333333333,0.9166666666666666
6038,27,1,0,7,7,0.0,1.0
6042,27,1,0,49,49,0.0,1.0
5924,27,1,0,50,50,0.0,1.0
6083,27,1,1,11,12,0.08333333333333333,0.9166666666666666
6178,27,1,0,225,225,0.0,1.0
6086,27,1,0,25,25,0.0,1.0
5945,27,1,0,95,95,0.0,1.0
5925,27,1,0,122,122,0.0,1.0
5935,27,1,0,3,3,0.0,1.0
6073,27,1,2,5,7,0.2857142857142857,0.7142857142857143
5980,27,1,0,12,12,0.0,1.0
5993,27,1,0,24,24,0.0,1.0
5979,27,1,0,33,33,0.0,1.0
5966,27,1,0,26,26,0.0,1.0
5967,27,1,0,101,101,0.0,1.0
5970,27,1,0,14,14,0.0,1.0
6188,27,1,1,2,3,0.3333333333333333,0.6666666666666666
6096,27,1,1,0,1,1.0,0.0
6069,27,1,0,17,17,0.0,1.0
5937,27,1,0,6,6,0.0,1.0
5990,27,1,0,50,50,0.0,1.0
5928,27,1,0,22,22,0.0,1.0
6058,27,1,0,69,69,0.0,1.0
6001,27,1,3,21,24,0.125,0.875
5964,27,1,1,9,10,0.1,0.9
5950,27,1,1,6,7,0.14285714285714285,0.8571428571428571
5991,27,1,0,20,20,0.0,1.0
6177,27,1,0,3,3,0.0,1.0
5961,27,1,0,45,45,0.0,1.0
5938,27,1,0,340,340,0.0,1.0
5960,27,1,0,36,36,0.0,1.0
5947,27,1,0,78,78,0.0,1.0
5957,27,1,1,6,7,0.14285714285714285,0.8571428571428571
6043,27,1,0,29,29,0.0,1.0
6014,27,1,6,4,10,0.6,0.4
6015,27,1,2,0,2,1.0,0.0
5978,27,1,0,16,16,0.0,1.0
5986,27,1,2,2,4,0.5,0.5
5969,27,1,0,4,4,0.0,1.0
5949,27,1,0,30,30,0.0,1.0
5959,27,1,1,39,40,0.025,0.975
6051,27,1,0,108,108,0.0,1.0
6029,27,1,0,20,20,0.0,1.0
6070,27,1,2,2,4,0.5,0.5
5942,27,1,0,108,108,0.0,1.0
5953,27,1,0,28,28,0.0,1.0
6076,27,1,0,14,14,0.0,1.0
5940,27,1,2,7,9,0.2222222222222222,0.7777777777777778
6109,27,1,0,95,95,0.0,1.0
6187,27,1,0,6,6,0.0,1.0
6053,27,1,0,15,15,0.0,1.0
6104,27,1,2,2,4,0.5,0.5
5943,27,1,0,9,9,0.0,1.0
6168,27,1,0,240,240,0.0,1.0
5989,27,1,0,6,6,0.0,1.0
5963,27,1,0,20,20,0.0,1.0
6194,27,1,0,80,80,0.0,1.0
6003,27,1,1,237,238,0.004201680672268907,0.9957983193277311
6167,27,1,0,10,10,0.0,1.0
6004,27,1,0,135,135,0.0,1.0
6054,27,1,0,14,14,0.0,1.0
6170,27,1,0,34,34,0.0,1.0
6063,27,1,1,9,10,0.1,0.9
5988,27,1,0,17,17,0.0,1.0
6075,27,1,1,11,12,0.08333333333333333,0.9166666666666666
6061,27,1,0,26,26,0.0,1.0
5965,27,1,0,45,45,0.0,1.0
6040,27,1,4,8,12,0.3333333333333333,0.6666666666666666
6106,27,1,1,29,30,0.03333333333333333,0.9666666666666667
6082,27,1,0,13,13,0.0,1.0
6031,27,1,1,24,25,0.04,0.96
6039,27,1,1,57,58,0.017241379310344827,0.9827586206896551
6189,28,1,0,22,22,0.0,1.0
5936,28,1,0,31,31,0.0,1.0
6087,28,1,0,18,18,0.0,1.0
5973,28,1,0,34,34,0.0,1.0
6085,28,1,0,34,34,0.0,1.0
5948,28,1,1,41,42,0.023809523809523808,0.9761904761904762
5974,28,1,0,10,10,0.0,1.0
6090,28,1,0,1,1,0.0,1.0
6068,28,1,0,35,35,0.0,1.0
6024,28,1,2,0,2,1.0,0.0
5976,28,1,2,78,80,0.025,0.975
5962,28,1,0,59,59,0.0,1.0
6033,28,1,4,20,24,0.16666666666666666,0.8333333333333334
6038,28,1,0,7,7,0.0,1.0
6042,28,1,0,49,49,0.0,1.0
5924,28,1,0,50,50,0.0,1.0
6083,28,1,0,12,12,0.0,1.0
6178,28,1,0,225,225,0.0,1.0
6086,28,1,0,25,25,0.0,1.0
5945,28,1,0,95,95,0.0,1.0
5925,28,1,0,122,122,0.0,1.0
5935,28,1,0,3,3,0.0,1.0
6073,28,1,0,7,7,0.0,1.0
5980,28,1,2,10,12,0.16666666666666666,0.8333333333333334
5993,28,1,0,24,24,0.0,1.0
5979,28,1,0,33,33,0.0,1.0
5966,28,1,0,26,26,0.0,1.0
5967,28,1,0,101,101,0.0,1.0
5970,28,1,0,14,14,0.0,1.0
6188,28,1,0,3,3,0.0,1.0
6096,28,1,1,0,1,1.0,0.0
6069,28,1,0,17,17,0.0,1.0
5937,28,1,0,6,6,0.0,1.0
5990,28,1,0,50,50,0.0,1.0
5928,28,1,0,22,22,0.0,1.0
6058,28,1,2,67,69,0.028985507246376812,0.9710144927536232
6001,28,1,3,21,24,0.125,0.875
5964,28,1,0,10,10,0.0,1.0
5950,28,1,0,7,7,0.0,1.0
5991,28,1,0,20,20,0.0,1.0
6177,28,1,0,3,3,0.0,1.0
5961,28,1,0,45,45,0.0,1.0
5938,28,1,0,340,340,0.0,1.0
5960,28,1,0,36,36,0.0,1.0
5947,28,1,0,78,78,0.0,1.0
5957,28,1,0,7,7,0.0,1.0
6043,28,1,0,29,29,0.0,1.0
6014,28,1,6,4,10,0.6,0.4
6015,28,1,1,1,2,0.5,0.5
5978,28,1,1,15,16,0.0625,0.9375
5986,28,1,3,1,4,0.75,0.25
5969,28,1,0,4,4,0.0,1.0
5949,28,1,0,30,30,0.0,1.0
5959,28,1,2,38,40,0.05,0.95
6051,28,1,0,108,108,0.0,1.0
6029,28,1,0,20,20,0.0,1.0
6070,28,1,0,4,4,0.0,1.0
5942,28,1,0,108,108,0.0,1.0
5953,28,1,0,28,28,0.0,1.0
6076,28,1,0,14,14,0.0,1.0
5940,28,1,5,4,9,0.5555555555555556,0.4444444444444444
6109,28,1,0,95,95,0.0,1.0
6187,28,1,0,6,6,0.0,1.0
6053,28,1,0,15,15,0.0,1.0
6104,28,1,2,2,4,0.5,0.5
5943,28,1,0,9,9,0.0,1.0
6168,28,1,0,240,240,0.0,1.0
5989,28,1,0,6,6,0.0,1.0
5963,28,1,0,20,20,0.0,1.0
6194,28,1,0,80,80,0.0,1.0
6003,28,1,1,237,238,0.004201680672268907,0.9957983193277311
6167,28,1,0,10,10,0.0,1.0
6004,28,1,0,135,135,0.0,1.0
6054,28,1,0,14,14,0.0,1.0
6170,28,1,0,34,34,0.0,1.0
6063,28,1,1,9,10,0.1,0.9
5988,28,1,0,17,17,0.0,1.0
6075,28,1,1,11,12,0.08333333333333333,0.9166666666666666
6061,28,1,0,26,26,0.0,1.0
5965,28,1,0,45,45,0.0,1.0
6040,28,1,5,7,12,0.4166666666666667,0.5833333333333334
6106,28,1,1,29,30,0.03333333333333333,0.9666666666666667
6082,28,1,0,13,13,0.0,1.0
6031,28,1,1,24,25,0.04,0.96
6039,28,1,1,57,58,0.017241379310344827,0.9827586206896551
6189,29,1,0,22,22,0.0,1.0
5936,29,1,0,31,31,0.0,1.0
6087,29,1,0,18,18,0.0,1.0
5973,29,1,0,34,34,0.0,1.0
6085,29,1,0,34,34,0.0,1.0
5948,29,1,0,42,42,0.0,1.0
5974,29,1,0,10,10,0.0,1.0
6090,29,1,0,1,1,0.0,1.0
6068,29,1,0,35,35,0.0,1.0
6024,29,1,2,0,2,1.0,0.0
5976,29,1,1,79,80,0.0125,0.9875
5962,29,1,0,59,59,0.0,1.0
6033,29,1,2,22,24,0.08333333333333333,0.9166666666666666
6038,29,1,0,7,7,0.0,1.0
6042,29,1,0,49,49,0.0,1.0
5924,29,1,0,50,50,0.0,1.0
6083,29,1,4,8,12,0.3333333333333333,0.6666666666666666
6178,29,1,0,225,225,0.0,1.0
6086,29,1,0,25,25,0.0,1.0
5945,29,1,0,95,95,0.0,1.0
5925,29,1,0,122,122,0.0,1.0
5935,29,1,0,3,3,0.0,1.0
6073,29,1,1,6,7,0.14285714285714285,0.8571428571428571
5980,29,1,2,10,12,0.16666666666666666,0.8333333333333334
5993,29,1,0,24,24,0.0,1.0
5979,29,1,0,33,33,0.0,1.0
5966,29,1,0,26,26,0.0,1.0
5967,29,1,2,99,101,0.019801980198019802,0.9801980198019802
5970,29,1,0,14,14,0.0,1.0
6188,29,1,0,3,3,0.0,1.0
6096,29,1,1,0,1,1.0,0.0
6069,29,1,0,17,17,0.0,1.0
5937,29,1,0,6,6,0.0,1.0
5990,29,1,0,50,50,0.0,1.0
5928,29,1,0,22,22,0.0,1.0
6058,29,1,4,65,69,0.057971014492753624,0.9420289855072463
6001,29,1,4,20,24,0.16666666666666666,0.8333333333333334
5964,29,1,0,10,10,0.0,1.0
5950,29,1,1,6,7,0.14285714285714285,0.8571428571428571
5991,29,1,0,20,20,0.0,1.0
6177,29,1,0,3,3,0.0,1.0
5961,29,1,0,45,45,0.0,1.0
5938,29,1,0,340,340,0.0,1.0
5960,29,1,0,36,36,0.0,1.0
5947,29,1,0,78,78,0.0,1.0
5957,29,1,1,6,7,0.14285714285714285,0.8571428571428571
6043,29,1,0,29,29,0.0,1.0
6014,29,1,4,6,10,0.4,0.6
6015,29,1,1,1,2,0.5,0.5
5978,29,1,0,16,16,0.0,1.0
5986,29,1,2,2,4,0.5,0.5
5969,29,1,0,4,4,0.0,1.0
5949,29,1,0,30,30,0.0,1.0
5959,29,1,1,39,40,0.025,0.975
6051,29,1,0,108,108,0.0,1.0
6029,29,1,0,20,20,0.0,1.0
6070,29,1,2,2,4,0.5,0.5
5942,29,1,0,108,108,0.0,1.0
5953,29,1,0,28,28,0.0,1.0
6076,29,1,1,13,14,0.07142857142857142,0.9285714285714286
5940,29,1,4,5,9,0.4444444444444444,0.5555555555555556
6109,29,1,0,95,95,0.0,1.0
6187,29,1,0,6,6,0.0,1.0
6053,29,1,0,15,15,0.0,1.0
6104,29,1,3,1,4,0.75,0.25
5943,29,1,0,9,9,0.0,1.0
6168,29,1,0,240,240,0.0,1.0
5989,29,1,0,6,6,0.0,1.0
5963,29,1,1,19,20,0.05,0.95
6194,29,1,0,80,80,0.0,1.0
6003,29,1,0,238,238,0.0,1.0
6167,29,1,0,10,10,0.0,1.0
6004,29,1,0,135,135,0.0,1.0
6054,29,1,0,14,14,0.0,1.0
6170,29,1,1,33,34,0.029411764705882353,0.9705882352941176
6063,29,1,3,7,10,0.3,0.7
5988,29,1,0,17,17,0.0,1.0
6075,29,1,1,11,12,0.08333333333333333,0.9166666666666666
6061,29,1,0,26,26,0.0,1.0
5965,29,1,0,45,45,0.0,1.0
6040,29,1,2,10,12,0.16666666666666666,0.8333333333333334
6106,29,1,1,29,30,0.03333333333333333,0.9666666666666667
6082,29,1,2,11,13,0.15384615384615385,0.8461538461538461
6031,29,1,2,23,25,0.08,0.92
6039,29,1,1,57,58,0.017241379310344827,0.9827586206896551
6189,0,2,7,15,22,0.3181818181818182,0.6818181818181818
5936,0,2,0,31,31,0.0,1.0
6087,0,2,0,18,18,0.0,1.0
5973,0,2,0,34,34,0.0,1.0
6085,0,2,0,34,34,0.0,1.0
5948,0,2,1,41,42,0.023809523809523808,0.9761904761904762
5974,0,2,0,10,10,0.0,1.0
6090,0,2,0,1,1,0.0,1.0
6068,0,2,0,35,35,0.0,1.0
6024,0,2,1,1,2,0.5,0.5
5976,0,2,76,4,80,0.95,0.05
5962,0,2,0,59,59,0.0,1.0
6033,0,2,0,24,24,0.0,1.0
6038,0,2,0,7,7,0.0,1.0
6042,0,2,0,49,49,0.0,1.0
5924,0,2,0,50,50,0.0,1.0
6083,0,2,1,11,12,0.08333333333333333,0.9166666666666666
6178,0,2,194,31,225,0.8622222222222222,0.13777777777777778
6086,0,2,0,25,25,0.0,1.0
5945,0,2,0,95,95,0.0,1.0
5925,0,2,0,122,122,0.0,1.0
5935,0,2,0,3,3,0.0,1.0
6073,0,2,5,2,7,0.7142857142857143,0.2857142857142857
5980,0,2,0,12,12,0.0,1.0
5993,0,2,0,24,24,0.0,1.0
5979,0,2,0,33,33,0.0,1.0
5966,0,2,25,1,26,0.9615384615384616,0.038461538461538464
5967,0,2,95,6,101,0.9405940594059405,0.0594059405940594
5970,0,2,0,14,14,0.0,1.0
6188,0,2,3,0,3,1.0,0.0
6096,0,2,1,0,1,1.0,0.0
6069,0,2,0,17,17,0.0,1.0
5937,0,2,0,6,6,0.0,1.0
5990,0,2,0,50,50,0.0,1.0
5928,0,2,0,22,22,0.0,1.0
6058,0,2,62,7,69,0.8985507246376812,0.10144927536231885
6001,0,2,5,19,24,0.20833333333333334,0.7916666666666666
5964,0,2,1,9,10,0.1,0.9
5950,0,2,1,6,7,0.14285714285714285,0.8571428571428571
5991,0,2,0,20,20,0.0,1.0
6177,0,2,0,3,3,0.0,1.0
5961,0,2,0,45,45,0.0,1.0
5938,0,2,234,106,340,0.6882352941176471,0.31176470588235294
5960,0,2,0,36,36,0.0,1.0
5947,0,2,0,78,78,0.0,1.0
5957,0,2,7,0,7,1.0,0.0
6043,0,2,0,29,29,0.0,1.0
6014,0,2,10,0,10,1.0,0.0
6015,0,2,2,0,2,1.0,0.0
5978,0,2,16,0,16,1.0,0.0
5986,0,2,4,0,4,1.0,0.0
5969,0,2,4,0,4,1.0,0.0
5949,0,2,3,27,30,0.1,0.9
5959,0,2,39,1,40,0.975,0.025
6051,0,2,0,108,108,0.0,1.0
6029,0,2,1,19,20,0.05,0.95
6070,0,2,3,1,4,0.75,0.25
5942,0,2,0,108,108,0.0,1.0
5953,0,2,0,28,28,0.0,1.0
6076,0,2,10,4,14,0.7142857142857143,0.2857142857142857
5940,0,2,9,0,9,1.0,0.0
6109,0,2,93,2,95,0.9789473684210527,0.021052631578947368
6187,0,2,0,6,6,0.0,1.0
6053,0,2,0,15,15,0.0,1.0
6104,0,2,3,1,4,0.75,0.25
5943,0,2,0,9,9,0.0,1.0
6168,0,2,0,240,240,0.0,1.0
5989,0,2,0,6,6,0.0,1.0
5963,0,2,20,0,20,1.0,0.0
6194,0,2,0,80,80,0.0,1.0
6003,0,2,104,134,238,0.4369747899159664,0.5630252100840336
6167,0,2,10,0,10,1.0,0.0
6004,0,2,83,52,135,0.6148148148148148,0.3851851851851852
6054,0,2,0,14,14,0.0,1.0
6170,0,2,4,30,34,0.11764705882352941,0.8823529411764706
6063,0,2,8,2,10,0.8,0.2
5988,0,2,0,17,17,0.0,1.0
6075,0,2,2,10,12,0.16666666666666666,0.8333333333333334
6061,0,2,0,26,26,0.0,1.0
5965,0,2,0,45,45,0.0,1.0
6040,0,2,12,0,12,1.0,0.0
6106,0,2,2,28,30,0.06666666666666667,0.9333333333333333
6082,0,2,0,13,13,0.0,1.0
6031,0,2,0,25,25,0.0,1.0
6039,0,2,0,58,58,0.0,1.0
6189,1,2,11,11,22,0.5,0.5
5936,1,2,0,31,31,0.0,1.0
6087,1,2,0,18,18,0.0,1.0
5973,1,2,0,34,34,0.0,1.0
6085,1,2,0,34,34,0.0,1.0
5948,1,2,0,42,42,0.0,1.0
5974,1,2,0,10,10,0.0,1.0
6090,1,2,0,1,1,0.0,1.0
6068,1,2,0,35,35,0.0,1.0
6024,1,2,2,0,2,1.0,0.0
5976,1,2,74,6,80,0.925,0.075
5962,1,2,0,59,59,0.0,1.0
6033,1,2,2,22,24,0.08333333333333333,0.9166666666666666
6038,1,2,0,7,7,0.0,1.0
6042,1,2,0,49,49,0.0,1.0
5924,1,2,0,50,50,0.0,1.0
6083,1,2,5,7,12,0.4166666666666667,0.5833333333333334
6178,1,2,150,75,225,0.6666666666666666,0.3333333333333333
6086,1,2,0,25,25,0.0,1.0
5945,1,2,0,95,95,0.0,1.0
5925,1,2,0,122,122,0.0,1.0
5935,1,2,0,3,3,0.0,1.0
6073,1,2,4,3,7,0.5714285714285714,0.42857142857142855
5980,1,2,2,10,12,0.16666666666666666,0.8333333333333334
5993,1,2,0,24,24,0.0,1.0
5979,1,2,0,33,33,0.0,1.0
5966,1,2,25,1,26,0.9615384615384616,0.038461538461538464
5967,1,2,85,16,101,0.8415841584158416,0.15841584158415842
5970,1,2,0,14,14,0.0,1.0
6188,1,2,3,0,3,1.0,0.0
6096,1,2,1,0,1,1.0,0.0
6069,1,2,0,17,17,0.0,1.0
5937,1,2,0,6,6,0.0,1.0
5990,1,2,0,50,50,0.0,1.0
5928,1,2,0,22,22,0.0,1.0
6058,1,2,63,6,69,0.9130434782608695,0.08695652173913043
6001,1,2,3,21,24,0.125,0.875
5964,1,2,1,9,10,0.1,0.9
5950,1,2,3,4,7,0.42857142857142855,0.5714285714285714
5991,1,2,0,20,20,0.0,1.0
6177,1,2,0,3,3,0.0,1.0
5961,1,2,0,45,45,0.0,1.0
5938,1,2,131,209,340,0.38529411764705884,0.6147058823529412
5960,1,2,0,36,36,0.0,1.0
5947,1,2,0,78,78,0.0,1.0
5957,1,2,7,0,7,1.0,0.0
6043,1,2,0,29,29,0.0,1.0
6014,1,2,10,0,10,1.0,0.0
6015,1,2,2,0,2,1.0,0.0
5978,1,2,16,0,16,1.0,0.0
5986,1,2,4,0,4,1.0,0.0
5969,1,2,4,0,4,1.0,0.0
5949,1,2,0,30,30,0.0,1.0
5959,1,2,38,2,40,0.95,0.05
6051,1,2,0,108,108,0.0,1.0
6029,1,2,0,20,20,0.0,1.0
6070,1,2,3,1,4,0.75,0.25
5942,1,2,0,108,108,0.0,1.0
5953,1,2,0,28,28,0.0,1.0
6076,1,2,11,3,14,0.7857142857142857,0.21428571428571427
5940,1,2,8,1,9,0.8888888888888888,0.1111111111111111
6109,1,2,77,18,95,0.8105263157894737,0.18947368421052632
6187,1,2,0,6,6,0.0,1.0
6053,1,2,0,15,15,0.0,1.0
6104,1,2,3,1,4,0.75,0.25
5943,1,2,0,9,9,0.0,1.0
6168,1,2,0,240,240,0.0,1.0
5989,1,2,0,6,6,0.0,1.0
5963,1,2,19,1,20,0.95,0.05
6194,1,2,0,80,80,0.0,1.0
6003,1,2,79,159,238,0.3319327731092437,0.6680672268907563
6167,1,2,9,1,10,0.9,0.1
6004,1,2,63,72,135,0.4666666666666667,0.5333333333333333
6054,1,2,0,14,14,0.0,1.0
6170,1,2,9,25,34,0.2647058823529412,0.7352941176470589
6063,1,2,8,2,10,0.8,0.2
5988,1,2,0,17,17,0.0,1.0
6075,1,2,2,10,12,0.16666666666666666,0.8333333333333334
6061,1,2,0,26,26,0.0,1.0
5965,1,2,0,45,45,0.0,1.0
6040,1,2,12,0,12,1.0,0.0
6106,1,2,1,29,30,0.03333333333333333,0.9666666666666667
6082,1,2,0,13,13,0.0,1.0
6031,1,2,1,24,25,0.04,0.96
6039,1,2,1,57,58,0.017241379310344827,0.9827586206896551
6189,2,2,8,14,22,0.36363636363636365,0.6363636363636364
5936,2,2,0,31,31,0.0,1.0
6087,2,2,0,18,18,0.0,1.0
5973,2,2,0,34,34,0.0,1.0
6085,2,2,0,34,34,0.0,1.0
5948,2,2,1,41,42,0.023809523809523808,0.9761904761904762
5974,2,2,0,10,10,0.0,1.0
6090,2,2,0,1,1,0.0,1.0
6068,2,2,0,35,35,0.0,1.0
6024,2,2,2,0,2,1.0,0.0
5976,2,2,34,46,80,0.425,0.575
5962,2,2,0,59,59,0.0,1.0
6033,2,2,2,22,24,0.08333333333333333,0.9166666666666666
6038,2,2,0,7,7,0.0,1.0
6042,2,2,0,49,49,0.0,1.0
5924,2,2,0,50,50,0.0,1.0
6083,2,2,2,10,12,0.16666666666666666,0.8333333333333334
6178,2,2,71,154,225,0.31555555555555553,0.6844444444444444
6086,2,2,0,25,25,0.0,1.0
5945,2,2,0,95,95,0.0,1.0
5925,2,2,0,122,122,0.0,1.0
5935,2,2,0,3,3,0.0,1.0
6073,2,2,4,3,7,0.5714285714285714,0.42857142857142855
5980,2,2,2,10,12,0.16666666666666666,0.8333333333333334
5993,2,2,0,24,24,0.0,1.0
5979,2,2,0,33,33,0.0,1.0
5966,2,2,21,5,26,0.8076923076923077,0.19230769230769232
5967,2,2,57,44,101,0.5643564356435643,0.43564356435643564
5970,2,2,0,14,14,0.0,1.0
6188,2,2,3,0,3,1.0,0.0
6096,2,2,1,0,1,1.0,0.0
6069,2,2,0,17,17,0.0,1.0
5937,2,2,0,6,6,0.0,1.0
5990,2,2,0,50,50,0.0,1.0
5928,2,2,0,22,22,0.0,1.0
6058,2,2,44,25,69,0.6376811594202898,0.36231884057971014
6001,2,2,2,22,24,0.08333333333333333,0.9166666666666666
5964,2,2,1,9,10,0.1,0.9
5950,2,2,1,6,7,0.14285714285714285,0.8571428571428571
5991,2,2,0,20,20,0.0,1.0
6177,2,2,0,3,3,0.0,1.0
5961,2,2,0,45,45,0.0,1.0
5938,2,2,36,304,340,0.10588235294117647,0.8941176470588236
5960,2,2,0,36,36,0.0,1.0
5947,2,2,0,78,78,0.0,1.0
5957,2,2,7,0,7,1.0,0.0
6043,2,2,0,29,29,0.0,1.0
6014,2,2,10,0,10,1.0,0.0
6015,2,2,2,0,2,1.0,0.0
5978,2,2,15,1,16,0.9375,0.0625
5986,2,2,4,0,4,1.0,0.0
5969,2,2,3,1,4,0.75,0.25
5949,2,2,0,30,30,0.0,1.0
5959,2,2,28,12,40,0.7,0.3
6051,2,2,0,108,108,0.0,1.0
6029,2,2,0,20,20,0.0,1.0
6070,2,2,4,0,4,1.0,0.0
5942,2,2,0,108,108,0.0,1.0
5953,2,2,0,28,28,0.0,1.0
6076,2,2,12,2,14,0.8571428571428571,0.14285714285714285
5940,2,2,8,1,9,0.8888888888888888,0.1111111111111111
6109,2,2,48,47,95,0.5052631578947369,0.49473684210526314
6187,2,2,0,6,6,0.0,1.0
6053,2,2,0,15,15,0.0,1.0
6104,2,2,3,1,4,0.75,0.25
5943,2,2,0,9,9,0.0,1.0
6168,2,2,0,240,240,0.0,1.0
5989,2,2,0,6,6,0.0,1.0
5963,2,2,19,1,20,0.95,0.05
6194,2,2,0,80,80,0.0,1.0
6003,2,2,38,200,238,0.15966386554621848,0.8403361344537815
6167,2,2,6,4,10,0.6,0.4
6004,2,2,34,101,135,0.2518518518518518,0.7481481481481481
6054,2,2,0,14,14,0.0,1.0
6170,2,2,6,28,34,0.17647058823529413,0.8235294117647058
6063,2,2,8,2,10,0.8,0.2
5988,2,2,0,17,17,0.0,1.0
6075,2,2,0,12,12,0.0,1.0
6061,2,2,0,26,26,0.0,1.0
5965,2,2,0,45,45,0.0,1.0
6040,2,2,11,1,12,0.9166666666666666,0.08333333333333333
6106,2,2,1,29,30,0.03333333333333333,0.9666666666666667
6082,2,2,0,13,13,0.0,1.0
6031,2,2,1,24,25,0.04,0.96
6039,2,2,0,58,58,0.0,1.0
6189,3,2,3,19,22,0.13636363636363635,0.8636363636363636
5936,3,2,0,31,31,0.0,1.0
6087,3,2,0,18,18,0.0,1.0
5973,3,2,0,34,34,0.0,1.0
6085,3,2,0,34,34,0.0,1.0
5948,3,2,1,41,42,0.023809523809523808,0.9761904761904762
5974,3,2,0,10,10,0.0,1.0
6090,3,2,0,1,1,0.0,1.0
6068,3,2,0,35,35,0.0,1.0
6024,3,2,1,1,2,0.5,0.5
5976,3,2,30,50,80,0.375,0.625
5962,3,2,0,59,59,0.0,1.0
6033,3,2,7,17,24,0.2916666666666667,0.7083333333333334
6038,3,2,0,7,7,0.0,1.0
6042,3,2,0,49,49,0.0,1.0
5924,3,2,0,50,50,0.0,1.0
6083,3,2,1,11,12,0.08333333333333333,0.9166666666666666
6178,3,2,51,174,225,0.22666666666666666,0.7733333333333333
6086,3,2,0,25,25,0.0,1.0
5945,3,2,0,95,95,0.0,1.0
5925,3,2,0,122,122,0.0,1.0
5935,3,2,0,3,3,0.0,1.0
6073,3,2,5,2,7,0.7142857142857143,0.2857142857142857
5980,3,2,2,10,12,0.16666666666666666,0.8333333333333334
5993,3,2,0,24,24,0.0,1.0
5979,3,2,0,33,33,0.0,1.0
5966,3,2,20,6,26,0.7692307692307693,0.23076923076923078
5967,3,2,31,70,101,0.3069306930693069,0.693069306930693
5970,3,2,0,14,14,0.0,1.0
6188,3,2,3,0,3,1.0,0.0
6096,3,2,1,0,1,1.0,0.0
6069,3,2,0,17,17,0.0,1.0
5937,3,2,0,6,6,0.0,1.0
5990,3,2,0,50,50,0.0,1.0
5928,3,2,0,22,22,0.0,1.0
6058,3,2,37,32,69,0.5362318840579711,0.463768115942029
6001,3,2,6,18,24,0.25,0.75
5964,3,2,0,10,10,0.0,1.0
5950,3,2,0,7,7,0.0,1.0
5991,3,2,0,20,20,0.0,1.0
6177,3,2,0,3,3,0.0,1.0
5961,3,2,0,45,45,0.0,1.0
5938,3,2,24,316,340,0.07058823529411765,0.9294117647058824
5960,3,2,0,36,36,0.0,1.0
5947,3,2,0,78,78,0.0,1.0
5957,3,2,5,2,7,0.7142857142857143,0.2857142857142857
6043,3,2,0,29,29,0.0,1.0
6014,3,2,10,0,10,1.0,0.0
6015,3,2,2,0,2,1.0,0.0
5978,3,2,12,4,16,0.75,0.25
5986,3,2,4,0,4,1.0,0.0
5969,3,2,3,1,4,0.75,0.25
5949,3,2,3,27,30,0.1,0.9
5959,3,2,25,15,40,0.625,0.375
6051,3,2,0,108,108,0.0,1.0
6029,3,2,0,20,20,0.0,1.0
6070,3,2,3,1,4,0.75,0.25
5942,3,2,0,108,108,0.0,1.0
5953,3,2,0,28,28,0.0,1.0
6076,3,2,11,3,14,0.7857142857142857,0.21428571428571427
5940,3,2,9,0,9,1.0,0.0
6109,3,2,34,61,95,0.35789473684210527,0.6421052631578947
6187,3,2,0,6,6,0.0,1.0
6053,3,2,0,15,15,0.0,1.0
6104,3,2,3,1,4,0.75,0.25
5943,3,2,0,9,9,0.0,1.0
6168,3,2,0,240,240,0.0,1.0
5989,3,2,0,6,6,0.0,1.0
5963,3,2,16,4,20,0.8,0.2
6194,3,2,0,80,80,0.0,1.0
6003,3,2,23,215,238,0.09663865546218488,0.9033613445378151
6167,3,2,6,4,10,0.6,0.4
6004,3,2,23,112,135,0.17037037037037037,0.8296296296296296
6054,3,2,0,14,14,0.0,1.0
6170,3,2,7,27,34,0.20588235294117646,0.7941176470588235
6063,3,2,8,2,10,0.8,0.2
5988,3,2,0,17,17,0.0,1.0
6075,3,2,2,10,12,0.16666666666666666,0.8333333333333334
6061,3,2,0,26,26,0.0,1.0
5965,3,2,0,45,45,0.0,1.0
6040,3,2,10,2,12,0.8333333333333334,0.16666666666666666
6106,3,2,9,21,30,0.3,0.7
6082,3,2,2,11,13,0.15384615384615385,0.8461538461538461
6031,3,2,1,24,25,0.04,0.96
6039,3,2,0,58,58,0.0,1.0
6189,4,2,8,14,22,0.36363636363636365,0.6363636363636364
5936,4,2,0,31,31,0.0,1.0
6087,4,2,0,18,18,0.0,1.0
5973,4,2,0,34,34,0.0,1.0
6085,4,2,0,34,34,0.0,1.0
5948,4,2,1,41,42,0.023809523809523808,0.9761904761904762
5974,4,2,0,10,10,0.0,1.0
6090,4,2,0,1,1,0.0,1.0
6068,4,2,0,35,35,0.0,1.0
6024,4,2,1,1,2,0.5,0.5
5976,4,2,22,58,80,0.275,0.725
5962,4,2,0,59,59,0.0,1.0
6033,4,2,0,24,24,0.0,1.0
6038,4,2,0,7,7,0.0,1.0
6042,4,2,0,49,49,0.0,1.0
5924,4,2,0,50,50,0.0,1.0
6083,4,2,2,10,12,0.16666666666666666,0.8333333333333334
6178,4,2,30,195,225,0.13333333333333333,0.8666666666666667
6086,4,2,0,25,25,0.0,1.0
5945,4,2,0,95,95,0.0,1.0
5925,4,2,0,122,122,0.0,1.0
5935,4,2,0,3,3,0.0,1.0
6073,4,2,3,4,7,0.42857142857142855,0.5714285714285714
5980,4,2,0,12,12,0.0,1.0
5993,4,2,0,24,24,0.0,1.0
5979,4,2,0,33,33,0.0,1.0
5966,4,2,18,8,26,0.6923076923076923,0.3076923076923077
5967,4,2,23,78,101,0.22772277227722773,0.7722772277227723
5970,4,2,0,14,14,0.0,1.0
6188,4,2,3,0,3,1.0,0.0
6096,4,2,1,0,1,1.0,0.0
6069,4,2,0,17,17,0.0,1.0
5937,4,2,0,6,6,0.0,1.0
5990,4,2,0,50,50,0.0,1.0
5928,4,2,0,22,22,0.0,1.0
6058,4,2,26,43,69,0.37681159420289856,0.6231884057971014
6001,4,2,4,20,24,0.16666666666666666,0.8333333333333334
5964,4,2,1,9,10,0.1,0.9
5950,4,2,3,4,7,0.42857142857142855,0.5714285714285714
5991,4,2,0,20,20,0.0,1.0
6177,4,2,0,3,3,0.0,1.0
5961,4,2,0,45,45,0.0,1.0
5938,4,2,17,323,340,0.05,0.95
5960,4,2,0,36,36,0.0,1.0
5947,4,2,0,78,78,0.0,1.0
5957,4,2,7,0,7,1.0,0.0
6043,4,2,0,29,29,0.0,1.0
6014,4,2,10,0,10,1.0,0.0
6015,4,2,2,0,2,1.0,0.0
5978,4,2,12,4,16,0.75,0.25
5986,4,2,4,0,4,1.0,0.0
5969,4,2,3,1,4,0.75,0.25
5949,4,2,0,30,30,0.0,1.0
5959,4,2,13,27,40,0.325,0.675
6051,4,2,0,108,108,0.0,1.0
6029,4,2,1,19,20,0.05,0.95
6070,4,2,3,1,4,0.75,0.25
5942,4,2,0,108,108,0.0,1.0
5953,4,2,0,28,28,0.0,1.0
6076,4,2,8,6,14,0.5714285714285714,0.42857142857142855
5940,4,2,8,1,9,0.8888888888888888,0.1111111111111111
6109,4,2,32,63,95,0.3368421052631579,0.6631578947368421
6187,4,2,0,6,6,0.0,1.0
6053,4,2,0,15,15,0.0,1.0
6104,4,2,3,1,4,0.75,0.25
5943,4,2,0,9,9,0.0,1.0
6168,4,2,0,240,240,0.0,1.0
5989,4,2,0,6,6,0.0,1.0
5963,4,2,14,6,20,0.7,0.3
6194,4,2,0,80,80,0.0,1.0
6003,4,2,16,222,238,0.06722689075630252,0.9327731092436975
6167,4,2,3,7,10,0.3,0.7
6004,4,2,24,111,135,0.17777777777777778,0.8222222222222222
6054,4,2,0,14,14,0.0,1.0
6170,4,2,5,29,34,0.14705882352941177,0.8529411764705882
6063,4,2,6,4,10,0.6,0.4
5988,4,2,0,17,17,0.0,1.0
6075,4,2,1,11,12,0.08333333333333333,0.9166666666666666
6061,4,2,0,26,26,0.0,1.0
5965,4,2,0,45,45,0.0,1.0
6040,4,2,10,2,12,0.8333333333333334,0.16666666666666666
6106,4,2,2,28,30,0.06666666666666667,0.9333333333333333
6082,4,2,0,13,13,0.0,1.0
6031,4,2,1,24,25,0.04,0.96
6039,4,2,0,58,58,0.0,1.0
6189,5,2,4,18,22,0.18181818181818182,0.8181818181818182
5936,5,2,0,31,31,0.0,1.0
6087,5,2,0,18,18,0.0,1.0
5973,5,2,0,34,34,0.0,1.0
6085,5,2,0,34,34,0.0,1.0
5948,5,2,1,41,42,0.023809523809523808,0.9761904761904762
5974,5,2,0,10,10,0.0,1.0
6090,5,2,0,1,1,0.0,1.0
6068,5,2,0,35,35,0.0,1.0
6024,5,2,2,0,2,1.0,0.0
5976,5,2,18,62,80,0.225,0.775
5962,5,2,0,59,59,0.0,1.0
6033,5,2,2,22,24,0.08333333333333333,0.9166666666666666
6038,5,2,0,7,7,0.0,1.0
6042,5,2,0,49,49,0.0,1.0
5924,5,2,0,50,50,0.0,1.0
6083,5,2,4,8,12,0.3333333333333333,0.6666666666666666
6178,5,2,19,206,225,0.08444444444444445,0.9155555555555556
6086,5,2,0,25,25,0.0,1.0
5945,5,2,0,95,95,0.0,1.0
5925,5,2,0,122,122,0.0,1.0
5935,5,2,0,3,3,0.0,1.0
6073,5,2,6,1,7,0.8571428571428571,0.14285714285714285
5980,5,2,0,12,12,0.0,1.0
5993,5,2,0,24,24,0.0,1.0
5979,5,2,0,33,33,0.0,1.0
5966,5,2,14,12,26,0.5384615384615384,0.46153846153846156
5967,5,2,18,83,101,0.1782178217821782,0.8217821782178217
5970,5,2,0,14,14,0.0,1.0
6188,5,2,3,0,3,1.0,0.0
6096,5,2,1,0,1,1.0,0.0
6069,5,2,0,17,17,0.0,1.0
5937,5,2,0,6,6,0.0,1.0
5990,5,2,0,50,50,0.0,1.0
5928,5,2,0,22,22,0.0,1.0
6058,5,2,24,45,69,0.34782608695652173,0.6521739130434783
6001,5,2,4,20,24,0.16666666666666666,0.8333333333333334
5964,5,2,0,10,10,0.0,1.0
5950,5,2,2,5,7,0.2857142857142857,0.7142857142857143
5991,5,2,0,20,20,0.0,1.0
6177,5,2,0,3,3,0.0,1.0
5961,5,2,0,45,45,0.0,1.0
5938,5,2,10,330,340,0.029411764705882353,0.9705882352941176
5960,5,2,0,36,36,0.0,1.0
5947,5,2,0,78,78,0.0,1.0
5957,5,2,4,3,7,0.5714285714285714,0.42857142857142855
6043,5,2,0,29,29,0.0,1.0
6014,5,2,10,0,10,1.0,0.0
6015,5,2,2,0,2,1.0,0.0
5978,5,2,7,9,16,0.4375,0.5625
5986,5,2,4,0,4,1.0,0.0
5969,5,2,3,1,4,0.75,0.25
5949,5,2,0,30,30,0.0,1.0
5959,5,2,11,29,40,0.275,0.725
6051,5,2,0,108,108,0.0,1.0
6029,5,2,0,20,20,0.0,1.0
6070,5,2,3,1,4,0.75,0.25
5942,5,2,0,108,108,0.0,1.0
5953,5,2,0,28,28,0.0,1.0
6076,5,2,10,4,14,0.7142857142857143,0.2857142857142857
5940,5,2,6,3,9,0.6666666666666666,0.3333333333333333
6109,5,2,27,68,95,0.28421052631578947,0.7157894736842105
6187,5,2,0,6,6,0.0,1.0
6053,5,2,0,15,15,0.0,1.0
6104,5,2,4,0,4,1.0,0.0
5943,5,2,0,9,9,0.0,1.0
6168,5,2,0,240,240,0.0,1.0
5989,5,2,0,6,6,0.0,1.0
5963,5,2,12,8,20,0.6,0.4
6194,5,2,0,80,80,0.0,1.0
6003,5,2,15,223,238,0.06302521008403361,0.9369747899159664
6167,5,2,4,6,10,0.4,0.6
6004,5,2,13,122,135,0.0962962962962963,0.9037037037037037
6054,5,2,0,14,14,0.0,1.0
6170,5,2,5,29,34,0.14705882352941177,0.8529411764705882
6063,5,2,9,1,10,0.9,0.1
5988,5,2,0,17,17,0.0,1.0
6075,5,2,1,11,12,0.08333333333333333,0.9166666666666666
6061,5,2,0,26,26,0.0,1.0
5965,5,2,0,45,45,0.0,1.0
6040,5,2,9,3,12,0.75,0.25
6106,5,2,0,30,30,0.0,1.0
6082,5,2,0,13,13,0.0,1.0
6031,5,2,1,24,25,0.04,0.96
6039,5,2,0,58,58,0.0,1.0
6189,6,2,3,19,22,0.13636363636363635,0.8636363636363636
5936,6,2,0,31,31,0.0,1.0
6087,6,2,0,18,18,0.0,1.0
5973,6,2,0,34,34,0.0,1.0
6085,6,2,0,34,34,0.0,1.0
5948,6,2,0,42,42,0.0,1.0
5974,6,2,0,10,10,0.0,1.0
6090,6,2,0,1,1,0.0,1.0
6068,6,2,0,35,35,0.0,1.0
6024,6,2,2,0,2,1.0,0.0
5976,6,2,9,71,80,0.1125,0.8875
5962,6,2,0,59,59,0.0,1.0
6033,6,2,2,22,24,0.08333333333333333,0.9166666666666666
6038,6,2,0,7,7,0.0,1.0
6042,6,2,0,49,49,0.0,1.0
5924,6,2,0,50,50,0.0,1.0
6083,6,2,2,10,12,0.16666666666666666,0.8333333333333334
6178,6,2,9,216,225,0.04,0.96
6086,6,2,0,25,25,0.0,1.0
5945,6,2,0,95,95,0.0,1.0
5925,6,2,0,122,122,0.0,1.0
5935,6,2,0,3,3,0.0,1.0
6073,6,2,6,1,7,0.8571428571428571,0.14285714285714285
5980,6,2,0,12,12,0.0,1.0
5993,6,2,0,24,24,0.0,1.0
5979,6,2,0,33,33,0.0,1.0
5966,6,2,13,13,26,0.5,0.5
5967,6,2,12,89,101,0.1188118811881188,0.8811881188118812
5970,6,2,0,14,14,0.0,1.0
6188,6,2,3,0,3,1.0,0.0
6096,6,2,1,0,1,1.0,0.0
6069,6,2,0,17,17,0.0,1.0
5937,6,2,0,6,6,0.0,1.0
5990,6,2,0,50,50,0.0,1.0
5928,6,2,0,22,22,0.0,1.0
6058,6,2,21,48,69,0.30434782608695654,0.6956521739130435
6001,6,2,3,21,24,0.125,0.875
5964,6,2,0,10,10,0.0,1.0
5950,6,2,1,6,7,0.14285714285714285,0.8571428571428571
5991,6,2,0,20,20,0.0,1.0
6177,6,2,0,3,3,0.0,1.0
5961,6,2,0,45,45,0.0,1.0
5938,6,2,7,333,340,0.020588235294117647,0.9794117647058823
5960,6,2,0,36,36,0.0,1.0
5947,6,2,0,78,78,0.0,1.0
5957,6,2,4,3,7,0.5714285714285714,0.42857142857142855
6043,6,2,0,29,29,0.0,1.0
6014,6,2,10,0,10,1.0,0.0
6015,6,2,2,0,2,1.0,0.0
5978,6,2,6,10,16,0.375,0.625
5986,6,2,4,0,4,1.0,0.0
5969,6,2,3,1,4,0.75,0.25
5949,6,2,0,30,30,0.0,1.0
5959,6,2,11,29,40,0.275,0.725
6051,6,2,0,108,108,0.0,1.0
6029,6,2,0,20,20,0.0,1.0
6070,6,2,4,0,4,1.0,0.0
5942,6,2,0,108,108,0.0,1.0
5953,6,2,0,28,28,0.0,1.0
6076,6,2,5,9,14,0.35714285714285715,0.6428571428571429
5940,6,2,5,4,9,0.5555555555555556,0.4444444444444444
6109,6,2,18,77,95,0.18947368421052632,0.8105263157894737
6187,6,2,0,6,6,0.0,1.0
6053,6,2,0,15,15,0.0,1.0
6104,6,2,3,1,4,0.75,0.25
5943,6,2,0,9,9,0.0,1.0
6168,6,2,0,240,240,0.0,1.0
5989,6,2,0,6,6,0.0,1.0
5963,6,2,13,7,20,0.65,0.35
6194,6,2,0,80,80,0.0,1.0
6003,6,2,5,233,238,0.02100840336134454,0.9789915966386554
6167,6,2,3,7,10,0.3,0.7
6004,6,2,7,128,135,0.05185185185185185,0.9481481481481482
6054,6,2,0,14,14,0.0,1.0
6170,6,2,5,29,34,0.14705882352941177,0.8529411764705882
6063,6,2,6,4,10,0.6,0.4
5988,6,2,0,17,17,0.0,1.0
6075,6,2,1,11,12,0.08333333333333333,0.9166666666666666
6061,6,2,0,26,26,0.0,1.0
5965,6,2,0,45,45,0.0,1.0
6040,6,2,9,3,12,0.75,0.25
6106,6,2,1,29,30,0.03333333333333333,0.9666666666666667
6082,6,2,0,13,13,0.0,1.0
6031,6,2,1,24,25,0.04,0.96
6039,6,2,0,58,58,0.0,1.0
6189,7,2,4,18,22,0.18181818181818182,0.8181818181818182
5936,7,2,0,31,31,0.0,1.0
6087,7,2,0,18,18,0.0,1.0
5973,7,2,0,34,34,0.0,1.0
6085,7,2,0,34,34,0.0,1.0
5948,7,2,0,42,42,0.0,1.0
5974,7,2,0,10,10,0.0,1.0
6090,7,2,0,1,1,0.0,1.0
6068,7,2,0,35,35,0.0,1.0
6024,7,2,1,1,2,0.5,0.5
5976,7,2,9,71,80,0.1125,0.8875
5962,7,2,0,59,59,0.0,1.0
6033,7,2,4,20,24,0.16666666666666666,0.8333333333333334
6038,7,2,0,7,7,0.0,1.0
6042,7,2,0,49,49,0.0,1.0
5924,7,2,0,50,50,0.0,1.0
6083,7,2,1,11,12,0.08333333333333333,0.9166666666666666
6178,7,2,6,219,225,0.02666666666666667,0.9733333333333334
6086,7,2,0,25,25,0.0,1.0
5945,7,2,0,95,95,0.0,1.0
5925,7,2,0,122,122,0.0,1.0
5935,7,2,0,3,3,0.0,1.0
6073,7,2,4,3,7,0.5714285714285714,0.42857142857142855
5980,7,2,2,10,12,0.16666666666666666,0.8333333333333334
5993,7,2,0,24,24,0.0,1.0
5979,7,2,0,33,33,0.0,1.0
5966,7,2,10,16,26,0.38461538461538464,0.6153846153846154
5967,7,2,12,89,101,0.1188118811881188,0.8811881188118812
5970,7,2,0,14,14,0.0,1.0
6188,7,2,2,1,3,0.6666666666666666,0.3333333333333333
6096,7,2,1,0,1,1.0,0.0
6069,7,2,0,17,17,0.0,1.0
5937,7,2,0,6,6,0.0,1.0
5990,7,2,0,50,50,0.0,1.0
5928,7,2,0,22,22,0.0,1.0
6058,7,2,21,48,69,0.30434782608695654,0.6956521739130435
6001,7,2,5,19,24,0.20833333333333334,0.7916666666666666
5964,7,2,1,9,10,0.1,0.9
5950,7,2,1,6,7,0.14285714285714285,0.8571428571428571
5991,7,2,0,20,20,0.0,1.0
6177,7,2,0,3,3,0.0,1.0
5961,7,2,0,45,45,0.0,1.0
5938,7,2,4,336,340,0.011764705882352941,0.9882352941176471
5960,7,2,0,36,36,0.0,1.0
5947,7,2,0,78,78,0.0,1.0
5957,7,2,4,3,7,0.5714285714285714,0.42857142857142855
6043,7,2,0,29,29,0.0,1.0
6014,7,2,9,1,10,0.9,0.1
6015,7,2,2,0,2,1.0,0.0
5978,7,2,6,10,16,0.375,0.625
5986,7,2,3,1,4,0.75,0.25
5969,7,2,3,1,4,0.75,0.25
5949,7,2,0,30,30,0.0,1.0
5959,7,2,4,36,40,0.1,0.9
6051,7,2,0,108,108,0.0,1.0
6029,7,2,0,20,20,0.0,1.0
6070,7,2,3,1,4,0.75,0.25
5942,7,2,0,108,108,0.0,1.0
5953,7,2,0,28,28,0.0,1.0
6076,7,2,6,8,14,0.42857142857142855,0.5714285714285714
5940,7,2,6,3,9,0.6666666666666666,0.3333333333333333
6109,7,2,10,85,95,0.10526315789473684,0.8947368421052632
6187,7,2,2,4,6,0.3333333333333333,0.6666666666666666
6053,7,2,0,15,15,0.0,1.0
6104,7,2,4,0,4,1.0,0.0
5943,7,2,0,9,9,0.0,1.0
6168,7,2,0,240,240,0.0,1.0
5989,7,2,0,6,6,0.0,1.0
5963,7,2,9,11,20,0.45,0.55
6194,7,2,0,80,80,0.0,1.0
6003,7,2,8,230,238,0.03361344537815126,0.9663865546218487
6167,7,2,2,8,10,0.2,0.8
6004,7,2,5,130,135,0.037037037037037035,0.9629629629629629
6054,7,2,0,14,14,0.0,1.0
6170,7,2,6,28,34,0.17647058823529413,0.8235294117647058
6063,7,2,5,5,10,0.5,0.5
5988,7,2,0,17,17,0.0,1.0
6075,7,2,2,10,12,0.16666666666666666,0.8333333333333334
6061,7,2,0,26,26,0.0,1.0
5965,7,2,0,45,45,0.0,1.0
6040,7,2,8,4,12,0.6666666666666666,0.3333333333333333
6106,7,2,0,30,30,0.0,1.0
6082,7,2,0,13,13,0.0,1.0
6031,7,2,1,24,25,0.04,0.96
6039,7,2,0,58,58,0.0,1.0
6189,8,2,2,20,22,0.09090909090909091,0.9090909090909091
5936,8,2,0,31,31,0.0,1.0
6087,8,2,0,18,18,0.0,1.0
5973,8,2,0,34,34,0.0,1.0
6085,8,2,0,34,34,0.0,1.0
5948,8,2,0,42,42,0.0,1.0
5974,8,2,0,10,10,0.0,1.0
6090,8,2,0,1,1,0.0,1.0
6068,8,2,0,35,35,0.0,1.0
6024,8,2,1,1,2,0.5,0.5
5976,8,2,7,73,80,0.0875,0.9125
5962,8,2,0,59,59,0.0,1.0
6033,8,2,2,22,24,0.08333333333333333,0.9166666666666666
6038,8,2,0,7,7,0.0,1.0
6042,8,2,0,49,49,0.0,1.0
5924,8,2,0,50,50,0.0,1.0
6083,8,2,1,11,12,0.08333333333333333,0.9166666666666666
6178,8,2,6,219,225,0.02666666666666667,0.9733333333333334
6086,8,2,0,25,25,0.0,1.0
5945,8,2,0,95,95,0.0,1.0
5925,8,2,0,122,122,0.0,1.0
5935,8,2,0,3,3,0.0,1.0
6073,8,2,3,4,7,0.42857142857142855,0.5714285714285714
5980,8,2,0,12,12,0.0,1.0
5993,8,2,0,24,24,0.0,1.0
5979,8,2,0,33,33,0.0,1.0
5966,8,2,8,18,26,0.3076923076923077,0.6923076923076923
5967,8,2,8,93,101,0.07920792079207921,0.9207920792079208
5970,8,2,0,14,14,0.0,1.0
6188,8,2,2,1,3,0.6666666666666666,0.3333333333333333
6096,8,2,1,0,1,1.0,0.0
6069,8,2,0,17,17,0.0,1.0
5937,8,2,0,6,6,0.0,1.0
5990,8,2,0,50,50,0.0,1.0
5928,8,2,0,22,22,0.0,1.0
6058,8,2,12,57,69,0.17391304347826086,0.8260869565217391
6001,8,2,2,22,24,0.08333333333333333,0.9166666666666666
5964,8,2,4,6,10,0.4,0.6
5950,8,2,2,5,7,0.2857142857142857,0.7142857142857143
5991,8,2,0,20,20,0.0,1.0
6177,8,2,0,3,3,0.0,1.0
5961,8,2,0,45,45,0.0,1.0
5938,8,2,5,335,340,0.014705882352941176,0.9852941176470589
5960,8,2,0,36,36,0.0,1.0
5947,8,2,0,78,78,0.0,1.0
5957,8,2,3,4,7,0.42857142857142855,0.5714285714285714
6043,8,2,0,29,29,0.0,1.0
6014,8,2,9,1,10,0.9,0.1
6015,8,2,2,0,2,1.0,0.0
5978,8,2,6,10,16,0.375,0.625
5986,8,2,3,1,4,0.75,0.25
5969,8,2,3,1,4,0.75,0.25
5949,8,2,0,30,30,0.0,1.0
5959,8,2,5,35,40,0.125,0.875
6051,8,2,0,108,108,0.0,1.0
6029,8,2,0,20,20,0.0,1.0
6070,8,2,3,1,4,0.75,0.25
5942,8,2,0,108,108,0.0,1.0
5953,8,2,0,28,28,0.0,1.0
6076,8,2,1,13,14,0.07142857142857142,0.9285714285714286
5940,8,2,8,1,9,0.8888888888888888,0.1111111111111111
6109,8,2,9,86,95,0.09473684210526316,0.9052631578947369
6187,8,2,0,6,6,0.0,1.0
6053,8,2,0,15,15,0.0,1.0
6104,8,2,3,1,4,0.75,0.25
5943,8,2,4,5,9,0.4444444444444444,0.5555555555555556
6168,8,2,0,240,240,0.0,1.0
5989,8,2,0,6,6,0.0,1.0
5963,8,2,10,10,20,0.5,0.5
6194,8,2,0,80,80,0.0,1.0
6003,8,2,6,232,238,0.025210084033613446,0.9747899159663865
6167,8,2,0,10,10,0.0,1.0
6004,8,2,6,129,135,0.044444444444444446,0.9555555555555556
6054,8,2,0,14,14,0.0,1.0
6170,8,2,6,28,34,0.17647058823529413,0.8235294117647058
6063,8,2,5,5,10,0.5,0.5
5988,8,2,0,17,17,0.0,1.0
6075,8,2,0,12,12,0.0,1.0
6061,8,2,0,26,26,0.0,1.0
5965,8,2,0,45,45,0.0,1.0
6040,8,2,8,4,12,0.6666666666666666,0.3333333333333333
6106,8,2,1,29,30,0.03333333333333333,0.9666666666666667
6082,8,2,0,13,13,0.0,1.0
6031,8,2,0,25,25,0.0,1.0
6039,8,2,4,54,58,0.06896551724137931,0.9310344827586207
6189,9,2,4,18,22,0.18181818181818182,0.8181818181818182
5936,9,2,0,31,31,0.0,1.0
6087,9,2,0,18,18,0.0,1.0
5973,9,2,0,34,34,0.0,1.0
6085,9,2,0,34,34,0.0,1.0
5948,9,2,0,42,42,0.0,1.0
5974,9,2,0,10,10,0.0,1.0
6090,9,2,0,1,1,0.0,1.0
6068,9,2,0,35,35,0.0,1.0
6024,9,2,1,1,2,0.5,0.5
5976,9,2,7,73,80,0.0875,0.9125
5962,9,2,0,59,59,0.0,1.0
6033,9,2,4,20,24,0.16666666666666666,0.8333333333333334
6038,9,2,0,7,7,0.0,1.0
6042,9,2,0,49,49,0.0,1.0
5924,9,2,0,50,50,0.0,1.0
6083,9,2,5,7,12,0.4166666666666667,0.5833333333333334
6178,9,2,0,225,225,0.0,1.0
6086,9,2,0,25,25,0.0,1.0
5945,9,2,0,95,95,0.0,1.0
5925,9,2,0,122,122,0.0,1.0
5935,9,2,0,3,3,0.0,1.0
6073,9,2,3,4,7,0.42857142857142855,0.5714285714285714
5980,9,2,2,10,12,0.16666666666666666,0.8333333333333334
5993,9,2,3,21,24,0.125,0.875
5979,9,2,0,33,33,0.0,1.0
5966,9,2,3,23,26,0.11538461538461539,0.8846153846153846
5967,9,2,3,98,101,0.0297029702970297,0.9702970297029703
5970,9,2,0,14,14,0.0,1.0
6188,9,2,2,1,3,0.6666666666666666,0.3333333333333333
6096,9,2,1,0,1,1.0,0.0
6069,9,2,0,17,17,0.0,1.0
5937,9,2,0,6,6,0.0,1.0
5990,9,2,0,50,50,0.0,1.0
5928,9,2,0,22,22,0.0,1.0
6058,9,2,13,56,69,0.18840579710144928,0.8115942028985508
6001,9,2,2,22,24,0.08333333333333333,0.9166666666666666
5964,9,2,1,9,10,0.1,0.9
5950,9,2,1,6,7,0.14285714285714285,0.8571428571428571
5991,9,2,0,20,20,0.0,1.0
6177,9,2,0,3,3,0.0,1.0
5961,9,2,0,45,45,0.0,1.0
5938,9,2,4,336,340,0.011764705882352941,0.9882352941176471
5960,9,2,0,36,36,0.0,1.0
5947,9,2,0,78,78,0.0,1.0
5957,9,2,4,3,7,0.5714285714285714,0.42857142857142855
6043,9,2,0,29,29,0.0,1.0
6014,9,2,10,0,10,1.0,0.0
6015,9,2,2,0,2,1.0,0.0
5978,9,2,5,11,16,0.3125,0.6875
5986,9,2,3,1,4,0.75,0.25
5969,9,2,2,2,4,0.5,0.5
5949,9,2,3,27,30,0.1,0.9
5959,9,2,5,35,40,0.125,0.875
6051,9,2,0,108,108,0.0,1.0
6029,9,2,1,19,20,0.05,0.95
6070,9,2,3,1,4,0.75,0.25
5942,9,2,0,108,108,0.0,1.0
5953,9,2,0,28,28,0.0,1.0
6076,9,2,4,10,14,0.2857142857142857,0.7142857142857143
5940,9,2,5,4,9,0.5555555555555556,0.4444444444444444
6109,9,2,12,83,95,0.12631578947368421,0.8736842105263158
6187,9,2,2,4,6,0.3333333333333333,0.6666666666666666
6053,9,2,0,15,15,0.0,1.0
6104,9,2,3,1,4,0.75,0.25
5943,9,2,0,9,9,0.0,1.0
6168,9,2,0,240,240,0.0,1.0
5989,9,2,0,6,6,0.0,1.0
5963,9,2,11,9,20,0.55,0.45
6194,9,2,0,80,80,0.0,1.0
6003,9,2,3,235,238,0.012605042016806723,0.9873949579831933
6167,9,2,1,9,10,0.1,0.9
6004,9,2,4,131,135,0.02962962962962963,0.9703703703703703
6054,9,2,0,14,14,0.0,1.0
6170,9,2,2,32,34,0.058823529411764705,0.9411764705882353
6063,9,2,4,6,10,0.4,0.6
5988,9,2,0,17,17,0.0,1.0
6075,9,2,0,12,12,0.0,1.0
6061,9,2,0,26,26,0.0,1.0
5965,9,2,0,45,45,0.0,1.0
6040,9,2,8,4,12,0.6666666666666666,0.3333333333333333
6106,9,2,1,29,30,0.03333333333333333,0.9666666666666667
6082,9,2,0,13,13,0.0,1.0
6031,9,2,0,25,25,0.0,1.0
6039,9,2,4,54,58,0.06896551724137931,0.9310344827586207
6189,10,2,2,20,22,0.09090909090909091,0.9090909090909091
5936,10,2,0,31,31,0.0,1.0
6087,10,2,0,18,18,0.0,1.0
5973,10,2,0,34,34,0.0,1.0
6085,10,2,0,34,34,0.0,1.0
5948,10,2,0,42,42,0.0,1.0
5974,10,2,0,10,10,0.0,1.0
6090,10,2,0,1,1,0.0,1.0
6068,10,2,0,35,35,0.0,1.0
6024,10,2,1,1,2,0.5,0.5
5976,10,2,7,73,80,0.0875,0.9125
5962,10,2,0,59,59,0.0,1.0
6033,10,2,4,20,24,0.16666666666666666,0.8333333333333334
6038,10,2,0,7,7,0.0,1.0
6042,10,2,0,49,49,0.0,1.0
5924,10,2,0,50,50,0.0,1.0
6083,10,2,2,10,12,0.16666666666666666,0.8333333333333334
6178,10,2,4,221,225,0.017777777777777778,0.9822222222222222
6086,10,2,0,25,25,0.0,1.0
5945,10,2,0,95,95,0.0,1.0
5925,10,2,0,122,122,0.0,1.0
5935,10,2,0,3,3,0.0,1.0
6073,10,2,4,3,7,0.5714285714285714,0.42857142857142855
5980,10,2,0,12,12,0.0,1.0
5993,10,2,0,24,24,0.0,1.0
5979,10,2,0,33,33,0.0,1.0
5966,10,2,3,23,26,0.11538461538461539,0.8846153846153846
5967,10,2,7,94,101,0.06930693069306931,0.9306930693069307
5970,10,2,0,14,14,0.0,1.0
6188,10,2,1,2,3,0.3333333333333333,0.6666666666666666
6096,10,2,1,0,1,1.0,0.0
6069,10,2,0,17,17,0.0,1.0
5937,10,2,0,6,6,0.0,1.0
5990,10,2,0,50,50,0.0,1.0
5928,10,2,0,22,22,0.0,1.0
6058,10,2,14,55,69,0.2028985507246377,0.7971014492753623
6001,10,2,4,20,24,0.16666666666666666,0.8333333333333334
5964,10,2,1,9,10,0.1,0.9
5950,10,2,0,7,7,0.0,1.0
5991,10,2,0,20,20,0.0,1.0
6177,10,2,0,3,3,0.0,1.0
5961,10,2,0,45,45,0.0,1.0
5938,10,2,2,338,340,0.0058823529411764705,0.9941176470588236
5960,10,2,0,36,36,0.0,1.0
5947,10,2,0,78,78,0.0,1.0
5957,10,2,3,4,7,0.42857142857142855,0.5714285714285714
6043,10,2,0,29,29,0.0,1.0
6014,10,2,8,2,10,0.8,0.2
6015,10,2,2,0,2,1.0,0.0
5978,10,2,3,13,16,0.1875,0.8125
5986,10,2,3,1,4,0.75,0.25
5969,10,2,3,1,4,0.75,0.25
5949,10,2,0,30,30,0.0,1.0
5959,10,2,5,35,40,0.125,0.875
6051,10,2,0,108,108,0.0,1.0
6029,10,2,0,20,20,0.0,1.0
6070,10,2,3,1,4,0.75,0.25
5942,10,2,0,108,108,0.0,1.0
5953,10,2,0,28,28,0.0,1.0
6076,10,2,2,12,14,0.14285714285714285,0.8571428571428571
5940,10,2,4,5,9,0.4444444444444444,0.5555555555555556
6109,10,2,16,79,95,0.16842105263157894,0.8315789473684211
6187,10,2,0,6,6,0.0,1.0
6053,10,2,0,15,15,0.0,1.0
6104,10,2,3,1,4,0.75,0.25
5943,10,2,0,9,9,0.0,1.0
6168,10,2,0,240,240,0.0,1.0
5989,10,2,0,6,6,0.0,1.0
5963,10,2,11,9,20,0.55,0.45
6194,10,2,0,80,80,0.0,1.0
6003,10,2,1,237,238,0.004201680672268907,0.9957983193277311
6167,10,2,1,9,10,0.1,0.9
6004,10,2,5,130,135,0.037037037037037035,0.9629629629629629
6054,10,2,0,14,14,0.0,1.0
6170,10,2,6,28,34,0.17647058823529413,0.8235294117647058
6063,10,2,7,3,10,0.7,0.3
5988,10,2,0,17,17,0.0,1.0
6075,10,2,1,11,12,0.08333333333333333,0.9166666666666666
6061,10,2,0,26,26,0.0,1.0
5965,10,2,0,45,45,0.0,1.0
6040,10,2,7,5,12,0.5833333333333334,0.4166666666666667
6106,10,2,0,30,30,0.0,1.0
6082,10,2,0,13,13,0.0,1.0
6031,10,2,2,23,25,0.08,0.92
6039,10,2,0,58,58,0.0,1.0
6189,11,2,2,20,22,0.09090909090909091,0.9090909090909091
5936,11,2,0,31,31,0.0,1.0
6087,11,2,0,18,18,0.0,1.0
5973,11,2,0,34,34,0.0,1.0
6085,11,2,0,34,34,0.0,1.0
5948,11,2,1,41,42,0.023809523809523808,0.9761904761904762
5974,11,2,0,10,10,0.0,1.0
6090,11,2,0,1,1,0.0,1.0
6068,11,2,0,35,35,0.0,1.0
6024,11,2,1,1,2,0.5,0.5
5976,11,2,4,76,80,0.05,0.95
5962,11,2,0,59,59,0.0,1.0
6033,11,2,2,22,24,0.08333333333333333,0.9166666666666666
6038,11,2,0,7,7,0.0,1.0
6042,11,2,0,49,49,0.0,1.0
5924,11,2,0,50,50,0.0,1.0
6083,11,2,3,9,12,0.25,0.75
6178,11,2,4,221,225,0.017777777777777778,0.9822222222222222
6086,11,2,0,25,25,0.0,1.0
5945,11,2,0,95,95,0.0,1.0
5925,11,2,0,122,122,0.0,1.0
5935,11,2,0,3,3,0.0,1.0
6073,11,2,3,4,7,0.42857142857142855,0.5714285714285714
5980,11,2,0,12,12,0.0,1.0
5993,11,2,0,24,24,0.0,1.0
5979,11,2,0,33,33,0.0,1.0
5966,11,2,4,22,26,0.15384615384615385,0.8461538461538461
5967,11,2,6,95,101,0.0594059405940594,0.9405940594059405
5970,11,2,0,14,14,0.0,1.0
6188,11,2,3,0,3,1.0,0.0
6096,11,2,1,0,1,1.0,0.0
6069,11,2,0,17,17,0.0,1.0
5937,11,2,0,6,6,0.0,1.0
5990,11,2,0,50,50,0.0,1.0
5928,11,2,0,22,22,0.0,1.0
6058,11,2,7,62,69,0.10144927536231885,0.8985507246376812
6001,11,2,6,18,24,0.25,0.75
5964,11,2,3,7,10,0.3,0.7
5950,11,2,1,6,7,0.14285714285714285,0.8571428571428571
5991,11,2,0,20,20,0.0,1.0
6177,11,2,0,3,3,0.0,1.0
5961,11,2,0,45,45,0.0,1.0
5938,11,2,2,338,340,0.0058823529411764705,0.9941176470588236
5960,11,2,0,36,36,0.0,1.0
5947,11,2,0,78,78,0.0,1.0
5957,11,2,4,3,7,0.5714285714285714,0.42857142857142855
6043,11,2,0,29,29,0.0,1.0
6014,11,2,8,2,10,0.8,0.2
6015,11,2,1,1,2,0.5,0.5
5978,11,2,4,12,16,0.25,0.75
5986,11,2,3,1,4,0.75,0.25
5969,11,2,3,1,4,0.75,0.25
5949,11,2,0,30,30,0.0,1.0
5959,11,2,5,35,40,0.125,0.875
6051,11,2,0,108,108,0.0,1.0
6029,11,2,0,20,20,0.0,1.0
6070,11,2,3,1,4,0.75,0.25
5942,11,2,0,108,108,0.0,1.0
5953,11,2,0,28,28,0.0,1.0
6076,11,2,1,13,14,0.07142857142857142,0.9285714285714286
5940,11,2,4,5,9,0.4444444444444444,0.5555555555555556
6109,11,2,11,84,95,0.11578947368421053,0.8842105263157894
6187,11,2,0,6,6,0.0,1.0
6053,11,2,0,15,15,0.0,1.0
6104,11,2,3,1,4,0.75,0.25
5943,11,2,5,4,9,0.5555555555555556,0.4444444444444444
6168,11,2,0,240,240,0.0,1.0
5989,11,2,0,6,6,0.0,1.0
5963,11,2,7,13,20,0.35,0.65
6194,11,2,0,80,80,0.0,1.0
6003,11,2,2,236,238,0.008403361344537815,0.9915966386554622
6167,11,2,0,10,10,0.0,1.0
6004,11,2,5,130,135,0.037037037037037035,0.9629629629629629
6054,11,2,0,14,14,0.0,1.0
6170,11,2,6,28,34,0.17647058823529413,0.8235294117647058
6063,11,2,5,5,10,0.5,0.5
5988,11,2,0,17,17,0.0,1.0
6075,11,2,0,12,12,0.0,1.0
6061,11,2,0,26,26,0.0,1.0
5965,11,2,0,45,45,0.0,1.0
6040,11,2,6,6,12,0.5,0.5
6106,11,2,2,28,30,0.06666666666666667,0.9333333333333333
6082,11,2,0,13,13,0.0,1.0
6031,11,2,2,23,25,0.08,0.92
6039,11,2,0,58,58,0.0,1.0
6189,12,2,3,19,22,0.13636363636363635,0.8636363636363636
5936,12,2,0,31,31,0.0,1.0
6087,12,2,0,18,18,0.0,1.0
5973,12,2,0,34,34,0.0,1.0
6085,12,2,0,34,34,0.0,1.0
5948,12,2,0,42,42,0.0,1.0
5974,12,2,0,10,10,0.0,1.0
6090,12,2,0,1,1,0.0,1.0
6068,12,2,0,35,35,0.0,1.0
6024,12,2,2,0,2,1.0,0.0
5976,12,2,4,76,80,0.05,0.95
5962,12,2,0,59,59,0.0,1.0
6033,12,2,2,22,24,0.08333333333333333,0.9166666666666666
6038,12,2,0,7,7,0.0,1.0
6042,12,2,0,49,49,0.0,1.0
5924,12,2,0,50,50,0.0,1.0
6083,12,2,0,12,12,0.0,1.0
6178,12,2,2,223,225,0.008888888888888889,0.9911111111111112
6086,12,2,0,25,25,0.0,1.0
5945,12,2,0,95,95,0.0,1.0
5925,12,2,0,122,122,0.0,1.0
5935,12,2,0,3,3,0.0,1.0
6073,12,2,2,5,7,0.2857142857142857,0.7142857142857143
5980,12,2,0,12,12,0.0,1.0
5993,12,2,3,21,24,0.125,0.875
5979,12,2,0,33,33,0.0,1.0
5966,12,2,1,25,26,0.038461538461538464,0.9615384615384616
5967,12,2,4,97,101,0.039603960396039604,0.9603960396039604
5970,12,2,0,14,14,0.0,1.0
6188,12,2,3,0,3,1.0,0.0
6096,12,2,1,0,1,1.0,0.0
6069,12,2,0,17,17,0.0,1.0
5937,12,2,0,6,6,0.0,1.0
5990,12,2,0,50,50,0.0,1.0
5928,12,2,0,22,22,0.0,1.0
6058,12,2,14,55,69,0.2028985507246377,0.7971014492753623
6001,12,2,3,21,24,0.125,0.875
5964,12,2,1,9,10,0.1,0.9
5950,12,2,0,7,7,0.0,1.0
5991,12,2,0,20,20,0.0,1.0
6177,12,2,0,3,3,0.0,1.0
5961,12,2,0,45,45,0.0,1.0
5938,12,2,1,339,340,0.0029411764705882353,0.9970588235294118
5960,12,2,0,36,36,0.0,1.0
5947,12,2,0,78,78,0.0,1.0
5957,12,2,3,4,7,0.42857142857142855,0.5714285714285714
6043,12,2,0,29,29,0.0,1.0
6014,12,2,10,0,10,1.0,0.0
6015,12,2,2,0,2,1.0,0.0
5978,12,2,2,14,16,0.125,0.875
5986,12,2,4,0,4,1.0,0.0
5969,12,2,2,2,4,0.5,0.5
5949,12,2,0,30,30,0.0,1.0
5959,12,2,4,36,40,0.1,0.9
6051,12,2,0,108,108,0.0,1.0
6029,12,2,1,19,20,0.05,0.95
6070,12,2,3,1,4,0.75,0.25
5942,12,2,0,108,108,0.0,1.0
5953,12,2,0,28,28,0.0,1.0
6076,12,2,1,13,14,0.07142857142857142,0.9285714285714286
5940,12,2,2,7,9,0.2222222222222222,0.7777777777777778
6109,12,2,8,87,95,0.08421052631578947,0.9157894736842105
6187,12,2,2,4,6,0.3333333333333333,0.6666666666666666
6053,12,2,0,15,15,0.0,1.0
6104,12,2,4,0,4,1.0,0.0
5943,12,2,0,9,9,0.0,1.0
6168,12,2,0,240,240,0.0,1.0
5989,12,2,0,6,6,0.0,1.0
5963,12,2,5,15,20,0.25,0.75
6194,12,2,0,80,80,0.0,1.0
6003,12,2,2,236,238,0.008403361344537815,0.9915966386554622
6167,12,2,2,8,10,0.2,0.8
6004,12,2,2,133,135,0.014814814814814815,0.9851851851851852
6054,12,2,0,14,14,0.0,1.0
6170,12,2,3,31,34,0.08823529411764706,0.9117647058823529
6063,12,2,4,6,10,0.4,0.6
5988,12,2,0,17,17,0.0,1.0
6075,12,2,1,11,12,0.08333333333333333,0.9166666666666666
6061,12,2,0,26,26,0.0,1.0
5965,12,2,0,45,45,0.0,1.0
6040,12,2,8,4,12,0.6666666666666666,0.3333333333333333
6106,12,2,0,30,30,0.0,1.0
6082,12,2,0,13,13,0.0,1.0
6031,12,2,2,23,25,0.08,0.92
6039,12,2,1,57,58,0.017241379310344827,0.9827586206896551
6189,13,2,3,19,22,0.13636363636363635,0.8636363636363636
5936,13,2,0,31,31,0.0,1.0
6087,13,2,0,18,18,0.0,1.0
5973,13,2,0,34,34,0.0,1.0
6085,13,2,0,34,34,0.0,1.0
5948,13,2,0,42,42,0.0,1.0
5974,13,2,0,10,10,0.0,1.0
6090,13,2,0,1,1,0.0,1.0
6068,13,2,0,35,35,0.0,1.0
6024,13,2,2,0,2,1.0,0.0
5976,13,2,3,77,80,0.0375,0.9625
5962,13,2,0,59,59,0.0,1.0
6033,13,2,0,24,24,0.0,1.0
6038,13,2,0,7,7,0.0,1.0
6042,13,2,0,49,49,0.0,1.0
5924,13,2,0,50,50,0.0,1.0
6083,13,2,1,11,12,0.08333333333333333,0.9166666666666666
6178,13,2,4,221,225,0.017777777777777778,0.9822222222222222
6086,13,2,0,25,25,0.0,1.0
5945,13,2,0,95,95,0.0,1.0
5925,13,2,0,122,122,0.0,1.0
5935,13,2,0,3,3,0.0,1.0
6073,13,2,2,5,7,0.2857142857142857,0.7142857142857143
5980,13,2,0,12,12,0.0,1.0
5993,13,2,3,21,24,0.125,0.875
5979,13,2,0,33,33,0.0,1.0
5966,13,2,5,21,26,0.19230769230769232,0.8076923076923077
5967,13,2,1,100,101,0.009900990099009901,0.9900990099009901
5970,13,2,0,14,14,0.0,1.0
6188,13,2,2,1,3,0.6666666666666666,0.3333333333333333
6096,13,2,1,0,1,1.0,0.0
6069,13,2,0,17,17,0.0,1.0
5937,13,2,0,6,6,0.0,1.0
5990,13,2,0,50,50,0.0,1.0
5928,13,2,0,22,22,0.0,1.0
6058,13,2,10,59,69,0.14492753623188406,0.855072463768116
6001,13,2,2,22,24,0.08333333333333333,0.9166666666666666
5964,13,2,0,10,10,0.0,1.0
5950,13,2,0,7,7,0.0,1.0
5991,13,2,0,20,20,0.0,1.0
6177,13,2,0,3,3,0.0,1.0
5961,13,2,0,45,45,0.0,1.0
5938,13,2,3,337,340,0.008823529411764706,0.9911764705882353
5960,13,2,0,36,36,0.0,1.0
5947,13,2,0,78,78,0.0,1.0
5957,13,2,4,3,7,0.5714285714285714,0.42857142857142855
6043,13,2,0,29,29,0.0,1.0
6014,13,2,10,0,10,1.0,0.0
6015,13,2,1,1,2,0.5,0.5
5978,13,2,3,13,16,0.1875,0.8125
5986,13,2,2,2,4,0.5,0.5
5969,13,2,2,2,4,0.5,0.5
5949,13,2,0,30,30,0.0,1.0
5959,13,2,2,38,40,0.05,0.95
6051,13,2,0,108,108,0.0,1.0
6029,13,2,1,19,20,0.05,0.95
6070,13,2,4,0,4,1.0,0.0
5942,13,2,0,108,108,0.0,1.0
5953,13,2,0,28,28,0.0,1.0
6076,13,2,0,14,14,0.0,1.0
5940,13,2,4,5,9,0.4444444444444444,0.5555555555555556
6109,13,2,7,88,95,0.07368421052631578,0.9263157894736842
6187,13,2,0,6,6,0.0,1.0
6053,13,2,0,15,15,0.0,1.0
6104,13,2,2,2,4,0.5,0.5
5943,13,2,0,9,9,0.0,1.0
6168,13,2,0,240,240,0.0,1.0
5989,13,2,0,6,6,0.0,1.0
5963,13,2,5,15,20,0.25,0.75
6194,13,2,0,80,80,0.0,1.0
6003,13,2,1,237,238,0.004201680672268907,0.9957983193277311
6167,13,2,1,9,10,0.1,0.9
6004,13,2,1,134,135,0.007407407407407408,0.9925925925925926
6054,13,2,0,14,14,0.0,1.0
6170,13,2,1,33,34,0.029411764705882353,0.9705882352941176
6063,13,2,4,6,10,0.4,0.6
5988,13,2,0,17,17,0.0,1.0
6075,13,2,1,11,12,0.08333333333333333,0.9166666666666666
6061,13,2,0,26,26,0.0,1.0
5965,13,2,0,45,45,0.0,1.0
6040,13,2,6,6,12,0.5,0.5
6106,13,2,1,29,30,0.03333333333333333,0.9666666666666667
6082,13,2,2,11,13,0.15384615384615385,0.8461538461538461
6031,13,2,0,25,25,0.0,1.0
6039,13,2,3,55,58,0.05172413793103448,0.9482758620689655
6189,14,2,5,17,22,0.22727272727272727,0.7727272727272727
5936,14,2,0,31,31,0.0,1.0
6087,14,2,0,18,18,0.0,1.0
5973,14,2,0,34,34,0.0,1.0
6085,14,2,0,34,34,0.0,1.0
5948,14,2,1,41,42,0.023809523809523808,0.9761904761904762
5974,14,2,0,10,10,0.0,1.0
6090,14,2,0,1,1,0.0,1.0
6068,14,2,0,35,35,0.0,1.0
6024,14,2,1,1,2,0.5,0.5
5976,14,2,2,78,80,0.025,0.975
5962,14,2,0,59,59,0.0,1.0
6033,14,2,2,22,24,0.08333333333333333,0.9166666666666666
6038,14,2,0,7,7,0.0,1.0
6042,14,2,0,49,49,0.0,1.0
5924,14,2,0,50,50,0.0,1.0
6083,14,2,0,12,12,0.0,1.0
6178,14,2,0,225,225,0.0,1.0
6086,14,2,0,25,25,0.0,1.0
5945,14,2,0,95,95,0.0,1.0
5925,14,2,0,122,122,0.0,1.0
5935,14,2,0,3,3,0.0,1.0
6073,14,2,4,3,7,0.5714285714285714,0.42857142857142855
5980,14,2,0,12,12,0.0,1.0
5993,14,2,0,24,24,0.0,1.0
5979,14,2,0,33,33,0.0,1.0
5966,14,2,4,22,26,0.15384615384615385,0.8461538461538461
5967,14,2,1,100,101,0.009900990099009901,0.9900990099009901
5970,14,2,0,14,14,0.0,1.0
6188,14,2,1,2,3,0.3333333333333333,0.6666666666666666
6096,14,2,1,0,1,1.0,0.0
6069,14,2,0,17,17,0.0,1.0
5937,14,2,0,6,6,0.0,1.0
5990,14,2,0,50,50,0.0,1.0
5928,14,2,0,22,22,0.0,1.0
6058,14,2,11,58,69,0.15942028985507245,0.8405797101449275
6001,14,2,2,22,24,0.08333333333333333,0.9166666666666666
5964,14,2,3,7,10,0.3,0.7
5950,14,2,2,5,7,0.2857142857142857,0.7142857142857143
5991,14,2,0,20,20,0.0,1.0
6177,14,2,0,3,3,0.0,1.0
5961,14,2,0,45,45,0.0,1.0
5938,14,2,2,338,340,0.0058823529411764705,0.9941176470588236
5960,14,2,0,36,36,0.0,1.0
5947,14,2,0,78,78,0.0,1.0
5957,14,2,3,4,7,0.42857142857142855,0.5714285714285714
6043,14,2,0,29,29,0.0,1.0
6014,14,2,8,2,10,0.8,0.2
6015,14,2,2,0,2,1.0,0.0
5978,14,2,1,15,16,0.0625,0.9375
5986,14,2,3,1,4,0.75,0.25
5969,14,2,1,3,4,0.25,0.75
5949,14,2,0,30,30,0.0,1.0
5959,14,2,1,39,40,0.025,0.975
6051,14,2,0,108,108,0.0,1.0
6029,14,2,1,19,20,0.05,0.95
6070,14,2,3,1,4,0.75,0.25
5942,14,2,0,108,108,0.0,1.0
5953,14,2,0,28,28,0.0,1.0
6076,14,2,1,13,14,0.07142857142857142,0.9285714285714286
5940,14,2,5,4,9,0.5555555555555556,0.4444444444444444
6109,14,2,4,91,95,0.042105263157894736,0.9578947368421052
6187,14,2,2,4,6,0.3333333333333333,0.6666666666666666
6053,14,2,0,15,15,0.0,1.0
6104,14,2,3,1,4,0.75,0.25
5943,14,2,0,9,9,0.0,1.0
6168,14,2,0,240,240,0.0,1.0
5989,14,2,0,6,6,0.0,1.0
5963,14,2,1,19,20,0.05,0.95
6194,14,2,0,80,80,0.0,1.0
6003,14,2,0,238,238,0.0,1.0
6167,14,2,1,9,10,0.1,0.9
6004,14,2,5,130,135,0.037037037037037035,0.9629629629629629
6054,14,2,0,14,14,0.0,1.0
6170,14,2,0,34,34,0.0,1.0
6063,14,2,7,3,10,0.7,0.3
5988,14,2,0,17,17,0.0,1.0
6075,14,2,2,10,12,0.16666666666666666,0.8333333333333334
6061,14,2,0,26,26,0.0,1.0
5965,14,2,0,45,45,0.0,1.0
6040,14,2,6,6,12,0.5,0.5
6106,14,2,0,30,30,0.0,1.0
6082,14,2,0,13,13,0.0,1.0
6031,14,2,2,23,25,0.08,0.92
6039,14,2,0,58,58,0.0,1.0
6189,15,2,2,20,22,0.09090909090909091,0.9090909090909091
5936,15,2,0,31,31,0.0,1.0
6087,15,2,0,18,18,0.0,1.0
5973,15,2,0,34,34,0.0,1.0
6085,15,2,0,34,34,0.0,1.0
5948,15,2,0,42,42,0.0,1.0
5974,15,2,0,10,10,0.0,1.0
6090,15,2,0,1,1,0.0,1.0
6068,15,2,0,35,35,0.0,1.0
6024,15,2,2,0,2,1.0,0.0
5976,15,2,3,77,80,0.0375,0.9625
5962,15,2,0,59,59,0.0,1.0
6033,15,2,2,22,24,0.08333333333333333,0.9166666666666666
6038,15,2,0,7,7,0.0,1.0
6042,15,2,0,49,49,0.0,1.0
5924,15,2,0,50,50,0.0,1.0
6083,15,2,1,11,12,0.08333333333333333,0.9166666666666666
6178,15,2,1,224,225,0.0044444444444444444,0.9955555555555555
6086,15,2,0,25,25,0.0,1.0
5945,15,2,0,95,95,0.0,1.0
5925,15,2,0,122,122,0.0,1.0
5935,15,2,0,3,3,0.0,1.0
6073,15,2,3,4,7,0.42857142857142855,0.5714285714285714
5980,15,2,0,12,12,0.0,1.0
5993,15,2,0,24,24,0.0,1.0
5979,15,2,0,33,33,0.0,1.0
5966,15,2,2,24,26,0.07692307692307693,0.9230769230769231
5967,15,2,2,99,101,0.019801980198019802,0.9801980198019802
5970,15,2,0,14,14,0.0,1.0
6188,15,2,2,1,3,0.6666666666666666,0.3333333333333333
6096,15,2,1,0,1,1.0,0.0
6069,15,2,0,17,17,0.0,1.0
5937,15,2,0,6,6,0.0,1.0
5990,15,2,0,50,50,0.0,1.0
5928,15,2,0,22,22,0.0,1.0
6058,15,2,8,61,69,0.11594202898550725,0.8840579710144928
6001,15,2,3,21,24,0.125,0.875
5964,15,2,0,10,10,0.0,1.0
5950,15,2,2,5,7,0.2857142857142857,0.7142857142857143
5991,15,2,0,20,20,0.0,1.0
6177,15,2,0,3,3,0.0,1.0
5961,15,2,0,45,45,0.0,1.0
5938,15,2,1,339,340,0.0029411764705882353,0.9970588235294118
5960,15,2,0,36,36,0.0,1.0
5947,15,2,0,78,78,0.0,1.0
5957,15,2,3,4,7,0.42857142857142855,0.5714285714285714
6043,15,2,0,29,29,0.0,1.0
6014,15,2,9,1,10,0.9,0.1
6015,15,2,2,0,2,1.0,0.0
5978,15,2,0,16,16,0.0,1.0
5986,15,2,3,1,4,0.75,0.25
5969,15,2,2,2,4,0.5,0.5
5949,15,2,0,30,30,0.0,1.0
5959,15,2,2,38,40,0.05,0.95
6051,15,2,0,108,108,0.0,1.0
6029,15,2,1,19,20,0.05,0.95
6070,15,2,4,0,4,1.0,0.0
5942,15,2,0,108,108,0.0,1.0
5953,15,2,0,28,28,0.0,1.0
6076,15,2,1,13,14,0.07142857142857142,0.9285714285714286
5940,15,2,4,5,9,0.4444444444444444,0.5555555555555556
6109,15,2,6,89,95,0.06315789473684211,0.9368421052631579
6187,15,2,0,6,6,0.0,1.0
6053,15,2,0,15,15,0.0,1.0
6104,15,2,2,2,4,0.5,0.5
5943,15,2,0,9,9,0.0,1.0
6168,15,2,0,240,240,0.0,1.0
5989,15,2,0,6,6,0.0,1.0
5963,15,2,3,17,20,0.15,0.85
6194,15,2,0,80,80,0.0,1.0
6003,15,2,2,236,238,0.008403361344537815,0.9915966386554622
6167,15,2,1,9,10,0.1,0.9
6004,15,2,1,134,135,0.007407407407407408,0.9925925925925926
6054,15,2,0,14,14,0.0,1.0
6170,15,2,3,31,34,0.08823529411764706,0.9117647058823529
6063,15,2,4,6,10,0.4,0.6
5988,15,2,0,17,17,0.0,1.0
6075,15,2,2,10,12,0.16666666666666666,0.8333333333333334
6061,15,2,0,26,26,0.0,1.0
5965,15,2,0,45,45,0.0,1.0
6040,15,2,6,6,12,0.5,0.5
6106,15,2,1,29,30,0.03333333333333333,0.9666666666666667
6082,15,2,0,13,13,0.0,1.0
6031,15,2,1,24,25,0.04,0.96
6039,15,2,1,57,58,0.017241379310344827,0.9827586206896551
6189,16,2,2,20,22,0.09090909090909091,0.9090909090909091
5936,16,2,0,31,31,0.0,1.0
6087,16,2,0,18,18,0.0,1.0
5973,16,2,0,34,34,0.0,1.0
6085,16,2,0,34,34,0.0,1.0
5948,16,2,1,41,42,0.023809523809523808,0.9761904761904762
5974,16,2,0,10,10,0.0,1.0
6090,16,2,0,1,1,0.0,1.0
6068,16,2,0,35,35,0.0,1.0
6024,16,2,2,0,2,1.0,0.0
5976,16,2,0,80,80,0.0,1.0
5962,16,2,0,59,59,0.0,1.0
6033,16,2,0,24,24,0.0,1.0
6038,16,2,0,7,7,0.0,1.0
6042,16,2,0,49,49,0.0,1.0
5924,16,2,0,50,50,0.0,1.0
6083,16,2,2,10,12,0.16666666666666666,0.8333333333333334
6178,16,2,0,225,225,0.0,1.0
6086,16,2,0,25,25,0.0,1.0
5945,16,2,0,95,95,0.0,1.0
5925,16,2,0,122,122,0.0,1.0
5935,16,2,0,3,3,0.0,1.0
6073,16,2,2,5,7,0.2857142857142857,0.7142857142857143
5980,16,2,0,12,12,0.0,1.0
5993,16,2,0,24,24,0.0,1.0
5979,16,2,0,33,33,0.0,1.0
5966,16,2,1,25,26,0.038461538461538464,0.9615384615384616
5967,16,2,2,99,101,0.019801980198019802,0.9801980198019802
5970,16,2,0,14,14,0.0,1.0
6188,16,2,2,1,3,0.6666666666666666,0.3333333333333333
6096,16,2,1,0,1,1.0,0.0
6069,16,2,0,17,17,0.0,1.0
5937,16,2,0,6,6,0.0,1.0
5990,16,2,0,50,50,0.0,1.0
5928,16,2,0,22,22,0.0,1.0
6058,16,2,3,66,69,0.043478260869565216,0.9565217391304348
6001,16,2,4,20,24,0.16666666666666666,0.8333333333333334
5964,16,2,1,9,10,0.1,0.9
5950,16,2,1,6,7,0.14285714285714285,0.8571428571428571
5991,16,2,0,20,20,0.0,1.0
6177,16,2,0,3,3,0.0,1.0
5961,16,2,0,45,45,0.0,1.0
5938,16,2,2,338,340,0.0058823529411764705,0.9941176470588236
5960,16,2,0,36,36,0.0,1.0
5947,16,2,0,78,78,0.0,1.0
5957,16,2,5,2,7,0.7142857142857143,0.2857142857142857
6043,16,2,0,29,29,0.0,1.0
6014,16,2,7,3,10,0.7,0.3
6015,16,2,2,0,2,1.0,0.0
5978,16,2,1,15,16,0.0625,0.9375
5986,16,2,3,1,4,0.75,0.25
5969,16,2,1,3,4,0.25,0.75
5949,16,2,0,30,30,0.0,1.0
5959,16,2,2,38,40,0.05,0.95
6051,16,2,0,108,108,0.0,1.0
6029,16,2,0,20,20,0.0,1.0
6070,16,2,4,0,4,1.0,0.0
5942,16,2,0,108,108,0.0,1.0
5953,16,2,0,28,28,0.0,1.0
6076,16,2,1,13,14,0.07142857142857142,0.9285714285714286
5940,16,2,4,5,9,0.4444444444444444,0.5555555555555556
6109,16,2,4,91,95,0.042105263157894736,0.9578947368421052
6187,16,2,0,6,6,0.0,1.0
6053,16,2,0,15,15,0.0,1.0
6104,16,2,3,1,4,0.75,0.25
5943,16,2,0,9,9,0.0,1.0
6168,16,2,0,240,240,0.0,1.0
5989,16,2,0,6,6,0.0,1.0
5963,16,2,1,19,20,0.05,0.95
6194,16,2,0,80,80,0.0,1.0
6003,16,2,1,237,238,0.004201680672268907,0.9957983193277311
6167,16,2,1,9,10,0.1,0.9
6004,16,2,2,133,135,0.014814814814814815,0.9851851851851852
6054,16,2,0,14,14,0.0,1.0
6170,16,2,3,31,34,0.08823529411764706,0.9117647058823529
6063,16,2,3,7,10,0.3,0.7
5988,16,2,0,17,17,0.0,1.0
6075,16,2,0,12,12,0.0,1.0
6061,16,2,0,26,26,0.0,1.0
5965,16,2,0,45,45,0.0,1.0
6040,16,2,7,5,12,0.5833333333333334,0.4166666666666667
6106,16,2,1,29,30,0.03333333333333333,0.9666666666666667
6082,16,2,2,11,13,0.15384615384615385,0.8461538461538461
6031,16,2,1,24,25,0.04,0.96
6039,16,2,3,55,58,0.05172413793103448,0.9482758620689655
6189,17,2,4,18,22,0.18181818181818182,0.8181818181818182
5936,17,2,0,31,31,0.0,1.0
6087,17,2,0,18,18,0.0,1.0
5973,17,2,0,34,34,0.0,1.0
6085,17,2,0,34,34,0.0,1.0
5948,17,2,0,42,42,0.0,1.0
5974,17,2,0,10,10,0.0,1.0
6090,17,2,0,1,1,0.0,1.0
6068,17,2,0,35,35,0.0,1.0
6024,17,2,1,1,2,0.5,0.5
5976,17,2,0,80,80,0.0,1.0
5962,17,2,0,59,59,0.0,1.0
6033,17,2,0,24,24,0.0,1.0
6038,17,2,0,7,7,0.0,1.0
6042,17,2,0,49,49,0.0,1.0
5924,17,2,0,50,50,0.0,1.0
6083,17,2,6,6,12,0.5,0.5
6178,17,2,0,225,225,0.0,1.0
6086,17,2,0,25,25,0.0,1.0
5945,17,2,0,95,95,0.0,1.0
5925,17,2,0,122,122,0.0,1.0
5935,17,2,0,3,3,0.0,1.0
6073,17,2,3,4,7,0.42857142857142855,0.5714285714285714
5980,17,2,2,10,12,0.16666666666666666,0.8333333333333334
5993,17,2,0,24,24,0.0,1.0
5979,17,2,0,33,33,0.0,1.0
5966,17,2,1,25,26,0.038461538461538464,0.9615384615384616
5967,17,2,4,97,101,0.039603960396039604,0.9603960396039604
5970,17,2,0,14,14,0.0,1.0
6188,17,2,0,3,3,0.0,1.0
6096,17,2,1,0,1,1.0,0.0
6069,17,2,0,17,17,0.0,1.0
5937,17,2,0,6,6,0.0,1.0
5990,17,2,0,50,50,0.0,1.0
5928,17,2,0,22,22,0.0,1.0
6058,17,2,4,65,69,0.057971014492753624,0.9420289855072463
6001,17,2,1,23,24,0.041666666666666664,0.9583333333333334
5964,17,2,1,9,10,0.1,0.9
5950,17,2,2,5,7,0.2857142857142857,0.7142857142857143
5991,17,2,0,20,20,0.0,1.0
6177,17,2,0,3,3,0.0,1.0
5961,17,2,0,45,45,0.0,1.0
5938,17,2,1,339,340,0.0029411764705882353,0.9970588235294118
5960,17,2,0,36,36,0.0,1.0
5947,17,2,0,78,78,0.0,1.0
5957,17,2,2,5,7,0.2857142857142857,0.7142857142857143
6043,17,2,0,29,29,0.0,1.0
6014,17,2,7,3,10,0.7,0.3
6015,17,2,1,1,2,0.5,0.5
5978,17,2,0,16,16,0.0,1.0
5986,17,2,2,2,4,0.5,0.5
5969,17,2,1,3,4,0.25,0.75
5949,17,2,0,30,30,0.0,1.0
5959,17,2,2,38,40,0.05,0.95
6051,17,2,0,108,108,0.0,1.0
6029,17,2,1,19,20,0.05,0.95
6070,17,2,3,1,4,0.75,0.25
5942,17,2,0,108,108,0.0,1.0
5953,17,2,0,28,28,0.0,1.0
6076,17,2,0,14,14,0.0,1.0
5940,17,2,4,5,9,0.4444444444444444,0.5555555555555556
6109,17,2,3,92,95,0.031578947368421054,0.968421052631579
6187,17,2,0,6,6,0.0,1.0
6053,17,2,0,15,15,0.0,1.0
6104,17,2,2,2,4,0.5,0.5
5943,17,2,0,9,9,0.0,1.0
6168,17,2,0,240,240,0.0,1.0
5989,17,2,0,6,6,0.0,1.0
5963,17,2,0,20,20,0.0,1.0
6194,17,2,0,80,80,0.0,1.0
6003,17,2,2,236,238,0.008403361344537815,0.9915966386554622
6167,17,2,2,8,10,0.2,0.8
6004,17,2,1,134,135,0.007407407407407408,0.9925925925925926
6054,17,2,0,14,14,0.0,1.0
6170,17,2,4,30,34,0.11764705882352941,0.8823529411764706
6063,17,2,2,8,10,0.2,0.8
5988,17,2,0,17,17,0.0,1.0
6075,17,2,2,10,12,0.16666666666666666,0.8333333333333334
6061,17,2,0,26,26,0.0,1.0
5965,17,2,0,45,45,0.0,1.0
6040,17,2,6,6,12,0.5,0.5
6106,17,2,0,30,30,0.0,1.0
6082,17,2,0,13,13,0.0,1.0
6031,17,2,2,23,25,0.08,0.92
6039,17,2,4,54,58,0.06896551724137931,0.9310344827586207
6189,18,2,2,20,22,0.09090909090909091,0.9090909090909091
5936,18,2,0,31,31,0.0,1.0
6087,18,2,0,18,18,0.0,1.0
5973,18,2,0,34,34,0.0,1.0
6085,18,2,0,34,34,0.0,1.0
5948,18,2,0,42,42,0.0,1.0
5974,18,2,0,10,10,0.0,1.0
6090,18,2,0,1,1,0.0,1.0
6068,18,2,0,35,35,0.0,1.0
6024,18,2,2,0,2,1.0,0.0
5976,18,2,0,80,80,0.0,1.0
5962,18,2,0,59,59,0.0,1.0
6033,18,2,2,22,24,0.08333333333333333,0.9166666666666666
6038,18,2,0,7,7,0.0,1.0
6042,18,2,0,49,49,0.0,1.0
5924,18,2,0,50,50,0.0,1.0
6083,18,2,7,5,12,0.5833333333333334,0.4166666666666667
6178,18,2,0,225,225,0.0,1.0
6086,18,2,0,25,25,0.0,1.0
5945,18,2,0,95,95,0.0,1.0
5925,18,2,0,122,122,0.0,1.0
5935,18,2,0,3,3,0.0,1.0
6073,18,2,2,5,7,0.2857142857142857,0.7142857142857143
5980,18,2,0,12,12,0.0,1.0
5993,18,2,0,24,24,0.0,1.0
5979,18,2,0,33,33,0.0,1.0
5966,18,2,0,26,26,0.0,1.0
5967,18,2,2,99,101,0.019801980198019802,0.9801980198019802
5970,18,2,0,14,14,0.0,1.0
6188,18,2,3,0,3,1.0,0.0
6096,18,2,1,0,1,1.0,0.0
6069,18,2,0,17,17,0.0,1.0
5937,18,2,0,6,6,0.0,1.0
5990,18,2,0,50,50,0.0,1.0
5928,18,2,0,22,22,0.0,1.0
6058,18,2,4,65,69,0.057971014492753624,0.9420289855072463
6001,18,2,4,20,24,0.16666666666666666,0.8333333333333334
5964,18,2,1,9,10,0.1,0.9
5950,18,2,1,6,7,0.14285714285714285,0.8571428571428571
5991,18,2,0,20,20,0.0,1.0
6177,18,2,0,3,3,0.0,1.0
5961,18,2,0,45,45,0.0,1.0
5938,18,2,0,340,340,0.0,1.0
5960,18,2,0,36,36,0.0,1.0
5947,18,2,0,78,78,0.0,1.0
5957,18,2,1,6,7,0.14285714285714285,0.8571428571428571
6043,18,2,0,29,29,0.0,1.0
6014,18,2,5,5,10,0.5,0.5
6015,18,2,2,0,2,1.0,0.0
5978,18,2,1,15,16,0.0625,0.9375
5986,18,2,4,0,4,1.0,0.0
5969,18,2,0,4,4,0.0,1.0
5949,18,2,0,30,30,0.0,1.0
5959,18,2,1,39,40,0.025,0.975
6051,18,2,0,108,108,0.0,1.0
6029,18,2,0,20,20,0.0,1.0
6070,18,2,3,1,4,0.75,0.25
5942,18,2,0,108,108,0.0,1.0
5953,18,2,0,28,28,0.0,1.0
6076,18,2,0,14,14,0.0,1.0
5940,18,2,3,6,9,0.3333333333333333,0.6666666666666666
6109,18,2,1,94,95,0.010526315789473684,0.9894736842105263
6187,18,2,0,6,6,0.0,1.0
6053,18,2,0,15,15,0.0,1.0
6104,18,2,4,0,4,1.0,0.0
5943,18,2,0,9,9,0.0,1.0
6168,18,2,0,240,240,0.0,1.0
5989,18,2,0,6,6,0.0,1.0
5963,18,2,0,20,20,0.0,1.0
6194,18,2,0,80,80,0.0,1.0
6003,18,2,1,237,238,0.004201680672268907,0.9957983193277311
6167,18,2,1,9,10,0.1,0.9
6004,18,2,1,134,135,0.007407407407407408,0.9925925925925926
6054,18,2,0,14,14,0.0,1.0
6170,18,2,0,34,34,0.0,1.0
6063,18,2,5,5,10,0.5,0.5
5988,18,2,0,17,17,0.0,1.0
6075,18,2,2,10,12,0.16666666666666666,0.8333333333333334
6061,18,2,0,26,26,0.0,1.0
5965,18,2,0,45,45,0.0,1.0
6040,18,2,5,7,12,0.4166666666666667,0.5833333333333334
6106,18,2,1,29,30,0.03333333333333333,0.9666666666666667
6082,18,2,2,11,13,0.15384615384615385,0.8461538461538461
6031,18,2,0,25,25,0.0,1.0
6039,18,2,1,57,58,0.017241379310344827,0.9827586206896551
6189,19,2,1,21,22,0.045454545454545456,0.9545454545454546
5936,19,2,0,31,31,0.0,1.0
6087,19,2,0,18,18,0.0,1.0
5973,19,2,0,34,34,0.0,1.0
6085,19,2,0,34,34,0.0,1.0
5948,19,2,1,41,42,0.023809523809523808,0.9761904761904762
5974,19,2,0,10,10,0.0,1.0
6090,19,2,0,1,1,0.0,1.0
6068,19,2,0,35,35,0.0,1.0
6024,19,2,1,1,2,0.5,0.5
5976,19,2,1,79,80,0.0125,0.9875
5962,19,2,0,59,59,0.0,1.0
6033,19,2,0,24,24,0.0,1.0
6038,19,2,0,7,7,0.0,1.0
6042,19,2,0,49,49,0.0,1.0
5924,19,2,0,50,50,0.0,1.0
6083,19,2,4,8,12,0.3333333333333333,0.6666666666666666
6178,19,2,0,225,225,0.0,1.0
6086,19,2,0,25,25,0.0,1.0
5945,19,2,0,95,95,0.0,1.0
5925,19,2,0,122,122,0.0,1.0
5935,19,2,0,3,3,0.0,1.0
6073,19,2,3,4,7,0.42857142857142855,0.5714285714285714
5980,19,2,2,10,12,0.16666666666666666,0.8333333333333334
5993,19,2,0,24,24,0.0,1.0
5979,19,2,0,33,33,0.0,1.0
5966,19,2,0,26,26,0.0,1.0
5967,19,2,1,100,101,0.009900990099009901,0.9900990099009901
5970,19,2,0,14,14,0.0,1.0
6188,19,2,1,2,3,0.3333333333333333,0.6666666666666666
6096,19,2,1,0,1,1.0,0.0
6069,19,2,0,17,17,0.0,1.0
5937,19,2,0,6,6,0.0,1.0
5990,19,2,0,50,50,0.0,1.0
5928,19,2,0,22,22,0.0,1.0
6058,19,2,2,67,69,0.028985507246376812,0.9710144927536232
6001,19,2,6,18,24,0.25,0.75
5964,19,2,4,6,10,0.4,0.6
5950,19,2,1,6,7,0.14285714285714285,0.8571428571428571
5991,19,2,0,20,20,0.0,1.0
6177,19,2,0,3,3,0.0,1.0
5961,19,2,0,45,45,0.0,1.0
5938,19,2,0,340,340,0.0,1.0
5960,19,2,0,36,36,0.0,1.0
5947,19,2,0,78,78,0.0,1.0
5957,19,2,5,2,7,0.7142857142857143,0.2857142857142857
6043,19,2,0,29,29,0.0,1.0
6014,19,2,5,5,10,0.5,0.5
6015,19,2,1,1,2,0.5,0.5
5978,19,2,0,16,16,0.0,1.0
5986,19,2,2,2,4,0.5,0.5
5969,19,2,1,3,4,0.25,0.75
5949,19,2,0,30,30,0.0,1.0
5959,19,2,5,35,40,0.125,0.875
6051,19,2,0,108,108,0.0,1.0
6029,19,2,0,20,20,0.0,1.0
6070,19,2,4,0,4,1.0,0.0
5942,19,2,0,108,108,0.0,1.0
5953,19,2,0,28,28,0.0,1.0
6076,19,2,0,14,14,0.0,1.0
5940,19,2,4,5,9,0.4444444444444444,0.5555555555555556
6109,19,2,2,93,95,0.021052631578947368,0.9789473684210527
6187,19,2,0,6,6,0.0,1.0
6053,19,2,0,15,15,0.0,1.0
6104,19,2,2,2,4,0.5,0.5
5943,19,2,0,9,9,0.0,1.0
6168,19,2,0,240,240,0.0,1.0
5989,19,2,0,6,6,0.0,1.0
5963,19,2,1,19,20,0.05,0.95
6194,19,2,0,80,80,0.0,1.0
6003,19,2,1,237,238,0.004201680672268907,0.9957983193277311
6167,19,2,1,9,10,0.1,0.9
6004,19,2,2,133,135,0.014814814814814815,0.9851851851851852
6054,19,2,0,14,14,0.0,1.0
6170,19,2,0,34,34,0.0,1.0
6063,19,2,3,7,10,0.3,0.7
5988,19,2,0,17,17,0.0,1.0
6075,19,2,2,10,12,0.16666666666666666,0.8333333333333334
6061,19,2,0,26,26,0.0,1.0
5965,19,2,0,45,45,0.0,1.0
6040,19,2,3,9,12,0.25,0.75
6106,19,2,1,29,30,0.03333333333333333,0.9666666666666667
6082,19,2,2,11,13,0.15384615384615385,0.8461538461538461
6031,19,2,1,24,25,0.04,0.96
6039,19,2,6,52,58,0.10344827586206896,0.896551724137931
6189,20,2,1,21,22,0.045454545454545456,0.9545454545454546
5936,20,2,0,31,31,0.0,1.0
6087,20,2,0,18,18,0.0,1.0
5973,20,2,0,34,34,0.0,1.0
6085,20,2,0,34,34,0.0,1.0
5948,20,2,1,41,42,0.023809523809523808,0.9761904761904762
5974,20,2,0,10,10,0.0,1.0
6090,20,2,0,1,1,0.0,1.0
6068,20,2,0,35,35,0.0,1.0
6024,20,2,2,0,2,1.0,0.0
5976,20,2,3,77,80,0.0375,0.9625
5962,20,2,0,59,59,0.0,1.0
6033,20,2,0,24,24,0.0,1.0
6038,20,2,0,7,7,0.0,1.0
6042,20,2,0,49,49,0.0,1.0
5924,20,2,0,50,50,0.0,1.0
6083,20,2,3,9,12,0.25,0.75
6178,20,2,0,225,225,0.0,1.0
6086,20,2,0,25,25,0.0,1.0
5945,20,2,0,95,95,0.0,1.0
5925,20,2,0,122,122,0.0,1.0
5935,20,2,0,3,3,0.0,1.0
6073,20,2,2,5,7,0.2857142857142857,0.7142857142857143
5980,20,2,2,10,12,0.16666666666666666,0.8333333333333334
5993,20,2,0,24,24,0.0,1.0
5979,20,2,0,33,33,0.0,1.0
5966,20,2,0,26,26,0.0,1.0
5967,20,2,0,101,101,0.0,1.0
5970,20,2,0,14,14,0.0,1.0
6188,20,2,2,1,3,0.6666666666666666,0.3333333333333333
6096,20,2,1,0,1,1.0,0.0
6069,20,2,0,17,17,0.0,1.0
5937,20,2,0,6,6,0.0,1.0
5990,20,2,0,50,50,0.0,1.0
5928,20,2,0,22,22,0.0,1.0
6058,20,2,1,68,69,0.014492753623188406,0.9855072463768116
6001,20,2,2,22,24,0.08333333333333333,0.9166666666666666
5964,20,2,4,6,10,0.4,0.6
5950,20,2,1,6,7,0.14285714285714285,0.8571428571428571
5991,20,2,0,20,20,0.0,1.0
6177,20,2,0,3,3,0.0,1.0
5961,20,2,0,45,45,0.0,1.0
5938,20,2,3,337,340,0.008823529411764706,0.9911764705882353
5960,20,2,0,36,36,0.0,1.0
5947,20,2,0,78,78,0.0,1.0
5957,20,2,1,6,7,0.14285714285714285,0.8571428571428571
6043,20,2,0,29,29,0.0,1.0
6014,20,2,3,7,10,0.3,0.7
6015,20,2,2,0,2,1.0,0.0
5978,20,2,2,14,16,0.125,0.875
5986,20,2,3,1,4,0.75,0.25
5969,20,2,0,4,4,0.0,1.0
5949,20,2,3,27,30,0.1,0.9
5959,20,2,1,39,40,0.025,0.975
6051,20,2,0,108,108,0.0,1.0
6029,20,2,1,19,20,0.05,0.95
6070,20,2,2,2,4,0.5,0.5
5942,20,2,0,108,108,0.0,1.0
5953,20,2,0,28,28,0.0,1.0
6076,20,2,1,13,14,0.07142857142857142,0.9285714285714286
5940,20,2,6,3,9,0.6666666666666666,0.3333333333333333
6109,20,2,6,89,95,0.06315789473684211,0.9368421052631579
6187,20,2,0,6,6,0.0,1.0
6053,20,2,4,11,15,0.26666666666666666,0.7333333333333333
6104,20,2,3,1,4,0.75,0.25
5943,20,2,0,9,9,0.0,1.0
6168,20,2,0,240,240,0.0,1.0
5989,20,2,0,6,6,0.0,1.0
5963,20,2,0,20,20,0.0,1.0
6194,20,2,0,80,80,0.0,1.0
6003,20,2,0,238,238,0.0,1.0
6167,20,2,1,9,10,0.1,0.9
6004,20,2,1,134,135,0.007407407407407408,0.9925925925925926
6054,20,2,0,14,14,0.0,1.0
6170,20,2,3,31,34,0.08823529411764706,0.9117647058823529
6063,20,2,1,9,10,0.1,0.9
5988,20,2,0,17,17,0.0,1.0
6075,20,2,2,10,12,0.16666666666666666,0.8333333333333334
6061,20,2,0,26,26,0.0,1.0
5965,20,2,0,45,45,0.0,1.0
6040,20,2,6,6,12,0.5,0.5
6106,20,2,1,29,30,0.03333333333333333,0.9666666666666667
6082,20,2,2,11,13,0.15384615384615385,0.8461538461538461
6031,20,2,1,24,25,0.04,0.96
6039,20,2,4,54,58,0.06896551724137931,0.9310344827586207
6189,21,2,0,22,22,0.0,1.0
5936,21,2,0,31,31,0.0,1.0
6087,21,2,0,18,18,0.0,1.0
5973,21,2,0,34,34,0.0,1.0
6085,21,2,0,34,34,0.0,1.0
5948,21,2,0,42,42,0.0,1.0
5974,21,2,0,10,10,0.0,1.0
6090,21,2,0,1,1,0.0,1.0
6068,21,2,0,35,35,0.0,1.0
6024,21,2,1,1,2,0.5,0.5
5976,21,2,3,77,80,0.0375,0.9625
5962,21,2,0,59,59,0.0,1.0
6033,21,2,2,22,24,0.08333333333333333,0.9166666666666666
6038,21,2,0,7,7,0.0,1.0
6042,21,2,0,49,49,0.0,1.0
5924,21,2,0,50,50,0.0,1.0
6083,21,2,2,10,12,0.16666666666666666,0.8333333333333334
6178,21,2,0,225,225,0.0,1.0
6086,21,2,0,25,25,0.0,1.0
5945,21,2,0,95,95,0.0,1.0
5925,21,2,0,122,122,0.0,1.0
5935,21,2,0,3,3,0.0,1.0
6073,21,2,1,6,7,0.14285714285714285,0.8571428571428571
5980,21,2,0,12,12,0.0,1.0
5993,21,2,0,24,24,0.0,1.0
5979,21,2,0,33,33,0.0,1.0
5966,21,2,0,26,26,0.0,1.0
5967,21,2,3,98,101,0.0297029702970297,0.9702970297029703
5970,21,2,0,14,14,0.0,1.0
6188,21,2,2,1,3,0.6666666666666666,0.3333333333333333
6096,21,2,1,0,1,1.0,0.0
6069,21,2,0,17,17,0.0,1.0
5937,21,2,0,6,6,0.0,1.0
5990,21,2,0,50,50,0.0,1.0
5928,21,2,0,22,22,0.0,1.0
6058,21,2,7,62,69,0.10144927536231885,0.8985507246376812
6001,21,2,4,20,24,0.16666666666666666,0.8333333333333334
5964,21,2,0,10,10,0.0,1.0
5950,21,2,1,6,7,0.14285714285714285,0.8571428571428571
5991,21,2,0,20,20,0.0,1.0
6177,21,2,0,3,3,0.0,1.0
5961,21,2,0,45,45,0.0,1.0
5938,21,2,0,340,340,0.0,1.0
5960,21,2,0,36,36,0.0,1.0
5947,21,2,0,78,78,0.0,1.0
5957,21,2,2,5,7,0.2857142857142857,0.7142857142857143
6043,21,2,0,29,29,0.0,1.0
6014,21,2,6,4,10,0.6,0.4
6015,21,2,1,1,2,0.5,0.5
5978,21,2,0,16,16,0.0,1.0
5986,21,2,2,2,4,0.5,0.5
5969,21,2,0,4,4,0.0,1.0
5949,21,2,0,30,30,0.0,1.0
5959,21,2,2,38,40,0.05,0.95
6051,21,2,0,108,108,0.0,1.0
6029,21,2,0,20,20,0.0,1.0
6070,21,2,3,1,4,0.75,0.25
5942,21,2,0,108,108,0.0,1.0
5953,21,2,0,28,28,0.0,1.0
6076,21,2,2,12,14,0.14285714285714285,0.8571428571428571
5940,21,2,5,4,9,0.5555555555555556,0.4444444444444444
6109,21,2,6,89,95,0.06315789473684211,0.9368421052631579
6187,21,2,2,4,6,0.3333333333333333,0.6666666666666666
6053,21,2,0,15,15,0.0,1.0
6104,21,2,2,2,4,0.5,0.5
5943,21,2,0,9,9,0.0,1.0
6168,21,2,0,240,240,0.0,1.0
5989,21,2,0,6,6,0.0,1.0
5963,21,2,1,19,20,0.05,0.95
6194,21,2,0,80,80,0.0,1.0
6003,21,2,1,237,238,0.004201680672268907,0.9957983193277311
6167,21,2,2,8,10,0.2,0.8
6004,21,2,1,134,135,0.007407407407407408,0.9925925925925926
6054,21,2,0,14,14,0.0,1.0
6170,21,2,1,33,34,0.029411764705882353,0.9705882352941176
6063,21,2,3,7,10,0.3,0.7
5988,21,2,0,17,17,0.0,1.0
6075,21,2,0,12,12,0.0,1.0
6061,21,2,0,26,26,0.0,1.0
5965,21,2,0,45,45,0.0,1.0
6040,21,2,6,6,12,0.5,0.5
6106,21,2,0,30,30,0.0,1.0
6082,21,2,0,13,13,0.0,1.0
6031,21,2,2,23,25,0.08,0.92
6039,21,2,3,55,58,0.05172413793103448,0.9482758620689655
6189,22,2,1,21,22,0.045454545454545456,0.9545454545454546
5936,22,2,0,31,31,0.0,1.0
6087,22,2,0,18,18,0.0,1.0
5973,22,2,0,34,34,0.0,1.0
6085,22,2,0,34,34,0.0,1.0
5948,22,2,1,41,42,0.023809523809523808,0.9761904761904762
5974,22,2,0,10,10,0.0,1.0
6090,22,2,0,1,1,0.0,1.0
6068,22,2,0,35,35,0.0,1.0
6024,22,2,2,0,2,1.0,0.0
5976,22,2,1,79,80,0.0125,0.9875
5962,22,2,0,59,59,0.0,1.0
6033,22,2,4,20,24,0.16666666666666666,0.8333333333333334
6038,22,2,0,7,7,0.0,1.0
6042,22,2,0,49,49,0.0,1.0
5924,22,2,0,50,50,0.0,1.0
6083,22,2,4,8,12,0.3333333333333333,0.6666666666666666
6178,22,2,0,225,225,0.0,1.0
6086,22,2,0,25,25,0.0,1.0
5945,22,2,0,95,95,0.0,1.0
5925,22,2,0,122,122,0.0,1.0
5935,22,2,0,3,3,0.0,1.0
6073,22,2,1,6,7,0.14285714285714285,0.8571428571428571
5980,22,2,0,12,12,0.0,1.0
5993,22,2,0,24,24,0.0,1.0
5979,22,2,0,33,33,0.0,1.0
5966,22,2,1,25,26,0.038461538461538464,0.9615384615384616
5967,22,2,1,100,101,0.009900990099009901,0.9900990099009901
5970,22,2,0,14,14,0.0,1.0
6188,22,2,0,3,3,0.0,1.0
6096,22,2,1,0,1,1.0,0.0
6069,22,2,0,17,17,0.0,1.0
5937,22,2,0,6,6,0.0,1.0
5990,22,2,0,50,50,0.0,1.0
5928,22,2,0,22,22,0.0,1.0
6058,22,2,5,64,69,0.07246376811594203,0.927536231884058
6001,22,2,0,24,24,0.0,1.0
5964,22,2,1,9,10,0.1,0.9
5950,22,2,1,6,7,0.14285714285714285,0.8571428571428571
5991,22,2,0,20,20,0.0,1.0
6177,22,2,0,3,3,0.0,1.0
5961,22,2,0,45,45,0.0,1.0
5938,22,2,0,340,340,0.0,1.0
5960,22,2,0,36,36,0.0,1.0
5947,22,2,0,78,78,0.0,1.0
5957,22,2,2,5,7,0.2857142857142857,0.7142857142857143
6043,22,2,0,29,29,0.0,1.0
6014,22,2,5,5,10,0.5,0.5
6015,22,2,1,1,2,0.5,0.5
5978,22,2,0,16,16,0.0,1.0
5986,22,2,2,2,4,0.5,0.5
5969,22,2,0,4,4,0.0,1.0
5949,22,2,0,30,30,0.0,1.0
5959,22,2,0,40,40,0.0,1.0
6051,22,2,0,108,108,0.0,1.0
6029,22,2,1,19,20,0.05,0.95
6070,22,2,3,1,4,0.75,0.25
5942,22,2,0,108,108,0.0,1.0
5953,22,2,0,28,28,0.0,1.0
6076,22,2,0,14,14,0.0,1.0
5940,22,2,4,5,9,0.4444444444444444,0.5555555555555556
6109,22,2,1,94,95,0.010526315789473684,0.9894736842105263
6187,22,2,0,6,6,0.0,1.0
6053,22,2,4,11,15,0.26666666666666666,0.7333333333333333
6104,22,2,1,3,4,0.25,0.75
5943,22,2,0,9,9,0.0,1.0
6168,22,2,0,240,240,0.0,1.0
5989,22,2,0,6,6,0.0,1.0
5963,22,2,0,20,20,0.0,1.0
6194,22,2,0,80,80,0.0,1.0
6003,22,2,1,237,238,0.004201680672268907,0.9957983193277311
6167,22,2,0,10,10,0.0,1.0
6004,22,2,0,135,135,0.0,1.0
6054,22,2,0,14,14,0.0,1.0
6170,22,2,0,34,34,0.0,1.0
6063,22,2,2,8,10,0.2,0.8
5988,22,2,0,17,17,0.0,1.0
6075,22,2,1,11,12,0.08333333333333333,0.9166666666666666
6061,22,2,0,26,26,0.0,1.0
5965,22,2,0,45,45,0.0,1.0
6040,22,2,6,6,12,0.5,0.5
6106,22,2,2,28,30,0.06666666666666667,0.9333333333333333
6082,22,2,2,11,13,0.15384615384615385,0.8461538461538461
6031,22,2,0,25,25,0.0,1.0
6039,22,2,3,55,58,0.05172413793103448,0.9482758620689655
6189,23,2,0,22,22,0.0,1.0
5936,23,2,0,31,31,0.0,1.0
6087,23,2,0,18,18,0.0,1.0
5973,23,2,0,34,34,0.0,1.0
6085,23,2,0,34,34,0.0,1.0
5948,23,2,0,42,42,0.0,1.0
5974,23,2,0,10,10,0.0,1.0
6090,23,2,0,1,1,0.0,1.0
6068,23,2,0,35,35,0.0,1.0
6024,23,2,1,1,2,0.5,0.5
5976,23,2,2,78,80,0.025,0.975
5962,23,2,0,59,59,0.0,1.0
6033,23,2,2,22,24,0.08333333333333333,0.9166666666666666
6038,23,2,0,7,7,0.0,1.0
6042,23,2,0,49,49,0.0,1.0
5924,23,2,0,50,50,0.0,1.0
6083,23,2,3,9,12,0.25,0.75
6178,23,2,0,225,225,0.0,1.0
6086,23,2,0,25,25,0.0,1.0
5945,23,2,0,95,95,0.0,1.0
5925,23,2,0,122,122,0.0,1.0
5935,23,2,0,3,3,0.0,1.0
6073,23,2,2,5,7,0.2857142857142857,0.7142857142857143
5980,23,2,2,10,12,0.16666666666666666,0.8333333333333334
5993,23,2,0,24,24,0.0,1.0
5979,23,2,0,33,33,0.0,1.0
5966,23,2,0,26,26,0.0,1.0
5967,23,2,0,101,101,0.0,1.0
5970,23,2,0,14,14,0.0,1.0
6188,23,2,2,1,3,0.6666666666666666,0.3333333333333333
6096,23,2,1,0,1,1.0,0.0
6069,23,2,0,17,17,0.0,1.0
5937,23,2,0,6,6,0.0,1.0
5990,23,2,0,50,50,0.0,1.0
5928,23,2,0,22,22,0.0,1.0
6058,23,2,3,66,69,0.043478260869565216,0.9565217391304348
6001,23,2,4,20,24,0.16666666666666666,0.8333333333333334
5964,23,2,0,10,10,0.0,1.0
5950,23,2,0,7,7,0.0,1.0
5991,23,2,0,20,20,0.0,1.0
6177,23,2,0,3,3,0.0,1.0
5961,23,2,0,45,45,0.0,1.0
5938,23,2,0,340,340,0.0,1.0
5960,23,2,0,36,36,0.0,1.0
5947,23,2,0,78,78,0.0,1.0
5957,23,2,1,6,7,0.14285714285714285,0.8571428571428571
6043,23,2,0,29,29,0.0,1.0
6014,23,2,4,6,10,0.4,0.6
6015,23,2,1,1,2,0.5,0.5
5978,23,2,1,15,16,0.0625,0.9375
5986,23,2,3,1,4,0.75,0.25
5969,23,2,0,4,4,0.0,1.0
5949,23,2,0,30,30,0.0,1.0
5959,23,2,1,39,40,0.025,0.975
6051,23,2,0,108,108,0.0,1.0
6029,23,2,0,20,20,0.0,1.0
6070,23,2,4,0,4,1.0,0.0
5942,23,2,0,108,108,0.0,1.0
5953,23,2,0,28,28,0.0,1.0
6076,23,2,0,14,14,0.0,1.0
5940,23,2,2,7,9,0.2222222222222222,0.7777777777777778
6109,23,2,0,95,95,0.0,1.0
6187,23,2,0,6,6,0.0,1.0
6053,23,2,0,15,15,0.0,1.0
6104,23,2,3,1,4,0.75,0.25
5943,23,2,9,0,9,1.0,0.0
6168,23,2,0,240,240,0.0,1.0
5989,23,2,0,6,6,0.0,1.0
5963,23,2,1,19,20,0.05,0.95
6194,23,2,0,80,80,0.0,1.0
6003,23,2,0,238,238,0.0,1.0
6167,23,2,0,10,10,0.0,1.0
6004,23,2,1,134,135,0.007407407407407408,0.9925925925925926
6054,23,2,0,14,14,0.0,1.0
6170,23,2,0,34,34,0.0,1.0
6063,23,2,4,6,10,0.4,0.6
5988,23,2,0,17,17,0.0,1.0
6075,23,2,0,12,12,0.0,1.0
6061,23,2,0,26,26,0.0,1.0
5965,23,2,0,45,45,0.0,1.0
6040,23,2,4,8,12,0.3333333333333333,0.6666666666666666
6106,23,2,2,28,30,0.06666666666666667,0.9333333333333333
6082,23,2,0,13,13,0.0,1.0
6031,23,2,2,23,25,0.08,0.92
6039,23,2,1,57,58,0.017241379310344827,0.9827586206896551
6189,24,2,0,22,22,0.0,1.0
5936,24,2,0,31,31,0.0,1.0
6087,24,2,0,18,18,0.0,1.0
5973,24,2,0,34,34,0.0,1.0
6085,24,2,0,34,34,0.0,1.0
5948,24,2,0,42,42,0.0,1.0
5974,24,2,0,10,10,0.0,1.0
6090,24,2,0,1,1,0.0,1.0
6068,24,2,0,35,35,0.0,1.0
6024,24,2,1,1,2,0.5,0.5
5976,24,2,1,79,80,0.0125,0.9875
5962,24,2,0,59,59,0.0,1.0
6033,24,2,2,22,24,0.08333333333333333,0.9166666666666666
6038,24,2,0,7,7,0.0,1.0
6042,24,2,0,49,49,0.0,1.0
5924,24,2,0,50,50,0.0,1.0
6083,24,2,3,9,12,0.25,0.75
6178,24,2,0,225,225,0.0,1.0
6086,24,2,0,25,25,0.0,1.0
5945,24,2,0,95,95,0.0,1.0
5925,24,2,0,122,122,0.0,1.0
5935,24,2,0,3,3,0.0,1.0
6073,24,2,1,6,7,0.14285714285714285,0.8571428571428571
5980,24,2,0,12,12,0.0,1.0
5993,24,2,0,24,24,0.0,1.0
5979,24,2,0,33,33,0.0,1.0
5966,24,2,0,26,26,0.0,1.0
5967,24,2,0,101,101,0.0,1.0
5970,24,2,0,14,14,0.0,1.0
6188,24,2,0,3,3,0.0,1.0
6096,24,2,1,0,1,1.0,0.0
6069,24,2,0,17,17,0.0,1.0
5937,24,2,0,6,6,0.0,1.0
5990,24,2,0,50,50,0.0,1.0
5928,24,2,0,22,22,0.0,1.0
6058,24,2,3,66,69,0.043478260869565216,0.9565217391304348
6001,24,2,2,22,24,0.08333333333333333,0.9166666666666666
5964,24,2,1,9,10,0.1,0.9
5950,24,2,0,7,7,0.0,1.0
5991,24,2,0,20,20,0.0,1.0
6177,24,2,0,3,3,0.0,1.0
5961,24,2,0,45,45,0.0,1.0
5938,24,2,0,340,340,0.0,1.0
5960,24,2,0,36,36,0.0,1.0
5947,24,2,0,78,78,0.0,1.0
5957,24,2,1,6,7,0.14285714285714285,0.8571428571428571
6043,24,2,0,29,29,0.0,1.0
6014,24,2,6,4,10,0.6,0.4
6015,24,2,1,1,2,0.5,0.5
5978,24,2,1,15,16,0.0625,0.9375
5986,24,2,3,1,4,0.75,0.25
5969,24,2,0,4,4,0.0,1.0
5949,24,2,0,30,30,0.0,1.0
5959,24,2,0,40,40,0.0,1.0
6051,24,2,0,108,108,0.0,1.0
6029,24,2,1,19,20,0.05,0.95
6070,24,2,2,2,4,0.5,0.5
5942,24,2,0,108,108,0.0,1.0
5953,24,2,0,28,28,0.0,1.0
6076,24,2,1,13,14,0.07142857142857142,0.9285714285714286
5940,24,2,2,7,9,0.2222222222222222,0.7777777777777778
6109,24,2,1,94,95,0.010526315789473684,0.9894736842105263
6187,24,2,2,4,6,0.3333333333333333,0.6666666666666666
6053,24,2,0,15,15,0.0,1.0
6104,24,2,2,2,4,0.5,0.5
5943,24,2,5,4,9,0.5555555555555556,0.4444444444444444
6168,24,2,0,240,240,0.0,1.0
5989,24,2,0,6,6,0.0,1.0
5963,24,2,0,20,20,0.0,1.0
6194,24,2,0,80,80,0.0,1.0
6003,24,2,1,237,238,0.004201680672268907,0.9957983193277311
6167,24,2,0,10,10,0.0,1.0
6004,24,2,0,135,135,0.0,1.0
6054,24,2,0,14,14,0.0,1.0
6170,24,2,0,34,34,0.0,1.0
6063,24,2,1,9,10,0.1,0.9
5988,24,2,0,17,17,0.0,1.0
6075,24,2,0,12,12,0.0,1.0
6061,24,2,0,26,26,0.0,1.0
5965,24,2,0,45,45,0.0,1.0
6040,24,2,4,8,12,0.3333333333333333,0.6666666666666666
6106,24,2,1,29,30,0.03333333333333333,0.9666666666666667
6082,24,2,0,13,13,0.0,1.0
6031,24,2,2,23,25,0.08,0.92
6039,24,2,1,57,58,0.017241379310344827,0.9827586206896551
6189,25,2,0,22,22,0.0,1.0
5936,25,2,0,31,31,0.0,1.0
6087,25,2,0,18,18,0.0,1.0
5973,25,2,0,34,34,0.0,1.0
6085,25,2,0,34,34,0.0,1.0
5948,25,2,0,42,42,0.0,1.0
5974,25,2,0,10,10,0.0,1.0
6090,25,2,0,1,1,0.0,1.0
6068,25,2,0,35,35,0.0,1.0
6024,25,2,1,1,2,0.5,0.5
5976,25,2,1,79,80,0.0125,0.9875
5962,25,2,0,59,59,0.0,1.0
6033,25,2,2,22,24,0.08333333333333333,0.9166666666666666
6038,25,2,0,7,7,0.0,1.0
6042,25,2,0,49,49,0.0,1.0
5924,25,2,0,50,50,0.0,1.0
6083,25,2,3,9,12,0.25,0.75
6178,25,2,0,225,225,0.0,1.0
6086,25,2,0,25,25,0.0,1.0
5945,25,2,0,95,95,0.0,1.0
5925,25,2,0,122,122,0.0,1.0
5935,25,2,0,3,3,0.0,1.0
6073,25,2,2,5,7,0.2857142857142857,0.7142857142857143
5980,25,2,0,12,12,0.0,1.0
5993,25,2,0,24,24,0.0,1.0
5979,25,2,0,33,33,0.0,1.0
5966,25,2,0,26,26,0.0,1.0
5967,25,2,2,99,101,0.019801980198019802,0.9801980198019802
5970,25,2,0,14,14,0.0,1.0
6188,25,2,0,3,3,0.0,1.0
6096,25,2,1,0,1,1.0,0.0
6069,25,2,0,17,17,0.0,1.0
5937,25,2,0,6,6,0.0,1.0
5990,25,2,0,50,50,0.0,1.0
5928,25,2,0,22,22,0.0,1.0
6058,25,2,3,66,69,0.043478260869565216,0.9565217391304348
6001,25,2,2,22,24,0.08333333333333333,0.9166666666666666
5964,25,2,1,9,10,0.1,0.9
5950,25,2,2,5,7,0.2857142857142857,0.7142857142857143
5991,25,2,0,20,20,0.0,1.0
6177,25,2,0,3,3,0.0,1.0
5961,25,2,0,45,45,0.0,1.0
5938,25,2,0,340,340,0.0,1.0
5960,25,2,0,36,36,0.0,1.0
5947,25,2,0,78,78,0.0,1.0
5957,25,2,2,5,7,0.2857142857142857,0.7142857142857143
6043,25,2,0,29,29,0.0,1.0
6014,25,2,4,6,10,0.4,0.6
6015,25,2,2,0,2,1.0,0.0
5978,25,2,3,13,16,0.1875,0.8125
5986,25,2,1,3,4,0.25,0.75
5969,25,2,1,3,4,0.25,0.75
5949,25,2,0,30,30,0.0,1.0
5959,25,2,0,40,40,0.0,1.0
6051,25,2,0,108,108,0.0,1.0
6029,25,2,1,19,20,0.05,0.95
6070,25,2,0,4,4,0.0,1.0
5942,25,2,0,108,108,0.0,1.0
5953,25,2,0,28,28,0.0,1.0
6076,25,2,0,14,14,0.0,1.0
5940,25,2,4,5,9,0.4444444444444444,0.5555555555555556
6109,25,2,0,95,95,0.0,1.0
6187,25,2,0,6,6,0.0,1.0
6053,25,2,0,15,15,0.0,1.0
6104,25,2,3,1,4,0.75,0.25
5943,25,2,0,9,9,0.0,1.0
6168,25,2,0,240,240,0.0,1.0
5989,25,2,0,6,6,0.0,1.0
5963,25,2,0,20,20,0.0,1.0
6194,25,2,0,80,80,0.0,1.0
6003,25,2,1,237,238,0.004201680672268907,0.9957983193277311
6167,25,2,1,9,10,0.1,0.9
6004,25,2,2,133,135,0.014814814814814815,0.9851851851851852
6054,25,2,0,14,14,0.0,1.0
6170,25,2,1,33,34,0.029411764705882353,0.9705882352941176
6063,25,2,3,7,10,0.3,0.7
5988,25,2,0,17,17,0.0,1.0
6075,25,2,0,12,12,0.0,1.0
6061,25,2,0,26,26,0.0,1.0
5965,25,2,0,45,45,0.0,1.0
6040,25,2,7,5,12,0.5833333333333334,0.4166666666666667
6106,25,2,2,28,30,0.06666666666666667,0.9333333333333333
6082,25,2,0,13,13,0.0,1.0
6031,25,2,2,23,25,0.08,0.92
6039,25,2,1,57,58,0.017241379310344827,0.9827586206896551
6189,26,2,0,22,22,0.0,1.0
5936,26,2,0,31,31,0.0,1.0
6087,26,2,0,18,18,0.0,1.0
5973,26,2,0,34,34,0.0,1.0
6085,26,2,0,34,34,0.0,1.0
5948,26,2,0,42,42,0.0,1.0
5974,26,2,0,10,10,0.0,1.0
6090,26,2,0,1,1,0.0,1.0
6068,26,2,0,35,35,0.0,1.0
6024,26,2,1,1,2,0.5,0.5
5976,26,2,0,80,80,0.0,1.0
5962,26,2,0,59,59,0.0,1.0
6033,26,2,0,24,24,0.0,1.0
6038,26,2,0,7,7,0.0,1.0
6042,26,2,0,49,49,0.0,1.0
5924,26,2,0,50,50,0.0,1.0
6083,26,2,1,11,12,0.08333333333333333,0.9166666666666666
6178,26,2,0,225,225,0.0,1.0
6086,26,2,0,25,25,0.0,1.0
5945,26,2,0,95,95,0.0,1.0
5925,26,2,0,122,122,0.0,1.0
5935,26,2,0,3,3,0.0,1.0
6073,26,2,0,7,7,0.0,1.0
5980,26,2,2,10,12,0.16666666666666666,0.8333333333333334
5993,26,2,0,24,24,0.0,1.0
5979,26,2,0,33,33,0.0,1.0
5966,26,2,0,26,26,0.0,1.0
5967,26,2,1,100,101,0.009900990099009901,0.9900990099009901
5970,26,2,0,14,14,0.0,1.0
6188,26,2,0,3,3,0.0,1.0
6096,26,2,1,0,1,1.0,0.0
6069,26,2,0,17,17,0.0,1.0
5937,26,2,0,6,6,0.0,1.0
5990,26,2,0,50,50,0.0,1.0
5928,26,2,0,22,22,0.0,1.0
6058,26,2,2,67,69,0.028985507246376812,0.9710144927536232
6001,26,2,4,20,24,0.16666666666666666,0.8333333333333334
5964,26,2,0,10,10,0.0,1.0
5950,26,2,0,7,7,0.0,1.0
5991,26,2,0,20,20,0.0,1.0
6177,26,2,0,3,3,0.0,1.0
5961,26,2,0,45,45,0.0,1.0
5938,26,2,0,340,340,0.0,1.0
5960,26,2,0,36,36,0.0,1.0
5947,26,2,0,78,78,0.0,1.0
5957,26,2,4,3,7,0.5714285714285714,0.42857142857142855
6043,26,2,0,29,29,0.0,1.0
6014,26,2,5,5,10,0.5,0.5
6015,26,2,2,0,2,1.0,0.0
5978,26,2,0,16,16,0.0,1.0
5986,26,2,2,2,4,0.5,0.5
5969,26,2,0,4,4,0.0,1.0
5949,26,2,0,30,30,0.0,1.0
5959,26,2,0,40,40,0.0,1.0
6051,26,2,0,108,108,0.0,1.0
6029,26,2,0,20,20,0.0,1.0
6070,26,2,2,2,4,0.5,0.5
5942,26,2,0,108,108,0.0,1.0
5953,26,2,0,28,28,0.0,1.0
6076,26,2,0,14,14,0.0,1.0
5940,26,2,2,7,9,0.2222222222222222,0.7777777777777778
6109,26,2,0,95,95,0.0,1.0
6187,26,2,0,6,6,0.0,1.0
6053,26,2,0,15,15,0.0,1.0
6104,26,2,3,1,4,0.75,0.25
5943,26,2,0,9,9,0.0,1.0
6168,26,2,0,240,240,0.0,1.0
5989,26,2,0,6,6,0.0,1.0
5963,26,2,1,19,20,0.05,0.95
6194,26,2,0,80,80,0.0,1.0
6003,26,2,0,238,238,0.0,1.0
6167,26,2,0,10,10,0.0,1.0
6004,26,2,0,135,135,0.0,1.0
6054,26,2,0,14,14,0.0,1.0
6170,26,2,0,34,34,0.0,1.0
6063,26,2,2,8,10,0.2,0.8
5988,26,2,0,17,17,0.0,1.0
6075,26,2,0,12,12,0.0,1.0
6061,26,2,0,26,26,0.0,1.0
5965,26,2,0,45,45,0.0,1.0
6040,26,2,3,9,12,0.25,0.75
6106,26,2,0,30,30,0.0,1.0
6082,26,2,0,13,13,0.0,1.0
6031,26,2,0,25,25,0.0,1.0
6039,26,2,0,58,58,0.0,1.0
6189,27,2,0,22,22,0.0,1.0
5936,27,2,0,31,31,0.0,1.0
6087,27,2,0,18,18,0.0,1.0
5973,27,2,0,34,34,0.0,1.0
6085,27,2,0,34,34,0.0,1.0
5948,27,2,1,41,42,0.023809523809523808,0.9761904761904762
5974,27,2,0,10,10,0.0,1.0
6090,27,2,0,1,1,0.0,1.0
6068,27,2,0,35,35,0.0,1.0
6024,27,2,1,1,2,0.5,0.5
5976,27,2,1,79,80,0.0125,0.9875
5962,27,2,0,59,59,0.0,1.0
6033,27,2,0,24,24,0.0,1.0
6038,27,2,0,7,7,0.0,1.0
6042,27,2,0,49,49,0.0,1.0
5924,27,2,0,50,50,0.0,1.0
6083,27,2,4,8,12,0.3333333333333333,0.6666666666666666
6178,27,2,0,225,225,0.0,1.0
6086,27,2,0,25,25,0.0,1.0
5945,27,2,0,95,95,0.0,1.0
5925,27,2,0,122,122,0.0,1.0
5935,27,2,0,3,3,0.0,1.0
6073,27,2,0,7,7,0.0,1.0
5980,27,2,0,12,12,0.0,1.0
5993,27,2,0,24,24,0.0,1.0
5979,27,2,0,33,33,0.0,1.0
5966,27,2,0,26,26,0.0,1.0
5967,27,2,1,100,101,0.009900990099009901,0.9900990099009901
5970,27,2,0,14,14,0.0,1.0
6188,27,2,0,3,3,0.0,1.0
6096,27,2,1,0,1,1.0,0.0
6069,27,2,0,17,17,0.0,1.0
5937,27,2,0,6,6,0.0,1.0
5990,27,2,0,50,50,0.0,1.0
5928,27,2,0,22,22,0.0,1.0
6058,27,2,5,64,69,0.07246376811594203,0.927536231884058
6001,27,2,1,23,24,0.041666666666666664,0.9583333333333334
5964,27,2,0,10,10,0.0,1.0
5950,27,2,1,6,7,0.14285714285714285,0.8571428571428571
5991,27,2,0,20,20,0.0,1.0
6177,27,2,0,3,3,0.0,1.0
5961,27,2,0,45,45,0.0,1.0
5938,27,2,0,340,340,0.0,1.0
5960,27,2,0,36,36,0.0,1.0
5947,27,2,0,78,78,0.0,1.0
5957,27,2,3,4,7,0.42857142857142855,0.5714285714285714
6043,27,2,0,29,29,0.0,1.0
6014,27,2,8,2,10,0.8,0.2
6015,27,2,1,1,2,0.5,0.5
5978,27,2,0,16,16,0.0,1.0
5986,27,2,2,2,4,0.5,0.5
5969,27,2,0,4,4,0.0,1.0
5949,27,2,0,30,30,0.0,1.0
5959,27,2,0,40,40,0.0,1.0
6051,27,2,0,108,108,0.0,1.0
6029,27,2,1,19,20,0.05,0.95
6070,27,2,2,2,4,0.5,0.5
5942,27,2,0,108,108,0.0,1.0
5953,27,2,0,28,28,0.0,1.0
6076,27,2,0,14,14,0.0,1.0
5940,27,2,3,6,9,0.3333333333333333,0.6666666666666666
6109,27,2,0,95,95,0.0,1.0
6187,27,2,0,6,6,0.0,1.0
6053,27,2,0,15,15,0.0,1.0
6104,27,2,2,2,4,0.5,0.5
5943,27,2,0,9,9,0.0,1.0
6168,27,2,0,240,240,0.0,1.0
5989,27,2,0,6,6,0.0,1.0
5963,27,2,0,20,20,0.0,1.0
6194,27,2,0,80,80,0.0,1.0
6003,27,2,1,237,238,0.004201680672268907,0.9957983193277311
6167,27,2,1,9,10,0.1,0.9
6004,27,2,0,135,135,0.0,1.0
6054,27,2,0,14,14,0.0,1.0
6170,27,2,1,33,34,0.029411764705882353,0.9705882352941176
6063,27,2,1,9,10,0.1,0.9
5988,27,2,0,17,17,0.0,1.0
6075,27,2,1,11,12,0.08333333333333333,0.9166666666666666
6061,27,2,0,26,26,0.0,1.0
5965,27,2,0,45,45,0.0,1.0
6040,27,2,6,6,12,0.5,0.5
6106,27,2,4,26,30,0.13333333333333333,0.8666666666666667
6082,27,2,0,13,13,0.0,1.0
6031,27,2,2,23,25,0.08,0.92
6039,27,2,1,57,58,0.017241379310344827,0.9827586206896551
6189,28,2,0,22,22,0.0,1.0
5936,28,2,0,31,31,0.0,1.0
6087,28,2,0,18,18,0.0,1.0
5973,28,2,0,34,34,0.0,1.0
6085,28,2,0,34,34,0.0,1.0
5948,28,2,0,42,42,0.0,1.0
5974,28,2,0,10,10,0.0,1.0
6090,28,2,0,1,1,0.0,1.0
6068,28,2,0,35,35,0.0,1.0
6024,28,2,2,0,2,1.0,0.0
5976,28,2,1,79,80,0.0125,0.9875
5962,28,2,0,59,59,0.0,1.0
6033,28,2,0,24,24,0.0,1.0
6038,28,2,0,7,7,0.0,1.0
6042,28,2,0,49,49,0.0,1.0
5924,28,2,0,50,50,0.0,1.0
6083,28,2,6,6,12,0.5,0.5
6178,28,2,0,225,225,0.0,1.0
6086,28,2,0,25,25,0.0,1.0
5945,28,2,0,95,95,0.0,1.0
5925,28,2,0,122,122,0.0,1.0
5935,28,2,0,3,3,0.0,1.0
6073,28,2,1,6,7,0.14285714285714285,0.8571428571428571
5980,28,2,2,10,12,0.16666666666666666,0.8333333333333334
5993,28,2,0,24,24,0.0,1.0
5979,28,2,0,33,33,0.0,1.0
5966,28,2,0,26,26,0.0,1.0
5967,28,2,0,101,101,0.0,1.0
5970,28,2,0,14,14,0.0,1.0
6188,28,2,0,3,3,0.0,1.0
6096,28,2,1,0,1,1.0,0.0
6069,28,2,0,17,17,0.0,1.0
5937,28,2,0,6,6,0.0,1.0
5990,28,2,0,50,50,0.0,1.0
5928,28,2,0,22,22,0.0,1.0
6058,28,2,1,68,69,0.014492753623188406,0.9855072463768116
6001,28,2,0,24,24,0.0,1.0
5964,28,2,1,9,10,0.1,0.9
5950,28,2,1,6,7,0.14285714285714285,0.8571428571428571
5991,28,2,0,20,20,0.0,1.0
6177,28,2,0,3,3,0.0,1.0
5961,28,2,0,45,45,0.0,1.0
5938,28,2,0,340,340,0.0,1.0
5960,28,2,0,36,36,0.0,1.0
5947,28,2,0,78,78,0.0,1.0
5957,28,2,2,5,7,0.2857142857142857,0.7142857142857143
6043,28,2,0,29,29,0.0,1.0
6014,28,2,3,7,10,0.3,0.7
6015,28,2,1,1,2,0.5,0.5
5978,28,2,1,15,16,0.0625,0.9375
5986,28,2,2,2,4,0.5,0.5
5969,28,2,0,4,4,0.0,1.0
5949,28,2,0,30,30,0.0,1.0
5959,28,2,2,38,40,0.05,0.95
6051,28,2,0,108,108,0.0,1.0
6029,28,2,1,19,20,0.05,0.95
6070,28,2,3,1,4,0.75,0.25
5942,28,2,0,108,108,0.0,1.0
5953,28,2,0,28,28,0.0,1.0
6076,28,2,1,13,14,0.07142857142857142,0.9285714285714286
5940,28,2,5,4,9,0.5555555555555556,0.4444444444444444
6109,28,2,0,95,95,0.0,1.0
6187,28,2,0,6,6,0.0,1.0
6053,28,2,0,15,15,0.0,1.0
6104,28,2,4,0,4,1.0,0.0
5943,28,2,0,9,9,0.0,1.0
6168,28,2,0,240,240,0.0,1.0
5989,28,2,0,6,6,0.0,1.0
5963,28,2,0,20,20,0.0,1.0
6194,28,2,0,80,80,0.0,1.0
6003,28,2,1,237,238,0.004201680672268907,0.9957983193277311
6167,28,2,0,10,10,0.0,1.0
6004,28,2,4,131,135,0.02962962962962963,0.9703703703703703
6054,28,2,0,14,14,0.0,1.0
6170,28,2,1,33,34,0.029411764705882353,0.9705882352941176
6063,28,2,1,9,10,0.1,0.9
5988,28,2,0,17,17,0.0,1.0
6075,28,2,2,10,12,0.16666666666666666,0.8333333333333334
6061,28,2,0,26,26,0.0,1.0
5965,28,2,0,45,45,0.0,1.0
6040,28,2,4,8,12,0.3333333333333333,0.6666666666666666
6106,28,2,1,29,30,0.03333333333333333,0.9666666666666667
6082,28,2,0,13,13,0.0,1.0
6031,28,2,1,24,25,0.04,0.96
6039,28,2,1,57,58,0.017241379310344827,0.9827586206896551
6189,29,2,1,21,22,0.045454545454545456,0.9545454545454546
5936,29,2,0,31,31,0.0,1.0
6087,29,2,0,18,18,0.0,1.0
5973,29,2,0,34,34,0.0,1.0
6085,29,2,0,34,34,0.0,1.0
5948,29,2,1,41,42,0.023809523809523808,0.9761904761904762
5974,29,2,0,10,10,0.0,1.0
6090,29,2,0,1,1,0.0,1.0
6068,29,2,0,35,35,0.0,1.0
6024,29,2,1,1,2,0.5,0.5
5976,29,2,1,79,80,0.0125,0.9875
5962,29,2,0,59,59,0.0,1.0
6033,29,2,4,20,24,0.16666666666666666,0.8333333333333334
6038,29,2,0,7,7,0.0,1.0
6042,29,2,0,49,49,0.0,1.0
5924,29,2,0,50,50,0.0,1.0
6083,29,2,4,8,12,0.3333333333333333,0.6666666666666666
6178,29,2,0,225,225,0.0,1.0
6086,29,2,0,25,25,0.0,1.0
5945,29,2,0,95,95,0.0,1.0
5925,29,2,0,122,122,0.0,1.0
5935,29,2,0,3,3,0.0,1.0
6073,29,2,1,6,7,0.14285714285714285,0.8571428571428571
5980,29,2,0,12,12,0.0,1.0
5993,29,2,0,24,24,0.0,1.0
5979,29,2,0,33,33,0.0,1.0
5966,29,2,0,26,26,0.0,1.0
5967,29,2,1,100,101,0.009900990099009901,0.9900990099009901
5970,29,2,0,14,14,0.0,1.0
6188,29,2,0,3,3,0.0,1.0
6096,29,2,1,0,1,1.0,0.0
6069,29,2,0,17,17,0.0,1.0
5937,29,2,0,6,6,0.0,1.0
5990,29,2,0,50,50,0.0,1.0
5928,29,2,0,22,22,0.0,1.0
6058,29,2,1,68,69,0.014492753623188406,0.9855072463768116
6001,29,2,2,22,24,0.08333333333333333,0.9166666666666666
5964,29,2,1,9,10,0.1,0.9
5950,29,2,0,7,7,0.0,1.0
5991,29,2,0,20,20,0.0,1.0
6177,29,2,0,3,3,0.0,1.0
5961,29,2,0,45,45,0.0,1.0
5938,29,2,0,340,340,0.0,1.0
5960,29,2,0,36,36,0.0,1.0
5947,29,2,0,78,78,0.0,1.0
5957,29,2,0,7,7,0.0,1.0
6043,29,2,0,29,29,0.0,1.0
6014,29,2,6,4,10,0.6,0.4
6015,29,2,0,2,2,0.0,1.0
5978,29,2,1,15,16,0.0625,0.9375
5986,29,2,1,3,4,0.25,0.75
5969,29,2,0,4,4,0.0,1.0
5949,29,2,0,30,30,0.0,1.0
5959,29,2,1,39,40,0.025,0.975
6051,29,2,0,108,108,0.0,1.0
6029,29,2,1,19,20,0.05,0.95
6070,29,2,2,2,4,0.5,0.5
5942,29,2,0,108,108,0.0,1.0
5953,29,2,0,28,28,0.0,1.0
6076,29,2,0,14,14,0.0,1.0
5940,29,2,2,7,9,0.2222222222222222,0.7777777777777778
6109,29,2,0,95,95,0.0,1.0
6187,29,2,2,4,6,0.3333333333333333,0.6666666666666666
6053,29,2,0,15,15,0.0,1.0
6104,29,2,3,1,4,0.75,0.25
5943,29,2,0,9,9,0.0,1.0
6168,29,2,0,240,240,0.0,1.0
5989,29,2,0,6,6,0.0,1.0
5963,29,2,0,20,20,0.0,1.0
6194,29,2,0,80,80,0.0,1.0
6003,29,2,1,237,238,0.004201680672268907,0.9957983193277311
6167,29,2,0,10,10,0.0,1.0
6004,29,2,1,134,135,0.007407407407407408,0.9925925925925926
6054,29,2,0,14,14,0.0,1.0
6170,29,2,0,34,34,0.0,1.0
6063,29,2,1,9,10,0.1,0.9
5988,29,2,0,17,17,0.0,1.0
6075,29,2,1,11,12,0.08333333333333333,0.9166666666666666
6061,29,2,0,26,26,0.0,1.0
5965,29,2,0,45,45,0.0,1.0
6040,29,2,4,8,12,0.3333333333333333,0.6666666666666666
6106,29,2,2,28,30,0.06666666666666667,0.9333333333333333
6082,29,2,0,13,13,0.0,1.0
6031,29,2,1,24,25,0.04,0.96
6039,29,2,4,54,58,0.06896551724137931,0.9310344827586207
6189,0,3,11,11,22,0.5,0.5
5936,0,3,0,31,31,0.0,1.0
6087,0,3,0,18,18,0.0,1.0
5973,0,3,0,34,34,0.0,1.0
6085,0,3,0,34,34,0.0,1.0
5948,0,3,1,41,42,0.023809523809523808,0.9761904761904762
5974,0,3,0,10,10,0.0,1.0
6090,0,3,0,1,1,0.0,1.0
6068,0,3,0,35,35,0.0,1.0
6024,0,3,1,1,2,0.5,0.5
5976,0,3,75,5,80,0.9375,0.0625
5962,0,3,0,59,59,0.0,1.0
6033,0,3,9,15,24,0.375,0.625
6038,0,3,0,7,7,0.0,1.0
6042,0,3,0,49,49,0.0,1.0
5924,0,3,0,50,50,0.0,1.0
6083,0,3,1,11,12,0.08333333333333333,0.9166666666666666
6178,0,3,195,30,225,0.8666666666666667,0.13333333333333333
6086,0,3,0,25,25,0.0,1.0
5945,0,3,0,95,95,0.0,1.0
5925,0,3,0,122,122,0.0,1.0
5935,0,3,0,3,3,0.0,1.0
6073,0,3,4,3,7,0.5714285714285714,0.42857142857142855
5980,0,3,0,12,12,0.0,1.0
5993,0,3,3,21,24,0.125,0.875
5979,0,3,0,33,33,0.0,1.0
5966,0,3,24,2,26,0.9230769230769231,0.07692307692307693
5967,0,3,91,10,101,0.900990099009901,0.09900990099009901
5970,0,3,0,14,14,0.0,1.0
6188,0,3,3,0,3,1.0,0.0
6096,0,3,1,0,1,1.0,0.0
6069,0,3,0,17,17,0.0,1.0
5937,0,3,0,6,6,0.0,1.0
5990,0,3,0,50,50,0.0,1.0
5928,0,3,0,22,22,0.0,1.0
6058,0,3,64,5,69,0.927536231884058,0.07246376811594203
6001,0,3,3,21,24,0.125,0.875
5964,0,3,1,9,10,0.1,0.9
5950,0,3,0,7,7,0.0,1.0
5991,0,3,0,20,20,0.0,1.0
6177,0,3,0,3,3,0.0,1.0
5961,0,3,0,45,45,0.0,1.0
5938,0,3,227,113,340,0.6676470588235294,0.3323529411764706
5960,0,3,0,36,36,0.0,1.0
5947,0,3,0,78,78,0.0,1.0
5957,0,3,7,0,7,1.0,0.0
6043,0,3,0,29,29,0.0,1.0
6014,0,3,10,0,10,1.0,0.0
6015,0,3,2,0,2,1.0,0.0
5978,0,3,16,0,16,1.0,0.0
5986,0,3,4,0,4,1.0,0.0
5969,0,3,4,0,4,1.0,0.0
5949,0,3,0,30,30,0.0,1.0
5959,0,3,39,1,40,0.975,0.025
6051,0,3,0,108,108,0.0,1.0
6029,0,3,1,19,20,0.05,0.95
6070,0,3,4,0,4,1.0,0.0
5942,0,3,0,108,108,0.0,1.0
5953,0,3,0,28,28,0.0,1.0
6076,0,3,10,4,14,0.7142857142857143,0.2857142857142857
5940,0,3,9,0,9,1.0,0.0
6109,0,3,89,6,95,0.9368421052631579,0.06315789473684211
6187,0,3,0,6,6,0.0,1.0
6053,0,3,0,15,15,0.0,1.0
6104,0,3,4,0,4,1.0,0.0
5943,0,3,0,9,9,0.0,1.0
6168,0,3,0,240,240,0.0,1.0
5989,0,3,0,6,6,0.0,1.0
5963,0,3,20,0,20,1.0,0.0
6194,0,3,0,80,80,0.0,1.0
6003,0,3,92,146,238,0.3865546218487395,0.6134453781512605
6167,0,3,8,2,10,0.8,0.2
6004,0,3,76,59,135,0.562962962962963,0.43703703703703706
6054,0,3,0,14,14,0.0,1.0
6170,0,3,7,27,34,0.20588235294117646,0.7941176470588235
6063,0,3,8,2,10,0.8,0.2
5988,0,3,0,17,17,0.0,1.0
6075,0,3,1,11,12,0.08333333333333333,0.9166666666666666
6061,0,3,0,26,26,0.0,1.0
5965,0,3,0,45,45,0.0,1.0
6040,0,3,12,0,12,1.0,0.0
6106,0,3,2,28,30,0.06666666666666667,0.9333333333333333
6082,0,3,2,11,13,0.15384615384615385,0.8461538461538461
6031,0,3,1,24,25,0.04,0.96
6039,0,3,0,58,58,0.0,1.0
6189,1,3,6,16,22,0.2727272727272727,0.7272727272727273
5936,1,3,0,31,31,0.0,1.0
6087,1,3,0,18,18,0.0,1.0
5973,1,3,0,34,34,0.0,1.0
6085,1,3,0,34,34,0.0,1.0
5948,1,3,1,41,42,0.023809523809523808,0.9761904761904762
5974,1,3,0,10,10,0.0,1.0
6090,1,3,0,1,1,0.0,1.0
6068,1,3,0,35,35,0.0,1.0
6024,1,3,1,1,2,0.5,0.5
5976,1,3,72,8,80,0.9,0.1
5962,1,3,0,59,59,0.0,1.0
6033,1,3,2,22,24,0.08333333333333333,0.9166666666666666
6038,1,3,0,7,7,0.0,1.0
6042,1,3,0,49,49,0.0,1.0
5924,1,3,0,50,50,0.0,1.0
6083,1,3,4,8,12,0.3333333333333333,0.6666666666666666
6178,1,3,145,80,225,0.6444444444444445,0.35555555555555557
6086,1,3,0,25,25,0.0,1.0
5945,1,3,0,95,95,0.0,1.0
5925,1,3,0,122,122,0.0,1.0
5935,1,3,0,3,3,0.0,1.0
6073,1,3,5,2,7,0.7142857142857143,0.2857142857142857
5980,1,3,0,12,12,0.0,1.0
5993,1,3,0,24,24,0.0,1.0
5979,1,3,0,33,33,0.0,1.0
5966,1,3,24,2,26,0.9230769230769231,0.07692307692307693
5967,1,3,83,18,101,0.8217821782178217,0.1782178217821782
5970,1,3,0,14,14,0.0,1.0
6188,1,3,3,0,3,1.0,0.0
6096,1,3,1,0,1,1.0,0.0
6069,1,3,0,17,17,0.0,1.0
5937,1,3,0,6,6,0.0,1.0
5990,1,3,0,50,50,0.0,1.0
5928,1,3,0,22,22,0.0,1.0
6058,1,3,63,6,69,0.9130434782608695,0.08695652173913043
6001,1,3,3,21,24,0.125,0.875
5964,1,3,1,9,10,0.1,0.9
5950,1,3,1,6,7,0.14285714285714285,0.8571428571428571
5991,1,3,0,20,20,0.0,1.0
6177,1,3,0,3,3,0.0,1.0
5961,1,3,0,45,45,0.0,1.0
5938,1,3,140,200,340,0.4117647058823529,0.5882352941176471
5960,1,3,0,36,36,0.0,1.0
5947,1,3,0,78,78,0.0,1.0
5957,1,3,7,0,7,1.0,0.0
6043,1,3,0,29,29,0.0,1.0
6014,1,3,10,0,10,1.0,0.0
6015,1,3,2,0,2,1.0,0.0
5978,1,3,16,0,16,1.0,0.0
5986,1,3,4,0,4,1.0,0.0
5969,1,3,4,0,4,1.0,0.0
5949,1,3,0,30,30,0.0,1.0
5959,1,3,38,2,40,0.95,0.05
6051,1,3,0,108,108,0.0,1.0
6029,1,3,0,20,20,0.0,1.0
6070,1,3,3,1,4,0.75,0.25
5942,1,3,0,108,108,0.0,1.0
5953,1,3,0,28,28,0.0,1.0
6076,1,3,10,4,14,0.7142857142857143,0.2857142857142857
5940,1,3,9,0,9,1.0,0.0
6109,1,3,85,10,95,0.8947368421052632,0.10526315789473684
6187,1,3,0,6,6,0.0,1.0
6053,1,3,0,15,15,0.0,1.0
6104,1,3,4,0,4,1.0,0.0
5943,1,3,0,9,9,0.0,1.0
6168,1,3,0,240,240,0.0,1.0
5989,1,3,0,6,6,0.0,1.0
5963,1,3,19,1,20,0.95,0.05
6194,1,3,0,80,80,0.0,1.0
6003,1,3,69,169,238,0.28991596638655465,0.7100840336134454
6167,1,3,7,3,10,0.7,0.3
6004,1,3,57,78,135,0.4222222222222222,0.5777777777777777
6054,1,3,0,14,14,0.0,1.0
6170,1,3,11,23,34,0.3235294117647059,0.6764705882352942
6063,1,3,10,0,10,1.0,0.0
5988,1,3,0,17,17,0.0,1.0
6075,1,3,1,11,12,0.08333333333333333,0.9166666666666666
6061,1,3,0,26,26,0.0,1.0
5965,1,3,0,45,45,0.0,1.0
6040,1,3,12,0,12,1.0,0.0
6106,1,3,0,30,30,0.0,1.0
6082,1,3,0,13,13,0.0,1.0
6031,1,3,0,25,25,0.0,1.0
6039,1,3,0,58,58,0.0,1.0
6189,2,3,9,13,22,0.4090909090909091,0.5909090909090909
5936,2,3,0,31,31,0.0,1.0
6087,2,3,0,18,18,0.0,1.0
5973,2,3,0,34,34,0.0,1.0
6085,2,3,0,34,34,0.0,1.0
5948,2,3,0,42,42,0.0,1.0
5974,2,3,0,10,10,0.0,1.0
6090,2,3,0,1,1,0.0,1.0
6068,2,3,0,35,35,0.0,1.0
6024,2,3,1,1,2,0.5,0.5
5976,2,3,48,32,80,0.6,0.4
5962,2,3,0,59,59,0.0,1.0
6033,2,3,0,24,24,0.0,1.0
6038,2,3,0,7,7,0.0,1.0
6042,2,3,0,49,49,0.0,1.0
5924,2,3,0,50,50,0.0,1.0
6083,2,3,3,9,12,0.25,0.75
6178,2,3,68,157,225,0.3022222222222222,0.6977777777777778
6086,2,3,0,25,25,0.0,1.0
5945,2,3,0,95,95,0.0,1.0
5925,2,3,0,122,122,0.0,1.0
5935,2,3,0,3,3,0.0,1.0
6073,2,3,5,2,7,0.7142857142857143,0.2857142857142857
5980,2,3,0,12,12,0.0,1.0
5993,2,3,0,24,24,0.0,1.0
5979,2,3,0,33,33,0.0,1.0
5966,2,3,24,2,26,0.9230769230769231,0.07692307692307693
5967,2,3,51,50,101,0.504950495049505,0.49504950495049505
5970,2,3,0,14,14,0.0,1.0
6188,2,3,3,0,3,1.0,0.0
6096,2,3,1,0,1,1.0,0.0
6069,2,3,0,17,17,0.0,1.0
5937,2,3,0,6,6,0.0,1.0
5990,2,3,0,50,50,0.0,1.0
5928,2,3,0,22,22,0.0,1.0
6058,2,3,46,23,69,0.6666666666666666,0.3333333333333333
6001,2,3,4,20,24,0.16666666666666666,0.8333333333333334
5964,2,3,1,9,10,0.1,0.9
5950,2,3,3,4,7,0.42857142857142855,0.5714285714285714
5991,2,3,0,20,20,0.0,1.0
6177,2,3,0,3,3,0.0,1.0
5961,2,3,0,45,45,0.0,1.0
5938,2,3,32,308,340,0.09411764705882353,0.9058823529411765
5960,2,3,0,36,36,0.0,1.0
5947,2,3,0,78,78,0.0,1.0
5957,2,3,5,2,7,0.7142857142857143,0.2857142857142857
6043,2,3,0,29,29,0.0,1.0
6014,2,3,10,0,10,1.0,0.0
6015,2,3,2,0,2,1.0,0.0
5978,2,3,14,2,16,0.875,0.125
5986,2,3,4,0,4,1.0,0.0
5969,2,3,4,0,4,1.0,0.0
5949,2,3,3,27,30,0.1,0.9
5959,2,3,28,12,40,0.7,0.3
6051,2,3,0,108,108,0.0,1.0
6029,2,3,0,20,20,0.0,1.0
6070,2,3,3,1,4,0.75,0.25
5942,2,3,0,108,108,0.0,1.0
5953,2,3,0,28,28,0.0,1.0
6076,2,3,12,2,14,0.8571428571428571,0.14285714285714285
5940,2,3,8,1,9,0.8888888888888888,0.1111111111111111
6109,2,3,49,46,95,0.5157894736842106,0.4842105263157895
6187,2,3,0,6,6,0.0,1.0
6053,2,3,0,15,15,0.0,1.0
6104,2,3,4,0,4,1.0,0.0
5943,2,3,0,9,9,0.0,1.0
6168,2,3,0,240,240,0.0,1.0
5989,2,3,0,6,6,0.0,1.0
5963,2,3,17,3,20,0.85,0.15
6194,2,3,0,80,80,0.0,1.0
6003,2,3,52,186,238,0.2184873949579832,0.7815126050420168
6167,2,3,7,3,10,0.7,0.3
6004,2,3,26,109,135,0.1925925925925926,0.8074074074074075
6054,2,3,0,14,14,0.0,1.0
6170,2,3,3,31,34,0.08823529411764706,0.9117647058823529
6063,2,3,10,0,10,1.0,0.0
5988,2,3,0,17,17,0.0,1.0
6075,2,3,0,12,12,0.0,1.0
6061,2,3,0,26,26,0.0,1.0
5965,2,3,0,45,45,0.0,1.0
6040,2,3,11,1,12,0.9166666666666666,0.08333333333333333
6106,2,3,2,28,30,0.06666666666666667,0.9333333333333333
6082,2,3,0,13,13,0.0,1.0
6031,2,3,2,23,25,0.08,0.92
6039,2,3,3,55,58,0.05172413793103448,0.9482758620689655
6189,3,3,5,17,22,0.22727272727272727,0.7727272727272727
5936,3,3,0,31,31,0.0,1.0
6087,3,3,0,18,18,0.0,1.0
5973,3,3,0,34,34,0.0,1.0
6085,3,3,0,34,34,0.0,1.0
5948,3,3,1,41,42,0.023809523809523808,0.9761904761904762
5974,3,3,0,10,10,0.0,1.0
6090,3,3,0,1,1,0.0,1.0
6068,3,3,0,35,35,0.0,1.0
6024,3,3,1,1,2,0.5,0.5
5976,3,3,36,44,80,0.45,0.55
5962,3,3,0,59,59,0.0,1.0
6033,3,3,4,20,24,0.16666666666666666,0.8333333333333334
6038,3,3,0,7,7,0.0,1.0
6042,3,3,0,49,49,0.0,1.0
5924,3,3,0,50,50,0.0,1.0
6083,3,3,4,8,12,0.3333333333333333,0.6666666666666666
6178,3,3,48,177,225,0.21333333333333335,0.7866666666666666
6086,3,3,0,25,25,0.0,1.0
5945,3,3,0,95,95,0.0,1.0
5925,3,3,0,122,122,0.0,1.0
5935,3,3,0,3,3,0.0,1.0
6073,3,3,4,3,7,0.5714285714285714,0.42857142857142855
5980,3,3,0,12,12,0.0,1.0
5993,3,3,3,21,24,0.125,0.875
5979,3,3,0,33,33,0.0,1.0
5966,3,3,17,9,26,0.6538461538461539,0.34615384615384615
5967,3,3,29,72,101,0.2871287128712871,0.7128712871287128
5970,3,3,0,14,14,0.0,1.0
6188,3,3,3,0,3,1.0,0.0
6096,3,3,1,0,1,1.0,0.0
6069,3,3,0,17,17,0.0,1.0
5937,3,3,0,6,6,0.0,1.0
5990,3,3,0,50,50,0.0,1.0
5928,3,3,0,22,22,0.0,1.0
6058,3,3,33,36,69,0.4782608695652174,0.5217391304347826
6001,3,3,4,20,24,0.16666666666666666,0.8333333333333334
5964,3,3,4,6,10,0.4,0.6
5950,3,3,0,7,7,0.0,1.0
5991,3,3,0,20,20,0.0,1.0
6177,3,3,0,3,3,0.0,1.0
5961,3,3,0,45,45,0.0,1.0
5938,3,3,15,325,340,0.04411764705882353,0.9558823529411765
5960,3,3,0,36,36,0.0,1.0
5947,3,3,0,78,78,0.0,1.0
5957,3,3,5,2,7,0.7142857142857143,0.2857142857142857
6043,3,3,0,29,29,0.0,1.0
6014,3,3,10,0,10,1.0,0.0
6015,3,3,2,0,2,1.0,0.0
5978,3,3,13,3,16,0.8125,0.1875
5986,3,3,4,0,4,1.0,0.0
5969,3,3,4,0,4,1.0,0.0
5949,3,3,0,30,30,0.0,1.0
5959,3,3,24,16,40,0.6,0.4
6051,3,3,0,108,108,0.0,1.0
6029,3,3,0,20,20,0.0,1.0
6070,3,3,3,1,4,0.75,0.25
5942,3,3,0,108,108,0.0,1.0
5953,3,3,0,28,28,0.0,1.0
6076,3,3,10,4,14,0.7142857142857143,0.2857142857142857
5940,3,3,8,1,9,0.8888888888888888,0.1111111111111111
6109,3,3,30,65,95,0.3157894736842105,0.6842105263157895
6187,3,3,0,6,6,0.0,1.0
6053,3,3,0,15,15,0.0,1.0
6104,3,3,3,1,4,0.75,0.25
5943,3,3,0,9,9,0.0,1.0
6168,3,3,0,240,240,0.0,1.0
5989,3,3,0,6,6,0.0,1.0
5963,3,3,14,6,20,0.7,0.3
6194,3,3,0,80,80,0.0,1.0
6003,3,3,25,213,238,0.10504201680672269,0.8949579831932774
6167,3,3,8,2,10,0.8,0.2
6004,3,3,19,116,135,0.14074074074074075,0.8592592592592593
6054,3,3,0,14,14,0.0,1.0
6170,3,3,7,27,34,0.20588235294117646,0.7941176470588235
6063,3,3,8,2,10,0.8,0.2
5988,3,3,0,17,17,0.0,1.0
6075,3,3,1,11,12,0.08333333333333333,0.9166666666666666
6061,3,3,0,26,26,0.0,1.0
5965,3,3,0,45,45,0.0,1.0
6040,3,3,11,1,12,0.9166666666666666,0.08333333333333333
6106,3,3,1,29,30,0.03333333333333333,0.9666666666666667
6082,3,3,2,11,13,0.15384615384615385,0.8461538461538461
6031,3,3,1,24,25,0.04,0.96
6039,3,3,7,51,58,0.1206896551724138,0.8793103448275862
6189,4,3,5,17,22,0.22727272727272727,0.7727272727272727
5936,4,3,0,31,31,0.0,1.0
6087,4,3,0,18,18,0.0,1.0
5973,4,3,0,34,34,0.0,1.0
6085,4,3,0,34,34,0.0,1.0
5948,4,3,1,41,42,0.023809523809523808,0.9761904761904762
5974,4,3,0,10,10,0.0,1.0
6090,4,3,0,1,1,0.0,1.0
6068,4,3,0,35,35,0.0,1.0
6024,4,3,1,1,2,0.5,0.5
5976,4,3,16,64,80,0.2,0.8
5962,4,3,0,59,59,0.0,1.0
6033,4,3,0,24,24,0.0,1.0
6038,4,3,0,7,7,0.0,1.0
6042,4,3,0,49,49,0.0,1.0
5924,4,3,0,50,50,0.0,1.0
6083,4,3,6,6,12,0.5,0.5
6178,4,3,22,203,225,0.09777777777777778,0.9022222222222223
6086,4,3,0,25,25,0.0,1.0
5945,4,3,0,95,95,0.0,1.0
5925,4,3,0,122,122,0.0,1.0
5935,4,3,0,3,3,0.0,1.0
6073,4,3,5,2,7,0.7142857142857143,0.2857142857142857
5980,4,3,0,12,12,0.0,1.0
5993,4,3,3,21,24,0.125,0.875
5979,4,3,0,33,33,0.0,1.0
5966,4,3,9,17,26,0.34615384615384615,0.6538461538461539
5967,4,3,21,80,101,0.2079207920792079,0.7920792079207921
5970,4,3,0,14,14,0.0,1.0
6188,4,3,3,0,3,1.0,0.0
6096,4,3,1,0,1,1.0,0.0
6069,4,3,0,17,17,0.0,1.0
5937,4,3,0,6,6,0.0,1.0
5990,4,3,0,50,50,0.0,1.0
5928,4,3,0,22,22,0.0,1.0
6058,4,3,29,40,69,0.42028985507246375,0.5797101449275363
6001,4,3,4,20,24,0.16666666666666666,0.8333333333333334
5964,4,3,0,10,10,0.0,1.0
5950,4,3,1,6,7,0.14285714285714285,0.8571428571428571
5991,4,3,0,20,20,0.0,1.0
6177,4,3,0,3,3,0.0,1.0
5961,4,3,0,45,45,0.0,1.0
5938,4,3,17,323,340,0.05,0.95
5960,4,3,0,36,36,0.0,1.0
5947,4,3,0,78,78,0.0,1.0
5957,4,3,5,2,7,0.7142857142857143,0.2857142857142857
6043,4,3,0,29,29,0.0,1.0
6014,4,3,10,0,10,1.0,0.0
6015,4,3,2,0,2,1.0,0.0
5978,4,3,11,5,16,0.6875,0.3125
5986,4,3,4,0,4,1.0,0.0
5969,4,3,4,0,4,1.0,0.0
5949,4,3,3,27,30,0.1,0.9
5959,4,3,15,25,40,0.375,0.625
6051,4,3,0,108,108,0.0,1.0
6029,4,3,1,19,20,0.05,0.95
6070,4,3,3,1,4,0.75,0.25
5942,4,3,0,108,108,0.0,1.0
5953,4,3,0,28,28,0.0,1.0
6076,4,3,9,5,14,0.6428571428571429,0.35714285714285715
5940,4,3,9,0,9,1.0,0.0
6109,4,3,25,70,95,0.2631578947368421,0.7368421052631579
6187,4,3,0,6,6,0.0,1.0
6053,4,3,0,15,15,0.0,1.0
6104,4,3,4,0,4,1.0,0.0
5943,4,3,0,9,9,0.0,1.0
6168,4,3,0,240,240,0.0,1.0
5989,4,3,0,6,6,0.0,1.0
5963,4,3,15,5,20,0.75,0.25
6194,4,3,0,80,80,0.0,1.0
6003,4,3,23,215,238,0.09663865546218488,0.9033613445378151
6167,4,3,2,8,10,0.2,0.8
6004,4,3,12,123,135,0.08888888888888889,0.9111111111111111
6054,4,3,0,14,14,0.0,1.0
6170,4,3,7,27,34,0.20588235294117646,0.7941176470588235
6063,4,3,8,2,10,0.8,0.2
5988,4,3,0,17,17,0.0,1.0
6075,4,3,0,12,12,0.0,1.0
6061,4,3,0,26,26,0.0,1.0
5965,4,3,0,45,45,0.0,1.0
6040,4,3,9,3,12,0.75,0.25
6106,4,3,1,29,30,0.03333333333333333,0.9666666666666667
6082,4,3,0,13,13,0.0,1.0
6031,4,3,2,23,25,0.08,0.92
6039,4,3,3,55,58,0.05172413793103448,0.9482758620689655
6189,5,3,7,15,22,0.3181818181818182,0.6818181818181818
5936,5,3,0,31,31,0.0,1.0
6087,5,3,0,18,18,0.0,1.0
5973,5,3,0,34,34,0.0,1.0
6085,5,3,0,34,34,0.0,1.0
5948,5,3,1,41,42,0.023809523809523808,0.9761904761904762
5974,5,3,0,10,10,0.0,1.0
6090,5,3,0,1,1,0.0,1.0
6068,5,3,0,35,35,0.0,1.0
6024,5,3,1,1,2,0.5,0.5
5976,5,3,21,59,80,0.2625,0.7375
5962,5,3,0,59,59,0.0,1.0
6033,5,3,11,13,24,0.4583333333333333,0.5416666666666666
6038,5,3,0,7,7,0.0,1.0
6042,5,3,0,49,49,0.0,1.0
5924,5,3,0,50,50,0.0,1.0
6083,5,3,7,5,12,0.5833333333333334,0.4166666666666667
6178,5,3,16,209,225,0.07111111111111111,0.9288888888888889
6086,5,3,0,25,25,0.0,1.0
5945,5,3,0,95,95,0.0,1.0
5925,5,3,0,122,122,0.0,1.0
5935,5,3,0,3,3,0.0,1.0
6073,5,3,4,3,7,0.5714285714285714,0.42857142857142855
5980,5,3,2,10,12,0.16666666666666666,0.8333333333333334
5993,5,3,0,24,24,0.0,1.0
5979,5,3,0,33,33,0.0,1.0
5966,5,3,8,18,26,0.3076923076923077,0.6923076923076923
5967,5,3,13,88,101,0.12871287128712872,0.8712871287128713
5970,5,3,0,14,14,0.0,1.0
6188,5,3,3,0,3,1.0,0.0
6096,5,3,1,0,1,1.0,0.0
6069,5,3,0,17,17,0.0,1.0
5937,5,3,0,6,6,0.0,1.0
5990,5,3,0,50,50,0.0,1.0
5928,5,3,0,22,22,0.0,1.0
6058,5,3,27,42,69,0.391304347826087,0.6086956521739131
6001,5,3,4,20,24,0.16666666666666666,0.8333333333333334
5964,5,3,0,10,10,0.0,1.0
5950,5,3,0,7,7,0.0,1.0
5991,5,3,0,20,20,0.0,1.0
6177,5,3,0,3,3,0.0,1.0
5961,5,3,0,45,45,0.0,1.0
5938,5,3,7,333,340,0.020588235294117647,0.9794117647058823
5960,5,3,0,36,36,0.0,1.0
5947,5,3,0,78,78,0.0,1.0
5957,5,3,4,3,7,0.5714285714285714,0.42857142857142855
6043,5,3,0,29,29,0.0,1.0
6014,5,3,10,0,10,1.0,0.0
6015,5,3,2,0,2,1.0,0.0
5978,5,3,11,5,16,0.6875,0.3125
5986,5,3,4,0,4,1.0,0.0
5969,5,3,3,1,4,0.75,0.25
5949,5,3,0,30,30,0.0,1.0
5959,5,3,12,28,40,0.3,0.7
6051,5,3,0,108,108,0.0,1.0
6029,5,3,1,19,20,0.05,0.95
6070,5,3,3,1,4,0.75,0.25
5942,5,3,0,108,108,0.0,1.0
5953,5,3,0,28,28,0.0,1.0
6076,5,3,6,8,14,0.42857142857142855,0.5714285714285714
5940,5,3,7,2,9,0.7777777777777778,0.2222222222222222
6109,5,3,23,72,95,0.24210526315789474,0.7578947368421053
6187,5,3,0,6,6,0.0,1.0
6053,5,3,4,11,15,0.26666666666666666,0.7333333333333333
6104,5,3,4,0,4,1.0,0.0
5943,5,3,0,9,9,0.0,1.0
6168,5,3,0,240,240,0.0,1.0
5989,5,3,0,6,6,0.0,1.0
5963,5,3,14,6,20,0.7,0.3
6194,5,3,0,80,80,0.0,1.0
6003,5,3,15,223,238,0.06302521008403361,0.9369747899159664
6167,5,3,5,5,10,0.5,0.5
6004,5,3,11,124,135,0.08148148148148149,0.9185185185185185
6054,5,3,0,14,14,0.0,1.0
6170,5,3,5,29,34,0.14705882352941177,0.8529411764705882
6063,5,3,6,4,10,0.6,0.4
5988,5,3,0,17,17,0.0,1.0
6075,5,3,2,10,12,0.16666666666666666,0.8333333333333334
6061,5,3,0,26,26,0.0,1.0
5965,5,3,0,45,45,0.0,1.0
6040,5,3,9,3,12,0.75,0.25
6106,5,3,1,29,30,0.03333333333333333,0.9666666666666667
6082,5,3,0,13,13,0.0,1.0
6031,5,3,1,24,25,0.04,0.96
6039,5,3,3,55,58,0.05172413793103448,0.9482758620689655
6189,6,3,3,19,22,0.13636363636363635,0.8636363636363636
5936,6,3,0,31,31,0.0,1.0
6087,6,3,0,18,18,0.0,1.0
5973,6,3,0,34,34,0.0,1.0
6085,6,3,0,34,34,0.0,1.0
5948,6,3,0,42,42,0.0,1.0
5974,6,3,0,10,10,0.0,1.0
6090,6,3,0,1,1,0.0,1.0
6068,6,3,0,35,35,0.0,1.0
6024,6,3,1,1,2,0.5,0.5
5976,6,3,13,67,80,0.1625,0.8375
5962,6,3,0,59,59,0.0,1.0
6033,6,3,6,18,24,0.25,0.75
6038,6,3,0,7,7,0.0,1.0
6042,6,3,0,49,49,0.0,1.0
5924,6,3,0,50,50,0.0,1.0
6083,6,3,2,10,12,0.16666666666666666,0.8333333333333334
6178,6,3,9,216,225,0.04,0.96
6086,6,3,0,25,25,0.0,1.0
5945,6,3,0,95,95,0.0,1.0
5925,6,3,0,122,122,0.0,1.0
5935,6,3,0,3,3,0.0,1.0
6073,6,3,5,2,7,0.7142857142857143,0.2857142857142857
5980,6,3,0,12,12,0.0,1.0
5993,6,3,0,24,24,0.0,1.0
5979,6,3,0,33,33,0.0,1.0
5966,6,3,4,22,26,0.15384615384615385,0.8461538461538461
5967,6,3,9,92,101,0.0891089108910891,0.9108910891089109
5970,6,3,0,14,14,0.0,1.0
6188,6,3,3,0,3,1.0,0.0
6096,6,3,1,0,1,1.0,0.0
6069,6,3,0,17,17,0.0,1.0
5937,6,3,0,6,6,0.0,1.0
5990,6,3,0,50,50,0.0,1.0
5928,6,3,0,22,22,0.0,1.0
6058,6,3,21,48,69,0.30434782608695654,0.6956521739130435
6001,6,3,5,19,24,0.20833333333333334,0.7916666666666666
5964,6,3,0,10,10,0.0,1.0
5950,6,3,0,7,7,0.0,1.0
5991,6,3,0,20,20,0.0,1.0
6177,6,3,0,3,3,0.0,1.0
5961,6,3,0,45,45,0.0,1.0
5938,6,3,6,334,340,0.01764705882352941,0.9823529411764705
5960,6,3,0,36,36,0.0,1.0
5947,6,3,0,78,78,0.0,1.0
5957,6,3,4,3,7,0.5714285714285714,0.42857142857142855
6043,6,3,0,29,29,0.0,1.0
6014,6,3,10,0,10,1.0,0.0
6015,6,3,2,0,2,1.0,0.0
5978,6,3,7,9,16,0.4375,0.5625
5986,6,3,4,0,4,1.0,0.0
5969,6,3,4,0,4,1.0,0.0
5949,6,3,0,30,30,0.0,1.0
5959,6,3,10,30,40,0.25,0.75
6051,6,3,0,108,108,0.0,1.0
6029,6,3,1,19,20,0.05,0.95
6070,6,3,4,0,4,1.0,0.0
5942,6,3,0,108,108,0.0,1.0
5953,6,3,0,28,28,0.0,1.0
6076,6,3,8,6,14,0.5714285714285714,0.42857142857142855
5940,6,3,7,2,9,0.7777777777777778,0.2222222222222222
6109,6,3,17,78,95,0.17894736842105263,0.8210526315789474
6187,6,3,0,6,6,0.0,1.0
6053,6,3,0,15,15,0.0,1.0
6104,6,3,3,1,4,0.75,0.25
5943,6,3,0,9,9,0.0,1.0
6168,6,3,0,240,240,0.0,1.0
5989,6,3,0,6,6,0.0,1.0
5963,6,3,11,9,20,0.55,0.45
6194,6,3,0,80,80,0.0,1.0
6003,6,3,5,233,238,0.02100840336134454,0.9789915966386554
6167,6,3,2,8,10,0.2,0.8
6004,6,3,12,123,135,0.08888888888888889,0.9111111111111111
6054,6,3,0,14,14,0.0,1.0
6170,6,3,7,27,34,0.20588235294117646,0.7941176470588235
6063,6,3,7,3,10,0.7,0.3
5988,6,3,0,17,17,0.0,1.0
6075,6,3,0,12,12,0.0,1.0
6061,6,3,0,26,26,0.0,1.0
5965,6,3,0,45,45,0.0,1.0
6040,6,3,9,3,12,0.75,0.25
6106,6,3,2,28,30,0.06666666666666667,0.9333333333333333
6082,6,3,0,13,13,0.0,1.0
6031,6,3,2,23,25,0.08,0.92
6039,6,3,1,57,58,0.017241379310344827,0.9827586206896551
6189,7,3,5,17,22,0.22727272727272727,0.7727272727272727
5936,7,3,0,31,31,0.0,1.0
6087,7,3,0,18,18,0.0,1.0
5973,7,3,0,34,34,0.0,1.0
6085,7,3,0,34,34,0.0,1.0
5948,7,3,0,42,42,0.0,1.0
5974,7,3,0,10,10,0.0,1.0
6090,7,3,0,1,1,0.0,1.0
6068,7,3,0,35,35,0.0,1.0
6024,7,3,1,1,2,0.5,0.5
5976,7,3,13,67,80,0.1625,0.8375
5962,7,3,0,59,59,0.0,1.0
6033,7,3,2,22,24,0.08333333333333333,0.9166666666666666
6038,7,3,0,7,7,0.0,1.0
6042,7,3,0,49,49,0.0,1.0
5924,7,3,0,50,50,0.0,1.0
6083,7,3,2,10,12,0.16666666666666666,0.8333333333333334
6178,7,3,9,216,225,0.04,0.96
6086,7,3,0,25,25,0.0,1.0
5945,7,3,0,95,95,0.0,1.0
5925,7,3,0,122,122,0.0,1.0
5935,7,3,0,3,3,0.0,1.0
6073,7,3,3,4,7,0.42857142857142855,0.5714285714285714
5980,7,3,0,12,12,0.0,1.0
5993,7,3,0,24,24,0.0,1.0
5979,7,3,0,33,33,0.0,1.0
5966,7,3,8,18,26,0.3076923076923077,0.6923076923076923
5967,7,3,17,84,101,0.16831683168316833,0.8316831683168316
5970,7,3,0,14,14,0.0,1.0
6188,7,3,2,1,3,0.6666666666666666,0.3333333333333333
6096,7,3,1,0,1,1.0,0.0
6069,7,3,0,17,17,0.0,1.0
5937,7,3,0,6,6,0.0,1.0
5990,7,3,0,50,50,0.0,1.0
5928,7,3,0,22,22,0.0,1.0
6058,7,3,18,51,69,0.2608695652173913,0.7391304347826086
6001,7,3,3,21,24,0.125,0.875
5964,7,3,1,9,10,0.1,0.9
5950,7,3,0,7,7,0.0,1.0
5991,7,3,0,20,20,0.0,1.0
6177,7,3,0,3,3,0.0,1.0
5961,7,3,0,45,45,0.0,1.0
5938,7,3,5,335,340,0.014705882352941176,0.9852941176470589
5960,7,3,0,36,36,0.0,1.0
5947,7,3,0,78,78,0.0,1.0
5957,7,3,4,3,7,0.5714285714285714,0.42857142857142855
6043,7,3,0,29,29,0.0,1.0
6014,7,3,9,1,10,0.9,0.1
6015,7,3,2,0,2,1.0,0.0
5978,7,3,6,10,16,0.375,0.625
5986,7,3,3,1,4,0.75,0.25
5969,7,3,3,1,4,0.75,0.25
5949,7,3,3,27,30,0.1,0.9
5959,7,3,8,32,40,0.2,0.8
6051,7,3,0,108,108,0.0,1.0
6029,7,3,1,19,20,0.05,0.95
6070,7,3,3,1,4,0.75,0.25
5942,7,3,0,108,108,0.0,1.0
5953,7,3,0,28,28,0.0,1.0
6076,7,3,3,11,14,0.21428571428571427,0.7857142857142857
5940,7,3,6,3,9,0.6666666666666666,0.3333333333333333
6109,7,3,13,82,95,0.1368421052631579,0.8631578947368421
6187,7,3,0,6,6,0.0,1.0
6053,7,3,0,15,15,0.0,1.0
6104,7,3,4,0,4,1.0,0.0
5943,7,3,0,9,9,0.0,1.0
6168,7,3,0,240,240,0.0,1.0
5989,7,3,0,6,6,0.0,1.0
5963,7,3,10,10,20,0.5,0.5
6194,7,3,0,80,80,0.0,1.0
6003,7,3,7,231,238,0.029411764705882353,0.9705882352941176
6167,7,3,1,9,10,0.1,0.9
6004,7,3,10,125,135,0.07407407407407407,0.9259259259259259
6054,7,3,0,14,14,0.0,1.0
6170,7,3,5,29,34,0.14705882352941177,0.8529411764705882
6063,7,3,5,5,10,0.5,0.5
5988,7,3,0,17,17,0.0,1.0
6075,7,3,2,10,12,0.16666666666666666,0.8333333333333334
6061,7,3,0,26,26,0.0,1.0
5965,7,3,0,45,45,0.0,1.0
6040,7,3,8,4,12,0.6666666666666666,0.3333333333333333
6106,7,3,0,30,30,0.0,1.0
6082,7,3,2,11,13,0.15384615384615385,0.8461538461538461
6031,7,3,1,24,25,0.04,0.96
6039,7,3,1,57,58,0.017241379310344827,0.9827586206896551
6189,8,3,9,13,22,0.4090909090909091,0.5909090909090909
5936,8,3,0,31,31,0.0,1.0
6087,8,3,0,18,18,0.0,1.0
5973,8,3,0,34,34,0.0,1.0
6085,8,3,0,34,34,0.0,1.0
5948,8,3,1,41,42,0.023809523809523808,0.9761904761904762
5974,8,3,0,10,10,0.0,1.0
6090,8,3,0,1,1,0.0,1.0
6068,8,3,0,35,35,0.0,1.0
6024,8,3,2,0,2,1.0,0.0
5976,8,3,5,75,80,0.0625,0.9375
5962,8,3,0,59,59,0.0,1.0
6033,8,3,4,20,24,0.16666666666666666,0.8333333333333334
6038,8,3,0,7,7,0.0,1.0
6042,8,3,0,49,49,0.0,1.0
5924,8,3,0,50,50,0.0,1.0
6083,8,3,2,10,12,0.16666666666666666,0.8333333333333334
6178,8,3,3,222,225,0.013333333333333334,0.9866666666666667
6086,8,3,0,25,25,0.0,1.0
5945,8,3,0,95,95,0.0,1.0
5925,8,3,0,122,122,0.0,1.0
5935,8,3,0,3,3,0.0,1.0
6073,8,3,4,3,7,0.5714285714285714,0.42857142857142855
5980,8,3,0,12,12,0.0,1.0
5993,8,3,0,24,24,0.0,1.0
5979,8,3,0,33,33,0.0,1.0
5966,8,3,3,23,26,0.11538461538461539,0.8846153846153846
5967,8,3,6,95,101,0.0594059405940594,0.9405940594059405
5970,8,3,0,14,14,0.0,1.0
6188,8,3,3,0,3,1.0,0.0
6096,8,3,1,0,1,1.0,0.0
6069,8,3,0,17,17,0.0,1.0
5937,8,3,0,6,6,0.0,1.0
5990,8,3,0,50,50,0.0,1.0
5928,8,3,0,22,22,0.0,1.0
6058,8,3,14,55,69,0.2028985507246377,0.7971014492753623
6001,8,3,1,23,24,0.041666666666666664,0.9583333333333334
5964,8,3,1,9,10,0.1,0.9
5950,8,3,0,7,7,0.0,1.0
5991,8,3,0,20,20,0.0,1.0
6177,8,3,0,3,3,0.0,1.0
5961,8,3,0,45,45,0.0,1.0
5938,8,3,3,337,340,0.008823529411764706,0.9911764705882353
5960,8,3,0,36,36,0.0,1.0
5947,8,3,0,78,78,0.0,1.0
5957,8,3,4,3,7,0.5714285714285714,0.42857142857142855
6043,8,3,0,29,29,0.0,1.0
6014,8,3,8,2,10,0.8,0.2
6015,8,3,2,0,2,1.0,0.0
5978,8,3,5,11,16,0.3125,0.6875
5986,8,3,3,1,4,0.75,0.25
5969,8,3,3,1,4,0.75,0.25
5949,8,3,0,30,30,0.0,1.0
5959,8,3,5,35,40,0.125,0.875
6051,8,3,0,108,108,0.0,1.0
6029,8,3,1,19,20,0.05,0.95
6070,8,3,3,1,4,0.75,0.25
5942,8,3,0,108,108,0.0,1.0
5953,8,3,0,28,28,0.0,1.0
6076,8,3,0,14,14,0.0,1.0
5940,8,3,7,2,9,0.7777777777777778,0.2222222222222222
6109,8,3,16,79,95,0.16842105263157894,0.8315789473684211
6187,8,3,0,6,6,0.0,1.0
6053,8,3,0,15,15,0.0,1.0
6104,8,3,3,1,4,0.75,0.25
5943,8,3,0,9,9,0.0,1.0
6168,8,3,0,240,240,0.0,1.0
5989,8,3,0,6,6,0.0,1.0
5963,8,3,7,13,20,0.35,0.65
6194,8,3,0,80,80,0.0,1.0
6003,8,3,8,230,238,0.03361344537815126,0.9663865546218487
6167,8,3,3,7,10,0.3,0.7
6004,8,3,5,130,135,0.037037037037037035,0.9629629629629629
6054,8,3,0,14,14,0.0,1.0
6170,8,3,3,31,34,0.08823529411764706,0.9117647058823529
6063,8,3,6,4,10,0.6,0.4
5988,8,3,0,17,17,0.0,1.0
6075,8,3,2,10,12,0.16666666666666666,0.8333333333333334
6061,8,3,0,26,26,0.0,1.0
5965,8,3,0,45,45,0.0,1.0
6040,8,3,7,5,12,0.5833333333333334,0.4166666666666667
6106,8,3,1,29,30,0.03333333333333333,0.9666666666666667
6082,8,3,0,13,13,0.0,1.0
6031,8,3,1,24,25,0.04,0.96
6039,8,3,1,57,58,0.017241379310344827,0.9827586206896551
6189,9,3,4,18,22,0.18181818181818182,0.8181818181818182
5936,9,3,0,31,31,0.0,1.0
6087,9,3,0,18,18,0.0,1.0
5973,9,3,0,34,34,0.0,1.0
6085,9,3,0,34,34,0.0,1.0
5948,9,3,1,41,42,0.023809523809523808,0.9761904761904762
5974,9,3,0,10,10,0.0,1.0
6090,9,3,0,1,1,0.0,1.0
6068,9,3,0,35,35,0.0,1.0
6024,9,3,2,0,2,1.0,0.0
5976,9,3,10,70,80,0.125,0.875
5962,9,3,0,59,59,0.0,1.0
6033,9,3,6,18,24,0.25,0.75
6038,9,3,0,7,7,0.0,1.0
6042,9,3,0,49,49,0.0,1.0
5924,9,3,0,50,50,0.0,1.0
6083,9,3,4,8,12,0.3333333333333333,0.6666666666666666
6178,9,3,5,220,225,0.022222222222222223,0.9777777777777777
6086,9,3,0,25,25,0.0,1.0
5945,9,3,0,95,95,0.0,1.0
5925,9,3,0,122,122,0.0,1.0
5935,9,3,0,3,3,0.0,1.0
6073,9,3,2,5,7,0.2857142857142857,0.7142857142857143
5980,9,3,0,12,12,0.0,1.0
5993,9,3,0,24,24,0.0,1.0
5979,9,3,0,33,33,0.0,1.0
5966,9,3,10,16,26,0.38461538461538464,0.6153846153846154
5967,9,3,8,93,101,0.07920792079207921,0.9207920792079208
5970,9,3,0,14,14,0.0,1.0
6188,9,3,2,1,3,0.6666666666666666,0.3333333333333333
6096,9,3,1,0,1,1.0,0.0
6069,9,3,0,17,17,0.0,1.0
5937,9,3,0,6,6,0.0,1.0
5990,9,3,0,50,50,0.0,1.0
5928,9,3,0,22,22,0.0,1.0
6058,9,3,15,54,69,0.21739130434782608,0.782608695652174
6001,9,3,3,21,24,0.125,0.875
5964,9,3,0,10,10,0.0,1.0
5950,9,3,0,7,7,0.0,1.0
5991,9,3,0,20,20,0.0,1.0
6177,9,3,0,3,3,0.0,1.0
5961,9,3,0,45,45,0.0,1.0
5938,9,3,5,335,340,0.014705882352941176,0.9852941176470589
5960,9,3,0,36,36,0.0,1.0
5947,9,3,0,78,78,0.0,1.0
5957,9,3,3,4,7,0.42857142857142855,0.5714285714285714
6043,9,3,0,29,29,0.0,1.0
6014,9,3,8,2,10,0.8,0.2
6015,9,3,2,0,2,1.0,0.0
5978,9,3,5,11,16,0.3125,0.6875
5986,9,3,3,1,4,0.75,0.25
5969,9,3,2,2,4,0.5,0.5
5949,9,3,0,30,30,0.0,1.0
5959,9,3,2,38,40,0.05,0.95
6051,9,3,0,108,108,0.0,1.0
6029,9,3,0,20,20,0.0,1.0
6070,9,3,3,1,4,0.75,0.25
5942,9,3,0,108,108,0.0,1.0
5953,9,3,0,28,28,0.0,1.0
6076,9,3,4,10,14,0.2857142857142857,0.7142857142857143
5940,9,3,5,4,9,0.5555555555555556,0.4444444444444444
6109,9,3,11,84,95,0.11578947368421053,0.8842105263157894
6187,9,3,0,6,6,0.0,1.0
6053,9,3,0,15,15,0.0,1.0
6104,9,3,4,0,4,1.0,0.0
5943,9,3,0,9,9,0.0,1.0
6168,9,3,0,240,240,0.0,1.0
5989,9,3,0,6,6,0.0,1.0
5963,9,3,11,9,20,0.55,0.45
6194,9,3,0,80,80,0.0,1.0
6003,9,3,3,235,238,0.012605042016806723,0.9873949579831933
6167,9,3,1,9,10,0.1,0.9
6004,9,3,2,133,135,0.014814814814814815,0.9851851851851852
6054,9,3,0,14,14,0.0,1.0
6170,9,3,2,32,34,0.058823529411764705,0.9411764705882353
6063,9,3,5,5,10,0.5,0.5
5988,9,3,0,17,17,0.0,1.0
6075,9,3,0,12,12,0.0,1.0
6061,9,3,0,26,26,0.0,1.0
5965,9,3,0,45,45,0.0,1.0
6040,9,3,8,4,12,0.6666666666666666,0.3333333333333333
6106,9,3,1,29,30,0.03333333333333333,0.9666666666666667
6082,9,3,0,13,13,0.0,1.0
6031,9,3,0,25,25,0.0,1.0
6039,9,3,4,54,58,0.06896551724137931,0.9310344827586207
6189,10,3,2,20,22,0.09090909090909091,0.9090909090909091
5936,10,3,0,31,31,0.0,1.0
6087,10,3,0,18,18,0.0,1.0
5973,10,3,0,34,34,0.0,1.0
6085,10,3,0,34,34,0.0,1.0
5948,10,3,0,42,42,0.0,1.0
5974,10,3,0,10,10,0.0,1.0
6090,10,3,0,1,1,0.0,1.0
6068,10,3,0,35,35,0.0,1.0
6024,10,3,1,1,2,0.5,0.5
5976,10,3,5,75,80,0.0625,0.9375
5962,10,3,0,59,59,0.0,1.0
6033,10,3,2,22,24,0.08333333333333333,0.9166666666666666
6038,10,3,0,7,7,0.0,1.0
6042,10,3,0,49,49,0.0,1.0
5924,10,3,0,50,50,0.0,1.0
6083,10,3,1,11,12,0.08333333333333333,0.9166666666666666
6178,10,3,3,222,225,0.013333333333333334,0.9866666666666667
6086,10,3,0,25,25,0.0,1.0
5945,10,3,0,95,95,0.0,1.0
5925,10,3,0,122,122,0.0,1.0
5935,10,3,0,3,3,0.0,1.0
6073,10,3,2,5,7,0.2857142857142857,0.7142857142857143
5980,10,3,0,12,12,0.0,1.0
5993,10,3,0,24,24,0.0,1.0
5979,10,3,0,33,33,0.0,1.0
5966,10,3,5,21,26,0.19230769230769232,0.8076923076923077
5967,10,3,6,95,101,0.0594059405940594,0.9405940594059405
5970,10,3,0,14,14,0.0,1.0
6188,10,3,2,1,3,0.6666666666666666,0.3333333333333333
6096,10,3,1,0,1,1.0,0.0
6069,10,3,0,17,17,0.0,1.0
5937,10,3,0,6,6,0.0,1.0
5990,10,3,0,50,50,0.0,1.0
5928,10,3,0,22,22,0.0,1.0
6058,10,3,10,59,69,0.14492753623188406,0.855072463768116
6001,10,3,4,20,24,0.16666666666666666,0.8333333333333334
5964,10,3,1,9,10,0.1,0.9
5950,10,3,0,7,7,0.0,1.0
5991,10,3,0,20,20,0.0,1.0
6177,10,3,0,3,3,0.0,1.0
5961,10,3,0,45,45,0.0,1.0
5938,10,3,6,334,340,0.01764705882352941,0.9823529411764705
5960,10,3,0,36,36,0.0,1.0
5947,10,3,0,78,78,0.0,1.0
5957,10,3,3,4,7,0.42857142857142855,0.5714285714285714
6043,10,3,0,29,29,0.0,1.0
6014,10,3,8,2,10,0.8,0.2
6015,10,3,2,0,2,1.0,0.0
5978,10,3,3,13,16,0.1875,0.8125
5986,10,3,3,1,4,0.75,0.25
5969,10,3,3,1,4,0.75,0.25
5949,10,3,0,30,30,0.0,1.0
5959,10,3,4,36,40,0.1,0.9
6051,10,3,0,108,108,0.0,1.0
6029,10,3,1,19,20,0.05,0.95
6070,10,3,3,1,4,0.75,0.25
5942,10,3,0,108,108,0.0,1.0
5953,10,3,0,28,28,0.0,1.0
6076,10,3,3,11,14,0.21428571428571427,0.7857142857142857
5940,10,3,5,4,9,0.5555555555555556,0.4444444444444444
6109,10,3,12,83,95,0.12631578947368421,0.8736842105263158
6187,10,3,2,4,6,0.3333333333333333,0.6666666666666666
6053,10,3,0,15,15,0.0,1.0
6104,10,3,4,0,4,1.0,0.0
5943,10,3,0,9,9,0.0,1.0
6168,10,3,0,240,240,0.0,1.0
5989,10,3,0,6,6,0.0,1.0
5963,10,3,6,14,20,0.3,0.7
6194,10,3,0,80,80,0.0,1.0
6003,10,3,6,232,238,0.025210084033613446,0.9747899159663865
6167,10,3,0,10,10,0.0,1.0
6004,10,3,4,131,135,0.02962962962962963,0.9703703703703703
6054,10,3,0,14,14,0.0,1.0
6170,10,3,3,31,34,0.08823529411764706,0.9117647058823529
6063,10,3,7,3,10,0.7,0.3
5988,10,3,0,17,17,0.0,1.0
6075,10,3,2,10,12,0.16666666666666666,0.8333333333333334
6061,10,3,0,26,26,0.0,1.0
5965,10,3,0,45,45,0.0,1.0
6040,10,3,9,3,12,0.75,0.25
6106,10,3,1,29,30,0.03333333333333333,0.9666666666666667
6082,10,3,0,13,13,0.0,1.0
6031,10,3,1,24,25,0.04,0.96
6039,10,3,0,58,58,0.0,1.0
6189,11,3,3,19,22,0.13636363636363635,0.8636363636363636
5936,11,3,0,31,31,0.0,1.0
6087,11,3,0,18,18,0.0,1.0
5973,11,3,0,34,34,0.0,1.0
6085,11,3,0,34,34,0.0,1.0
5948,11,3,0,42,42,0.0,1.0
5974,11,3,0,10,10,0.0,1.0
6090,11,3,0,1,1,0.0,1.0
6068,11,3,0,35,35,0.0,1.0
6024,11,3,1,1,2,0.5,0.5
5976,11,3,4,76,80,0.05,0.95
5962,11,3,0,59,59,0.0,1.0
6033,11,3,4,20,24,0.16666666666666666,0.8333333333333334
6038,11,3,0,7,7,0.0,1.0
6042,11,3,0,49,49,0.0,1.0
5924,11,3,0,50,50,0.0,1.0
6083,11,3,1,11,12,0.08333333333333333,0.9166666666666666
6178,11,3,4,221,225,0.017777777777777778,0.9822222222222222
6086,11,3,0,25,25,0.0,1.0
5945,11,3,0,95,95,0.0,1.0
5925,11,3,0,122,122,0.0,1.0
5935,11,3,0,3,3,0.0,1.0
6073,11,3,3,4,7,0.42857142857142855,0.5714285714285714
5980,11,3,0,12,12,0.0,1.0
5993,11,3,0,24,24,0.0,1.0
5979,11,3,0,33,33,0.0,1.0
5966,11,3,3,23,26,0.11538461538461539,0.8846153846153846
5967,11,3,5,96,101,0.04950495049504951,0.9504950495049505
5970,11,3,0,14,14,0.0,1.0
6188,11,3,1,2,3,0.3333333333333333,0.6666666666666666
6096,11,3,1,0,1,1.0,0.0
6069,11,3,0,17,17,0.0,1.0
5937,11,3,0,6,6,0.0,1.0
5990,11,3,0,50,50,0.0,1.0
5928,11,3,0,22,22,0.0,1.0
6058,11,3,9,60,69,0.13043478260869565,0.8695652173913043
6001,11,3,3,21,24,0.125,0.875
5964,11,3,1,9,10,0.1,0.9
5950,11,3,1,6,7,0.14285714285714285,0.8571428571428571
5991,11,3,0,20,20,0.0,1.0
6177,11,3,0,3,3,0.0,1.0
5961,11,3,0,45,45,0.0,1.0
5938,11,3,1,339,340,0.0029411764705882353,0.9970588235294118
5960,11,3,0,36,36,0.0,1.0
5947,11,3,0,78,78,0.0,1.0
5957,11,3,4,3,7,0.5714285714285714,0.42857142857142855
6043,11,3,0,29,29,0.0,1.0
6014,11,3,7,3,10,0.7,0.3
6015,11,3,1,1,2,0.5,0.5
5978,11,3,3,13,16,0.1875,0.8125
5986,11,3,3,1,4,0.75,0.25
5969,11,3,2,2,4,0.5,0.5
5949,11,3,0,30,30,0.0,1.0
5959,11,3,2,38,40,0.05,0.95
6051,11,3,0,108,108,0.0,1.0
6029,11,3,0,20,20,0.0,1.0
6070,11,3,4,0,4,1.0,0.0
5942,11,3,0,108,108,0.0,1.0
5953,11,3,0,28,28,0.0,1.0
6076,11,3,3,11,14,0.21428571428571427,0.7857142857142857
5940,11,3,5,4,9,0.5555555555555556,0.4444444444444444
6109,11,3,10,85,95,0.10526315789473684,0.8947368421052632
6187,11,3,0,6,6,0.0,1.0
6053,11,3,0,15,15,0.0,1.0
6104,11,3,4,0,4,1.0,0.0
5943,11,3,0,9,9,0.0,1.0
6168,11,3,0,240,240,0.0,1.0
5989,11,3,0,6,6,0.0,1.0
5963,11,3,5,15,20,0.25,0.75
6194,11,3,0,80,80,0.0,1.0
6003,11,3,1,237,238,0.004201680672268907,0.9957983193277311
6167,11,3,2,8,10,0.2,0.8
6004,11,3,0,135,135,0.0,1.0
6054,11,3,0,14,14,0.0,1.0
6170,11,3,3,31,34,0.08823529411764706,0.9117647058823529
6063,11,3,5,5,10,0.5,0.5
5988,11,3,0,17,17,0.0,1.0
6075,11,3,1,11,12,0.08333333333333333,0.9166666666666666
6061,11,3,0,26,26,0.0,1.0
5965,11,3,0,45,45,0.0,1.0
6040,11,3,5,7,12,0.4166666666666667,0.5833333333333334
6106,11,3,0,30,30,0.0,1.0
6082,11,3,0,13,13,0.0,1.0
6031,11,3,2,23,25,0.08,0.92
6039,11,3,0,58,58,0.0,1.0
6189,12,3,5,17,22,0.22727272727272727,0.7727272727272727
5936,12,3,0,31,31,0.0,1.0
6087,12,3,0,18,18,0.0,1.0
5973,12,3,0,34,34,0.0,1.0
6085,12,3,0,34,34,0.0,1.0
5948,12,3,1,41,42,0.023809523809523808,0.9761904761904762
5974,12,3,0,10,10,0.0,1.0
6090,12,3,0,1,1,0.0,1.0
6068,12,3,0,35,35,0.0,1.0
6024,12,3,2,0,2,1.0,0.0
5976,12,3,1,79,80,0.0125,0.9875
5962,12,3,0,59,59,0.0,1.0
6033,12,3,0,24,24,0.0,1.0
6038,12,3,0,7,7,0.0,1.0
6042,12,3,0,49,49,0.0,1.0
5924,12,3,0,50,50,0.0,1.0
6083,12,3,2,10,12,0.16666666666666666,0.8333333333333334
6178,12,3,1,224,225,0.0044444444444444444,0.9955555555555555
6086,12,3,0,25,25,0.0,1.0
5945,12,3,0,95,95,0.0,1.0
5925,12,3,0,122,122,0.0,1.0
5935,12,3,0,3,3,0.0,1.0
6073,12,3,3,4,7,0.42857142857142855,0.5714285714285714
5980,12,3,0,12,12,0.0,1.0
5993,12,3,0,24,24,0.0,1.0
5979,12,3,0,33,33,0.0,1.0
5966,12,3,3,23,26,0.11538461538461539,0.8846153846153846
5967,12,3,6,95,101,0.0594059405940594,0.9405940594059405
5970,12,3,0,14,14,0.0,1.0
6188,12,3,1,2,3,0.3333333333333333,0.6666666666666666
6096,12,3,1,0,1,1.0,0.0
6069,12,3,0,17,17,0.0,1.0
5937,12,3,0,6,6,0.0,1.0
5990,12,3,0,50,50,0.0,1.0
5928,12,3,0,22,22,0.0,1.0
6058,12,3,11,58,69,0.15942028985507245,0.8405797101449275
6001,12,3,3,21,24,0.125,0.875
5964,12,3,1,9,10,0.1,0.9
5950,12,3,0,7,7,0.0,1.0
5991,12,3,0,20,20,0.0,1.0
6177,12,3,0,3,3,0.0,1.0
5961,12,3,0,45,45,0.0,1.0
5938,12,3,1,339,340,0.0029411764705882353,0.9970588235294118
5960,12,3,0,36,36,0.0,1.0
5947,12,3,0,78,78,0.0,1.0
5957,12,3,3,4,7,0.42857142857142855,0.5714285714285714
6043,12,3,0,29,29,0.0,1.0
6014,12,3,8,2,10,0.8,0.2
6015,12,3,2,0,2,1.0,0.0
5978,12,3,3,13,16,0.1875,0.8125
5986,12,3,4,0,4,1.0,0.0
5969,12,3,3,1,4,0.75,0.25
5949,12,3,0,30,30,0.0,1.0
5959,12,3,3,37,40,0.075,0.925
6051,12,3,0,108,108,0.0,1.0
6029,12,3,1,19,20,0.05,0.95
6070,12,3,4,0,4,1.0,0.0
5942,12,3,0,108,108,0.0,1.0
5953,12,3,0,28,28,0.0,1.0
6076,12,3,4,10,14,0.2857142857142857,0.7142857142857143
5940,12,3,3,6,9,0.3333333333333333,0.6666666666666666
6109,12,3,5,90,95,0.05263157894736842,0.9473684210526315
6187,12,3,0,6,6,0.0,1.0
6053,12,3,0,15,15,0.0,1.0
6104,12,3,3,1,4,0.75,0.25
5943,12,3,0,9,9,0.0,1.0
6168,12,3,0,240,240,0.0,1.0
5989,12,3,0,6,6,0.0,1.0
5963,12,3,2,18,20,0.1,0.9
6194,12,3,0,80,80,0.0,1.0
6003,12,3,2,236,238,0.008403361344537815,0.9915966386554622
6167,12,3,1,9,10,0.1,0.9
6004,12,3,4,131,135,0.02962962962962963,0.9703703703703703
6054,12,3,0,14,14,0.0,1.0
6170,12,3,0,34,34,0.0,1.0
6063,12,3,3,7,10,0.3,0.7
5988,12,3,0,17,17,0.0,1.0
6075,12,3,1,11,12,0.08333333333333333,0.9166666666666666
6061,12,3,0,26,26,0.0,1.0
5965,12,3,0,45,45,0.0,1.0
6040,12,3,6,6,12,0.5,0.5
6106,12,3,1,29,30,0.03333333333333333,0.9666666666666667
6082,12,3,0,13,13,0.0,1.0
6031,12,3,0,25,25,0.0,1.0
6039,12,3,1,57,58,0.017241379310344827,0.9827586206896551
6189,13,3,6,16,22,0.2727272727272727,0.7272727272727273
5936,13,3,0,31,31,0.0,1.0
6087,13,3,0,18,18,0.0,1.0
5973,13,3,0,34,34,0.0,1.0
6085,13,3,0,34,34,0.0,1.0
5948,13,3,1,41,42,0.023809523809523808,0.9761904761904762
5974,13,3,0,10,10,0.0,1.0
6090,13,3,0,1,1,0.0,1.0
6068,13,3,0,35,35,0.0,1.0
6024,13,3,2,0,2,1.0,0.0
5976,13,3,6,74,80,0.075,0.925
5962,13,3,0,59,59,0.0,1.0
6033,13,3,4,20,24,0.16666666666666666,0.8333333333333334
6038,13,3,0,7,7,0.0,1.0
6042,13,3,0,49,49,0.0,1.0
5924,13,3,0,50,50,0.0,1.0
6083,13,3,1,11,12,0.08333333333333333,0.9166666666666666
6178,13,3,0,225,225,0.0,1.0
6086,13,3,0,25,25,0.0,1.0
5945,13,3,0,95,95,0.0,1.0
5925,13,3,0,122,122,0.0,1.0
5935,13,3,0,3,3,0.0,1.0
6073,13,3,1,6,7,0.14285714285714285,0.8571428571428571
5980,13,3,2,10,12,0.16666666666666666,0.8333333333333334
5993,13,3,0,24,24,0.0,1.0
5979,13,3,0,33,33,0.0,1.0
5966,13,3,5,21,26,0.19230769230769232,0.8076923076923077
5967,13,3,4,97,101,0.039603960396039604,0.9603960396039604
5970,13,3,0,14,14,0.0,1.0
6188,13,3,2,1,3,0.6666666666666666,0.3333333333333333
6096,13,3,1,0,1,1.0,0.0
6069,13,3,0,17,17,0.0,1.0
5937,13,3,0,6,6,0.0,1.0
5990,13,3,0,50,50,0.0,1.0
5928,13,3,0,22,22,0.0,1.0
6058,13,3,9,60,69,0.13043478260869565,0.8695652173913043
6001,13,3,6,18,24,0.25,0.75
5964,13,3,0,10,10,0.0,1.0
5950,13,3,0,7,7,0.0,1.0
5991,13,3,0,20,20,0.0,1.0
6177,13,3,0,3,3,0.0,1.0
5961,13,3,0,45,45,0.0,1.0
5938,13,3,2,338,340,0.0058823529411764705,0.9941176470588236
5960,13,3,0,36,36,0.0,1.0
5947,13,3,0,78,78,0.0,1.0
5957,13,3,4,3,7,0.5714285714285714,0.42857142857142855
6043,13,3,0,29,29,0.0,1.0
6014,13,3,10,0,10,1.0,0.0
6015,13,3,1,1,2,0.5,0.5
5978,13,3,2,14,16,0.125,0.875
5986,13,3,3,1,4,0.75,0.25
5969,13,3,2,2,4,0.5,0.5
5949,13,3,0,30,30,0.0,1.0
5959,13,3,1,39,40,0.025,0.975
6051,13,3,0,108,108,0.0,1.0
6029,13,3,0,20,20,0.0,1.0
6070,13,3,4,0,4,1.0,0.0
5942,13,3,0,108,108,0.0,1.0
5953,13,3,0,28,28,0.0,1.0
6076,13,3,0,14,14,0.0,1.0
5940,13,3,5,4,9,0.5555555555555556,0.4444444444444444
6109,13,3,4,91,95,0.042105263157894736,0.9578947368421052
6187,13,3,0,6,6,0.0,1.0
6053,13,3,0,15,15,0.0,1.0
6104,13,3,2,2,4,0.5,0.5
5943,13,3,0,9,9,0.0,1.0
6168,13,3,0,240,240,0.0,1.0
5989,13,3,0,6,6,0.0,1.0
5963,13,3,2,18,20,0.1,0.9
6194,13,3,0,80,80,0.0,1.0
6003,13,3,1,237,238,0.004201680672268907,0.9957983193277311
6167,13,3,1,9,10,0.1,0.9
6004,13,3,2,133,135,0.014814814814814815,0.9851851851851852
6054,13,3,0,14,14,0.0,1.0
6170,13,3,5,29,34,0.14705882352941177,0.8529411764705882
6063,13,3,5,5,10,0.5,0.5
5988,13,3,0,17,17,0.0,1.0
6075,13,3,0,12,12,0.0,1.0
6061,13,3,0,26,26,0.0,1.0
5965,13,3,0,45,45,0.0,1.0
6040,13,3,7,5,12,0.5833333333333334,0.4166666666666667
6106,13,3,1,29,30,0.03333333333333333,0.9666666666666667
6082,13,3,0,13,13,0.0,1.0
6031,13,3,0,25,25,0.0,1.0
6039,13,3,9,49,58,0.15517241379310345,0.8448275862068966
6189,14,3,3,19,22,0.13636363636363635,0.8636363636363636
5936,14,3,0,31,31,0.0,1.0
6087,14,3,0,18,18,0.0,1.0
5973,14,3,0,34,34,0.0,1.0
6085,14,3,0,34,34,0.0,1.0
5948,14,3,1,41,42,0.023809523809523808,0.9761904761904762
5974,14,3,0,10,10,0.0,1.0
6090,14,3,0,1,1,0.0,1.0
6068,14,3,0,35,35,0.0,1.0
6024,14,3,2,0,2,1.0,0.0
5976,14,3,2,78,80,0.025,0.975
5962,14,3,0,59,59,0.0,1.0
6033,14,3,4,20,24,0.16666666666666666,0.8333333333333334
6038,14,3,0,7,7,0.0,1.0
6042,14,3,0,49,49,0.0,1.0
5924,14,3,0,50,50,0.0,1.0
6083,14,3,3,9,12,0.25,0.75
6178,14,3,1,224,225,0.0044444444444444444,0.9955555555555555
6086,14,3,0,25,25,0.0,1.0
5945,14,3,0,95,95,0.0,1.0
5925,14,3,0,122,122,0.0,1.0
5935,14,3,0,3,3,0.0,1.0
6073,14,3,2,5,7,0.2857142857142857,0.7142857142857143
5980,14,3,2,10,12,0.16666666666666666,0.8333333333333334
5993,14,3,5,19,24,0.20833333333333334,0.7916666666666666
5979,14,3,0,33,33,0.0,1.0
5966,14,3,2,24,26,0.07692307692307693,0.9230769230769231
5967,14,3,3,98,101,0.0297029702970297,0.9702970297029703
5970,14,3,0,14,14,0.0,1.0
6188,14,3,2,1,3,0.6666666666666666,0.3333333333333333
6096,14,3,1,0,1,1.0,0.0
6069,14,3,0,17,17,0.0,1.0
5937,14,3,0,6,6,0.0,1.0
5990,14,3,0,50,50,0.0,1.0
5928,14,3,0,22,22,0.0,1.0
6058,14,3,9,60,69,0.13043478260869565,0.8695652173913043
6001,14,3,0,24,24,0.0,1.0
5964,14,3,0,10,10,0.0,1.0
5950,14,3,0,7,7,0.0,1.0
5991,14,3,0,20,20,0.0,1.0
6177,14,3,0,3,3,0.0,1.0
5961,14,3,0,45,45,0.0,1.0
5938,14,3,2,338,340,0.0058823529411764705,0.9941176470588236
5960,14,3,0,36,36,0.0,1.0
5947,14,3,0,78,78,0.0,1.0
5957,14,3,5,2,7,0.7142857142857143,0.2857142857142857
6043,14,3,0,29,29,0.0,1.0
6014,14,3,8,2,10,0.8,0.2
6015,14,3,1,1,2,0.5,0.5
5978,14,3,0,16,16,0.0,1.0
5986,14,3,3,1,4,0.75,0.25
5969,14,3,0,4,4,0.0,1.0
5949,14,3,0,30,30,0.0,1.0
5959,14,3,3,37,40,0.075,0.925
6051,14,3,0,108,108,0.0,1.0
6029,14,3,0,20,20,0.0,1.0
6070,14,3,3,1,4,0.75,0.25
5942,14,3,0,108,108,0.0,1.0
5953,14,3,0,28,28,0.0,1.0
6076,14,3,2,12,14,0.14285714285714285,0.8571428571428571
5940,14,3,7,2,9,0.7777777777777778,0.2222222222222222
6109,14,3,4,91,95,0.042105263157894736,0.9578947368421052
6187,14,3,0,6,6,0.0,1.0
6053,14,3,0,15,15,0.0,1.0
6104,14,3,3,1,4,0.75,0.25
5943,14,3,0,9,9,0.0,1.0
6168,14,3,0,240,240,0.0,1.0
5989,14,3,0,6,6,0.0,1.0
5963,14,3,7,13,20,0.35,0.65
6194,14,3,0,80,80,0.0,1.0
6003,14,3,0,238,238,0.0,1.0
6167,14,3,0,10,10,0.0,1.0
6004,14,3,1,134,135,0.007407407407407408,0.9925925925925926
6054,14,3,0,14,14,0.0,1.0
6170,14,3,1,33,34,0.029411764705882353,0.9705882352941176
6063,14,3,4,6,10,0.4,0.6
5988,14,3,0,17,17,0.0,1.0
6075,14,3,0,12,12,0.0,1.0
6061,14,3,0,26,26,0.0,1.0
5965,14,3,0,45,45,0.0,1.0
6040,14,3,7,5,12,0.5833333333333334,0.4166666666666667
6106,14,3,1,29,30,0.03333333333333333,0.9666666666666667
6082,14,3,2,11,13,0.15384615384615385,0.8461538461538461
6031,14,3,2,23,25,0.08,0.92
6039,14,3,0,58,58,0.0,1.0
6189,15,3,1,21,22,0.045454545454545456,0.9545454545454546
5936,15,3,0,31,31,0.0,1.0
6087,15,3,0,18,18,0.0,1.0
5973,15,3,0,34,34,0.0,1.0
6085,15,3,0,34,34,0.0,1.0
5948,15,3,1,41,42,0.023809523809523808,0.9761904761904762
5974,15,3,0,10,10,0.0,1.0
6090,15,3,0,1,1,0.0,1.0
6068,15,3,0,35,35,0.0,1.0
6024,15,3,2,0,2,1.0,0.0
5976,15,3,2,78,80,0.025,0.975
5962,15,3,0,59,59,0.0,1.0
6033,15,3,0,24,24,0.0,1.0
6038,15,3,0,7,7,0.0,1.0
6042,15,3,0,49,49,0.0,1.0
5924,15,3,0,50,50,0.0,1.0
6083,15,3,4,8,12,0.3333333333333333,0.6666666666666666
6178,15,3,1,224,225,0.0044444444444444444,0.9955555555555555
6086,15,3,0,25,25,0.0,1.0
5945,15,3,0,95,95,0.0,1.0
5925,15,3,0,122,122,0.0,1.0
5935,15,3,0,3,3,0.0,1.0
6073,15,3,0,7,7,0.0,1.0
5980,15,3,0,12,12,0.0,1.0
5993,15,3,3,21,24,0.125,0.875
5979,15,3,0,33,33,0.0,1.0
5966,15,3,1,25,26,0.038461538461538464,0.9615384615384616
5967,15,3,1,100,101,0.009900990099009901,0.9900990099009901
5970,15,3,0,14,14,0.0,1.0
6188,15,3,1,2,3,0.3333333333333333,0.6666666666666666
6096,15,3,1,0,1,1.0,0.0
6069,15,3,0,17,17,0.0,1.0
5937,15,3,0,6,6,0.0,1.0
5990,15,3,0,50,50,0.0,1.0
5928,15,3,0,22,22,0.0,1.0
6058,15,3,5,64,69,0.07246376811594203,0.927536231884058
6001,15,3,3,21,24,0.125,0.875
5964,15,3,1,9,10,0.1,0.9
5950,15,3,1,6,7,0.14285714285714285,0.8571428571428571
5991,15,3,0,20,20,0.0,1.0
6177,15,3,0,3,3,0.0,1.0
5961,15,3,0,45,45,0.0,1.0
5938,15,3,1,339,340,0.0029411764705882353,0.9970588235294118
5960,15,3,0,36,36,0.0,1.0
5947,15,3,0,78,78,0.0,1.0
5957,15,3,4,3,7,0.5714285714285714,0.42857142857142855
6043,15,3,0,29,29,0.0,1.0
6014,15,3,7,3,10,0.7,0.3
6015,15,3,1,1,2,0.5,0.5
5978,15,3,1,15,16,0.0625,0.9375
5986,15,3,2,2,4,0.5,0.5
5969,15,3,2,2,4,0.5,0.5
5949,15,3,0,30,30,0.0,1.0
5959,15,3,2,38,40,0.05,0.95
6051,15,3,0,108,108,0.0,1.0
6029,15,3,1,19,20,0.05,0.95
6070,15,3,3,1,4,0.75,0.25
5942,15,3,0,108,108,0.0,1.0
5953,15,3,0,28,28,0.0,1.0
6076,15,3,0,14,14,0.0,1.0
5940,15,3,4,5,9,0.4444444444444444,0.5555555555555556
6109,15,3,1,94,95,0.010526315789473684,0.9894736842105263
6187,15,3,0,6,6,0.0,1.0
6053,15,3,0,15,15,0.0,1.0
6104,15,3,3,1,4,0.75,0.25
5943,15,3,0,9,9,0.0,1.0
6168,15,3,0,240,240,0.0,1.0
5989,15,3,0,6,6,0.0,1.0
5963,15,3,3,17,20,0.15,0.85
6194,15,3,0,80,80,0.0,1.0
6003,15,3,1,237,238,0.004201680672268907,0.9957983193277311
6167,15,3,0,10,10,0.0,1.0
6004,15,3,2,133,135,0.014814814814814815,0.9851851851851852
6054,15,3,0,14,14,0.0,1.0
6170,15,3,3,31,34,0.08823529411764706,0.9117647058823529
6063,15,3,6,4,10,0.6,0.4
5988,15,3,0,17,17,0.0,1.0
6075,15,3,0,12,12,0.0,1.0
6061,15,3,0,26,26,0.0,1.0
5965,15,3,0,45,45,0.0,1.0
6040,15,3,6,6,12,0.5,0.5
6106,15,3,1,29,30,0.03333333333333333,0.9666666666666667
6082,15,3,0,13,13,0.0,1.0
6031,15,3,0,25,25,0.0,1.0
6039,15,3,0,58,58,0.0,1.0
6189,16,3,2,20,22,0.09090909090909091,0.9090909090909091
5936,16,3,0,31,31,0.0,1.0
6087,16,3,0,18,18,0.0,1.0
5973,16,3,0,34,34,0.0,1.0
6085,16,3,0,34,34,0.0,1.0
5948,16,3,0,42,42,0.0,1.0
5974,16,3,0,10,10,0.0,1.0
6090,16,3,0,1,1,0.0,1.0
6068,16,3,0,35,35,0.0,1.0
6024,16,3,1,1,2,0.5,0.5
5976,16,3,3,77,80,0.0375,0.9625
5962,16,3,0,59,59,0.0,1.0
6033,16,3,2,22,24,0.08333333333333333,0.9166666666666666
6038,16,3,0,7,7,0.0,1.0
6042,16,3,0,49,49,0.0,1.0
5924,16,3,0,50,50,0.0,1.0
6083,16,3,2,10,12,0.16666666666666666,0.8333333333333334
6178,16,3,1,224,225,0.0044444444444444444,0.9955555555555555
6086,16,3,0,25,25,0.0,1.0
5945,16,3,0,95,95,0.0,1.0
5925,16,3,0,122,122,0.0,1.0
5935,16,3,0,3,3,0.0,1.0
6073,16,3,2,5,7,0.2857142857142857,0.7142857142857143
5980,16,3,0,12,12,0.0,1.0
5993,16,3,3,21,24,0.125,0.875
5979,16,3,0,33,33,0.0,1.0
5966,16,3,4,22,26,0.15384615384615385,0.8461538461538461
5967,16,3,3,98,101,0.0297029702970297,0.9702970297029703
5970,16,3,0,14,14,0.0,1.0
6188,16,3,0,3,3,0.0,1.0
6096,16,3,1,0,1,1.0,0.0
6069,16,3,0,17,17,0.0,1.0
5937,16,3,0,6,6,0.0,1.0
5990,16,3,0,50,50,0.0,1.0
5928,16,3,0,22,22,0.0,1.0
6058,16,3,4,65,69,0.057971014492753624,0.9420289855072463
6001,16,3,2,22,24,0.08333333333333333,0.9166666666666666
5964,16,3,0,10,10,0.0,1.0
5950,16,3,3,4,7,0.42857142857142855,0.5714285714285714
5991,16,3,0,20,20,0.0,1.0
6177,16,3,0,3,3,0.0,1.0
5961,16,3,0,45,45,0.0,1.0
5938,16,3,1,339,340,0.0029411764705882353,0.9970588235294118
5960,16,3,0,36,36,0.0,1.0
5947,16,3,0,78,78,0.0,1.0
5957,16,3,4,3,7,0.5714285714285714,0.42857142857142855
6043,16,3,0,29,29,0.0,1.0
6014,16,3,8,2,10,0.8,0.2
6015,16,3,1,1,2,0.5,0.5
5978,16,3,2,14,16,0.125,0.875
5986,16,3,3,1,4,0.75,0.25
5969,16,3,2,2,4,0.5,0.5
5949,16,3,0,30,30,0.0,1.0
5959,16,3,1,39,40,0.025,0.975
6051,16,3,0,108,108,0.0,1.0
6029,16,3,0,20,20,0.0,1.0
6070,16,3,3,1,4,0.75,0.25
5942,16,3,0,108,108,0.0,1.0
5953,16,3,0,28,28,0.0,1.0
6076,16,3,4,10,14,0.2857142857142857,0.7142857142857143
5940,16,3,4,5,9,0.4444444444444444,0.5555555555555556
6109,16,3,4,91,95,0.042105263157894736,0.9578947368421052
6187,16,3,2,4,6,0.3333333333333333,0.6666666666666666
6053,16,3,0,15,15,0.0,1.0
6104,16,3,2,2,4,0.5,0.5
5943,16,3,0,9,9,0.0,1.0
6168,16,3,0,240,240,0.0,1.0
5989,16,3,0,6,6,0.0,1.0
5963,16,3,2,18,20,0.1,0.9
6194,16,3,0,80,80,0.0,1.0
6003,16,3,0,238,238,0.0,1.0
6167,16,3,1,9,10,0.1,0.9
6004,16,3,2,133,135,0.014814814814814815,0.9851851851851852
6054,16,3,0,14,14,0.0,1.0
6170,16,3,5,29,34,0.14705882352941177,0.8529411764705882
6063,16,3,3,7,10,0.3,0.7
5988,16,3,0,17,17,0.0,1.0
6075,16,3,2,10,12,0.16666666666666666,0.8333333333333334
6061,16,3,0,26,26,0.0,1.0
5965,16,3,0,45,45,0.0,1.0
6040,16,3,6,6,12,0.5,0.5
6106,16,3,0,30,30,0.0,1.0
6082,16,3,0,13,13,0.0,1.0
6031,16,3,1,24,25,0.04,0.96
6039,16,3,1,57,58,0.017241379310344827,0.9827586206896551
6189,17,3,2,20,22,0.09090909090909091,0.9090909090909091
5936,17,3,0,31,31,0.0,1.0
6087,17,3,0,18,18,0.0,1.0
5973,17,3,0,34,34,0.0,1.0
6085,17,3,0,34,34,0.0,1.0
5948,17,3,0,42,42,0.0,1.0
5974,17,3,0,10,10,0.0,1.0
6090,17,3,0,1,1,0.0,1.0
6068,17,3,0,35,35,0.0,1.0
6024,17,3,1,1,2,0.5,0.5
5976,17,3,2,78,80,0.025,0.975
5962,17,3,0,59,59,0.0,1.0
6033,17,3,2,22,24,0.08333333333333333,0.9166666666666666
6038,17,3,0,7,7,0.0,1.0
6042,17,3,0,49,49,0.0,1.0
5924,17,3,0,50,50,0.0,1.0
6083,17,3,1,11,12,0.08333333333333333,0.9166666666666666
6178,17,3,0,225,225,0.0,1.0
6086,17,3,0,25,25,0.0,1.0
5945,17,3,0,95,95,0.0,1.0
5925,17,3,0,122,122,0.0,1.0
5935,17,3,0,3,3,0.0,1.0
6073,17,3,1,6,7,0.14285714285714285,0.8571428571428571
5980,17,3,0,12,12,0.0,1.0
5993,17,3,0,24,24,0.0,1.0
5979,17,3,0,33,33,0.0,1.0
5966,17,3,2,24,26,0.07692307692307693,0.9230769230769231
5967,17,3,3,98,101,0.0297029702970297,0.9702970297029703
5970,17,3,0,14,14,0.0,1.0
6188,17,3,0,3,3,0.0,1.0
6096,17,3,1,0,1,1.0,0.0
6069,17,3,0,17,17,0.0,1.0
5937,17,3,0,6,6,0.0,1.0
5990,17,3,0,50,50,0.0,1.0
5928,17,3,0,22,22,0.0,1.0
6058,17,3,5,64,69,0.07246376811594203,0.927536231884058
6001,17,3,2,22,24,0.08333333333333333,0.9166666666666666
5964,17,3,0,10,10,0.0,1.0
5950,17,3,1,6,7,0.14285714285714285,0.8571428571428571
5991,17,3,0,20,20,0.0,1.0
6177,17,3,0,3,3,0.0,1.0
5961,17,3,0,45,45,0.0,1.0
5938,17,3,1,339,340,0.0029411764705882353,0.9970588235294118
5960,17,3,0,36,36,0.0,1.0
5947,17,3,0,78,78,0.0,1.0
5957,17,3,4,3,7,0.5714285714285714,0.42857142857142855
6043,17,3,0,29,29,0.0,1.0
6014,17,3,9,1,10,0.9,0.1
6015,17,3,1,1,2,0.5,0.5
5978,17,3,2,14,16,0.125,0.875
5986,17,3,3,1,4,0.75,0.25
5969,17,3,0,4,4,0.0,1.0
5949,17,3,3,27,30,0.1,0.9
5959,17,3,7,33,40,0.175,0.825
6051,17,3,0,108,108,0.0,1.0
6029,17,3,0,20,20,0.0,1.0
6070,17,3,3,1,4,0.75,0.25
5942,17,3,0,108,108,0.0,1.0
5953,17,3,0,28,28,0.0,1.0
6076,17,3,2,12,14,0.14285714285714285,0.8571428571428571
5940,17,3,5,4,9,0.5555555555555556,0.4444444444444444
6109,17,3,1,94,95,0.010526315789473684,0.9894736842105263
6187,17,3,0,6,6,0.0,1.0
6053,17,3,0,15,15,0.0,1.0
6104,17,3,2,2,4,0.5,0.5
5943,17,3,0,9,9,0.0,1.0
6168,17,3,0,240,240,0.0,1.0
5989,17,3,0,6,6,0.0,1.0
5963,17,3,1,19,20,0.05,0.95
6194,17,3,0,80,80,0.0,1.0
6003,17,3,1,237,238,0.004201680672268907,0.9957983193277311
6167,17,3,1,9,10,0.1,0.9
6004,17,3,2,133,135,0.014814814814814815,0.9851851851851852
6054,17,3,0,14,14,0.0,1.0
6170,17,3,0,34,34,0.0,1.0
6063,17,3,6,4,10,0.6,0.4
5988,17,3,0,17,17,0.0,1.0
6075,17,3,1,11,12,0.08333333333333333,0.9166666666666666
6061,17,3,0,26,26,0.0,1.0
5965,17,3,0,45,45,0.0,1.0
6040,17,3,5,7,12,0.4166666666666667,0.5833333333333334
6106,17,3,1,29,30,0.03333333333333333,0.9666666666666667
6082,17,3,0,13,13,0.0,1.0
6031,17,3,2,23,25,0.08,0.92
6039,17,3,1,57,58,0.017241379310344827,0.9827586206896551
6189,18,3,0,22,22,0.0,1.0
5936,18,3,0,31,31,0.0,1.0
6087,18,3,0,18,18,0.0,1.0
5973,18,3,0,34,34,0.0,1.0
6085,18,3,0,34,34,0.0,1.0
5948,18,3,0,42,42,0.0,1.0
5974,18,3,0,10,10,0.0,1.0
6090,18,3,0,1,1,0.0,1.0
6068,18,3,0,35,35,0.0,1.0
6024,18,3,1,1,2,0.5,0.5
5976,18,3,3,77,80,0.0375,0.9625
5962,18,3,0,59,59,0.0,1.0
6033,18,3,2,22,24,0.08333333333333333,0.9166666666666666
6038,18,3,0,7,7,0.0,1.0
6042,18,3,0,49,49,0.0,1.0
5924,18,3,0,50,50,0.0,1.0
6083,18,3,2,10,12,0.16666666666666666,0.8333333333333334
6178,18,3,0,225,225,0.0,1.0
6086,18,3,0,25,25,0.0,1.0
5945,18,3,0,95,95,0.0,1.0
5925,18,3,0,122,122,0.0,1.0
5935,18,3,0,3,3,0.0,1.0
6073,18,3,1,6,7,0.14285714285714285,0.8571428571428571
5980,18,3,0,12,12,0.0,1.0
5993,18,3,0,24,24,0.0,1.0
5979,18,3,0,33,33,0.0,1.0
5966,18,3,0,26,26,0.0,1.0
5967,18,3,1,100,101,0.009900990099009901,0.9900990099009901
5970,18,3,0,14,14,0.0,1.0
6188,18,3,1,2,3,0.3333333333333333,0.6666666666666666
6096,18,3,1,0,1,1.0,0.0
6069,18,3,0,17,17,0.0,1.0
5937,18,3,0,6,6,0.0,1.0
5990,18,3,0,50,50,0.0,1.0
5928,18,3,0,22,22,0.0,1.0
6058,18,3,6,63,69,0.08695652173913043,0.9130434782608695
6001,18,3,2,22,24,0.08333333333333333,0.9166666666666666
5964,18,3,0,10,10,0.0,1.0
5950,18,3,0,7,7,0.0,1.0
5991,18,3,0,20,20,0.0,1.0
6177,18,3,0,3,3,0.0,1.0
5961,18,3,0,45,45,0.0,1.0
5938,18,3,1,339,340,0.0029411764705882353,0.9970588235294118
5960,18,3,0,36,36,0.0,1.0
5947,18,3,0,78,78,0.0,1.0
5957,18,3,2,5,7,0.2857142857142857,0.7142857142857143
6043,18,3,0,29,29,0.0,1.0
6014,18,3,7,3,10,0.7,0.3
6015,18,3,2,0,2,1.0,0.0
5978,18,3,1,15,16,0.0625,0.9375
5986,18,3,2,2,4,0.5,0.5
5969,18,3,0,4,4,0.0,1.0
5949,18,3,0,30,30,0.0,1.0
5959,18,3,1,39,40,0.025,0.975
6051,18,3,0,108,108,0.0,1.0
6029,18,3,0,20,20,0.0,1.0
6070,18,3,4,0,4,1.0,0.0
5942,18,3,0,108,108,0.0,1.0
5953,18,3,0,28,28,0.0,1.0
6076,18,3,0,14,14,0.0,1.0
5940,18,3,6,3,9,0.6666666666666666,0.3333333333333333
6109,18,3,0,95,95,0.0,1.0
6187,18,3,0,6,6,0.0,1.0
6053,18,3,0,15,15,0.0,1.0
6104,18,3,3,1,4,0.75,0.25
5943,18,3,0,9,9,0.0,1.0
6168,18,3,0,240,240,0.0,1.0
5989,18,3,0,6,6,0.0,1.0
5963,18,3,0,20,20,0.0,1.0
6194,18,3,0,80,80,0.0,1.0
6003,18,3,2,236,238,0.008403361344537815,0.9915966386554622
6167,18,3,0,10,10,0.0,1.0
6004,18,3,0,135,135,0.0,1.0
6054,18,3,0,14,14,0.0,1.0
6170,18,3,0,34,34,0.0,1.0
6063,18,3,3,7,10,0.3,0.7
5988,18,3,0,17,17,0.0,1.0
6075,18,3,1,11,12,0.08333333333333333,0.9166666666666666
6061,18,3,0,26,26,0.0,1.0
5965,18,3,0,45,45,0.0,1.0
6040,18,3,5,7,12,0.4166666666666667,0.5833333333333334
6106,18,3,1,29,30,0.03333333333333333,0.9666666666666667
6082,18,3,0,13,13,0.0,1.0
6031,18,3,1,24,25,0.04,0.96
6039,18,3,1,57,58,0.017241379310344827,0.9827586206896551
6189,19,3,4,18,22,0.18181818181818182,0.8181818181818182
5936,19,3,0,31,31,0.0,1.0
6087,19,3,0,18,18,0.0,1.0
5973,19,3,0,34,34,0.0,1.0
6085,19,3,0,34,34,0.0,1.0
5948,19,3,1,41,42,0.023809523809523808,0.9761904761904762
5974,19,3,0,10,10,0.0,1.0
6090,19,3,0,1,1,0.0,1.0
6068,19,3,0,35,35,0.0,1.0
6024,19,3,2,0,2,1.0,0.0
5976,19,3,3,77,80,0.0375,0.9625
5962,19,3,0,59,59,0.0,1.0
6033,19,3,0,24,24,0.0,1.0
6038,19,3,0,7,7,0.0,1.0
6042,19,3,0,49,49,0.0,1.0
5924,19,3,0,50,50,0.0,1.0
6083,19,3,2,10,12,0.16666666666666666,0.8333333333333334
6178,19,3,0,225,225,0.0,1.0
6086,19,3,0,25,25,0.0,1.0
5945,19,3,0,95,95,0.0,1.0
5925,19,3,0,122,122,0.0,1.0
5935,19,3,0,3,3,0.0,1.0
6073,19,3,0,7,7,0.0,1.0
5980,19,3,0,12,12,0.0,1.0
5993,19,3,0,24,24,0.0,1.0
5979,19,3,0,33,33,0.0,1.0
5966,19,3,1,25,26,0.038461538461538464,0.9615384615384616
5967,19,3,4,97,101,0.039603960396039604,0.9603960396039604
5970,19,3,0,14,14,0.0,1.0
6188,19,3,3,0,3,1.0,0.0
6096,19,3,1,0,1,1.0,0.0
6069,19,3,0,17,17,0.0,1.0
5937,19,3,0,6,6,0.0,1.0
5990,19,3,0,50,50,0.0,1.0
5928,19,3,0,22,22,0.0,1.0
6058,19,3,7,62,69,0.10144927536231885,0.8985507246376812
6001,19,3,5,19,24,0.20833333333333334,0.7916666666666666
5964,19,3,4,6,10,0.4,0.6
5950,19,3,1,6,7,0.14285714285714285,0.8571428571428571
5991,19,3,0,20,20,0.0,1.0
6177,19,3,0,3,3,0.0,1.0
5961,19,3,0,45,45,0.0,1.0
5938,19,3,0,340,340,0.0,1.0
5960,19,3,0,36,36,0.0,1.0
5947,19,3,0,78,78,0.0,1.0
5957,19,3,2,5,7,0.2857142857142857,0.7142857142857143
6043,19,3,0,29,29,0.0,1.0
6014,19,3,6,4,10,0.6,0.4
6015,19,3,1,1,2,0.5,0.5
5978,19,3,0,16,16,0.0,1.0
5986,19,3,2,2,4,0.5,0.5
5969,19,3,1,3,4,0.25,0.75
5949,19,3,0,30,30,0.0,1.0
5959,19,3,1,39,40,0.025,0.975
6051,19,3,0,108,108,0.0,1.0
6029,19,3,0,20,20,0.0,1.0
6070,19,3,4,0,4,1.0,0.0
5942,19,3,0,108,108,0.0,1.0
5953,19,3,0,28,28,0.0,1.0
6076,19,3,1,13,14,0.07142857142857142,0.9285714285714286
5940,19,3,3,6,9,0.3333333333333333,0.6666666666666666
6109,19,3,0,95,95,0.0,1.0
6187,19,3,0,6,6,0.0,1.0
6053,19,3,0,15,15,0.0,1.0
6104,19,3,3,1,4,0.75,0.25
5943,19,3,0,9,9,0.0,1.0
6168,19,3,0,240,240,0.0,1.0
5989,19,3,0,6,6,0.0,1.0
5963,19,3,1,19,20,0.05,0.95
6194,19,3,0,80,80,0.0,1.0
6003,19,3,1,237,238,0.004201680672268907,0.9957983193277311
6167,19,3,0,10,10,0.0,1.0
6004,19,3,1,134,135,0.007407407407407408,0.9925925925925926
6054,19,3,0,14,14,0.0,1.0
6170,19,3,1,33,34,0.029411764705882353,0.9705882352941176
6063,19,3,3,7,10,0.3,0.7
5988,19,3,0,17,17,0.0,1.0
6075,19,3,1,11,12,0.08333333333333333,0.9166666666666666
6061,19,3,0,26,26,0.0,1.0
5965,19,3,0,45,45,0.0,1.0
6040,19,3,7,5,12,0.5833333333333334,0.4166666666666667
6106,19,3,0,30,30,0.0,1.0
6082,19,3,0,13,13,0.0,1.0
6031,19,3,0,25,25,0.0,1.0
6039,19,3,4,54,58,0.06896551724137931,0.9310344827586207
6189,20,3,0,22,22,0.0,1.0
5936,20,3,0,31,31,0.0,1.0
6087,20,3,0,18,18,0.0,1.0
5973,20,3,0,34,34,0.0,1.0
6085,20,3,0,34,34,0.0,1.0
5948,20,3,1,41,42,0.023809523809523808,0.9761904761904762
5974,20,3,0,10,10,0.0,1.0
6090,20,3,0,1,1,0.0,1.0
6068,20,3,0,35,35,0.0,1.0
6024,20,3,1,1,2,0.5,0.5
5976,20,3,4,76,80,0.05,0.95
5962,20,3,0,59,59,0.0,1.0
6033,20,3,0,24,24,0.0,1.0
6038,20,3,0,7,7,0.0,1.0
6042,20,3,0,49,49,0.0,1.0
5924,20,3,0,50,50,0.0,1.0
6083,20,3,3,9,12,0.25,0.75
6178,20,3,0,225,225,0.0,1.0
6086,20,3,0,25,25,0.0,1.0
5945,20,3,0,95,95,0.0,1.0
5925,20,3,0,122,122,0.0,1.0
5935,20,3,0,3,3,0.0,1.0
6073,20,3,1,6,7,0.14285714285714285,0.8571428571428571
5980,20,3,0,12,12,0.0,1.0
5993,20,3,0,24,24,0.0,1.0
5979,20,3,0,33,33,0.0,1.0
5966,20,3,3,23,26,0.11538461538461539,0.8846153846153846
5967,20,3,2,99,101,0.019801980198019802,0.9801980198019802
5970,20,3,0,14,14,0.0,1.0
6188,20,3,0,3,3,0.0,1.0
6096,20,3,1,0,1,1.0,0.0
6069,20,3,0,17,17,0.0,1.0
5937,20,3,0,6,6,0.0,1.0
5990,20,3,0,50,50,0.0,1.0
5928,20,3,0,22,22,0.0,1.0
6058,20,3,4,65,69,0.057971014492753624,0.9420289855072463
6001,20,3,3,21,24,0.125,0.875
5964,20,3,1,9,10,0.1,0.9
5950,20,3,1,6,7,0.14285714285714285,0.8571428571428571
5991,20,3,0,20,20,0.0,1.0
6177,20,3,0,3,3,0.0,1.0
5961,20,3,0,45,45,0.0,1.0
5938,20,3,0,340,340,0.0,1.0
5960,20,3,0,36,36,0.0,1.0
5947,20,3,0,78,78,0.0,1.0
5957,20,3,1,6,7,0.14285714285714285,0.8571428571428571
6043,20,3,0,29,29,0.0,1.0
6014,20,3,6,4,10,0.6,0.4
6015,20,3,2,0,2,1.0,0.0
5978,20,3,0,16,16,0.0,1.0
5986,20,3,2,2,4,0.5,0.5
5969,20,3,1,3,4,0.25,0.75
5949,20,3,0,30,30,0.0,1.0
5959,20,3,1,39,40,0.025,0.975
6051,20,3,0,108,108,0.0,1.0
6029,20,3,0,20,20,0.0,1.0
6070,20,3,3,1,4,0.75,0.25
5942,20,3,0,108,108,0.0,1.0
5953,20,3,0,28,28,0.0,1.0
6076,20,3,6,8,14,0.42857142857142855,0.5714285714285714
5940,20,3,5,4,9,0.5555555555555556,0.4444444444444444
6109,20,3,1,94,95,0.010526315789473684,0.9894736842105263
6187,20,3,0,6,6,0.0,1.0
6053,20,3,0,15,15,0.0,1.0
6104,20,3,3,1,4,0.75,0.25
5943,20,3,0,9,9,0.0,1.0
6168,20,3,0,240,240,0.0,1.0
5989,20,3,0,6,6,0.0,1.0
5963,20,3,0,20,20,0.0,1.0
6194,20,3,0,80,80,0.0,1.0
6003,20,3,1,237,238,0.004201680672268907,0.9957983193277311
6167,20,3,1,9,10,0.1,0.9
6004,20,3,0,135,135,0.0,1.0
6054,20,3,0,14,14,0.0,1.0
6170,20,3,1,33,34,0.029411764705882353,0.9705882352941176
6063,20,3,3,7,10,0.3,0.7
5988,20,3,0,17,17,0.0,1.0
6075,20,3,0,12,12,0.0,1.0
6061,20,3,0,26,26,0.0,1.0
5965,20,3,0,45,45,0.0,1.0
6040,20,3,2,10,12,0.16666666666666666,0.8333333333333334
6106,20,3,1,29,30,0.03333333333333333,0.9666666666666667
6082,20,3,0,13,13,0.0,1.0
6031,20,3,0,25,25,0.0,1.0
6039,20,3,3,55,58,0.05172413793103448,0.9482758620689655
6189,21,3,0,22,22,0.0,1.0
5936,21,3,0,31,31,0.0,1.0
6087,21,3,0,18,18,0.0,1.0
5973,21,3,0,34,34,0.0,1.0
6085,21,3,0,34,34,0.0,1.0
5948,21,3,0,42,42,0.0,1.0
5974,21,3,0,10,10,0.0,1.0
6090,21,3,0,1,1,0.0,1.0
6068,21,3,0,35,35,0.0,1.0
6024,21,3,2,0,2,1.0,0.0
5976,21,3,2,78,80,0.025,0.975
5962,21,3,0,59,59,0.0,1.0
6033,21,3,2,22,24,0.08333333333333333,0.9166666666666666
6038,21,3,0,7,7,0.0,1.0
6042,21,3,0,49,49,0.0,1.0
5924,21,3,0,50,50,0.0,1.0
6083,21,3,1,11,12,0.08333333333333333,0.9166666666666666
6178,21,3,0,225,225,0.0,1.0
6086,21,3,0,25,25,0.0,1.0
5945,21,3,0,95,95,0.0,1.0
5925,21,3,0,122,122,0.0,1.0
5935,21,3,0,3,3,0.0,1.0
6073,21,3,1,6,7,0.14285714285714285,0.8571428571428571
5980,21,3,0,12,12,0.0,1.0
5993,21,3,0,24,24,0.0,1.0
5979,21,3,0,33,33,0.0,1.0
5966,21,3,2,24,26,0.07692307692307693,0.9230769230769231
5967,21,3,2,99,101,0.019801980198019802,0.9801980198019802
5970,21,3,0,14,14,0.0,1.0
6188,21,3,2,1,3,0.6666666666666666,0.3333333333333333
6096,21,3,1,0,1,1.0,0.0
6069,21,3,0,17,17,0.0,1.0
5937,21,3,0,6,6,0.0,1.0
5990,21,3,0,50,50,0.0,1.0
5928,21,3,0,22,22,0.0,1.0
6058,21,3,5,64,69,0.07246376811594203,0.927536231884058
6001,21,3,4,20,24,0.16666666666666666,0.8333333333333334
5964,21,3,1,9,10,0.1,0.9
5950,21,3,1,6,7,0.14285714285714285,0.8571428571428571
5991,21,3,0,20,20,0.0,1.0
6177,21,3,0,3,3,0.0,1.0
5961,21,3,0,45,45,0.0,1.0
5938,21,3,3,337,340,0.008823529411764706,0.9911764705882353
5960,21,3,0,36,36,0.0,1.0
5947,21,3,0,78,78,0.0,1.0
5957,21,3,1,6,7,0.14285714285714285,0.8571428571428571
6043,21,3,0,29,29,0.0,1.0
6014,21,3,6,4,10,0.6,0.4
6015,21,3,1,1,2,0.5,0.5
5978,21,3,2,14,16,0.125,0.875
5986,21,3,2,2,4,0.5,0.5
5969,21,3,0,4,4,0.0,1.0
5949,21,3,0,30,30,0.0,1.0
5959,21,3,1,39,40,0.025,0.975
6051,21,3,0,108,108,0.0,1.0
6029,21,3,1,19,20,0.05,0.95
6070,21,3,1,3,4,0.25,0.75
5942,21,3,0,108,108,0.0,1.0
5953,21,3,0,28,28,0.0,1.0
6076,21,3,1,13,14,0.07142857142857142,0.9285714285714286
5940,21,3,5,4,9,0.5555555555555556,0.4444444444444444
6109,21,3,3,92,95,0.031578947368421054,0.968421052631579
6187,21,3,2,4,6,0.3333333333333333,0.6666666666666666
6053,21,3,0,15,15,0.0,1.0
6104,21,3,2,2,4,0.5,0.5
5943,21,3,0,9,9,0.0,1.0
6168,21,3,0,240,240,0.0,1.0
5989,21,3,0,6,6,0.0,1.0
5963,21,3,3,17,20,0.15,0.85
6194,21,3,0,80,80,0.0,1.0
6003,21,3,1,237,238,0.004201680672268907,0.9957983193277311
6167,21,3,1,9,10,0.1,0.9
6004,21,3,0,135,135,0.0,1.0
6054,21,3,0,14,14,0.0,1.0
6170,21,3,1,33,34,0.029411764705882353,0.9705882352941176
6063,21,3,3,7,10,0.3,0.7
5988,21,3,0,17,17,0.0,1.0
6075,21,3,1,11,12,0.08333333333333333,0.9166666666666666
6061,21,3,0,26,26,0.0,1.0
5965,21,3,0,45,45,0.0,1.0
6040,21,3,3,9,12,0.25,0.75
6106,21,3,1,29,30,0.03333333333333333,0.9666666666666667
6082,21,3,0,13,13,0.0,1.0
6031,21,3,0,25,25,0.0,1.0
6039,21,3,1,57,58,0.017241379310344827,0.9827586206896551
6189,22,3,0,22,22,0.0,1.0
5936,22,3,0,31,31,0.0,1.0
6087,22,3,0,18,18,0.0,1.0
5973,22,3,0,34,34,0.0,1.0
6085,22,3,0,34,34,0.0,1.0
5948,22,3,0,42,42,0.0,1.0
5974,22,3,0,10,10,0.0,1.0
6090,22,3,0,1,1,0.0,1.0
6068,22,3,0,35,35,0.0,1.0
6024,22,3,2,0,2,1.0,0.0
5976,22,3,1,79,80,0.0125,0.9875
5962,22,3,0,59,59,0.0,1.0
6033,22,3,6,18,24,0.25,0.75
6038,22,3,0,7,7,0.0,1.0
6042,22,3,0,49,49,0.0,1.0
5924,22,3,0,50,50,0.0,1.0
6083,22,3,5,7,12,0.4166666666666667,0.5833333333333334
6178,22,3,0,225,225,0.0,1.0
6086,22,3,0,25,25,0.0,1.0
5945,22,3,0,95,95,0.0,1.0
5925,22,3,0,122,122,0.0,1.0
5935,22,3,0,3,3,0.0,1.0
6073,22,3,3,4,7,0.42857142857142855,0.5714285714285714
5980,22,3,0,12,12,0.0,1.0
5993,22,3,0,24,24,0.0,1.0
5979,22,3,0,33,33,0.0,1.0
5966,22,3,0,26,26,0.0,1.0
5967,22,3,1,100,101,0.009900990099009901,0.9900990099009901
5970,22,3,0,14,14,0.0,1.0
6188,22,3,2,1,3,0.6666666666666666,0.3333333333333333
6096,22,3,1,0,1,1.0,0.0
6069,22,3,0,17,17,0.0,1.0
5937,22,3,0,6,6,0.0,1.0
5990,22,3,0,50,50,0.0,1.0
5928,22,3,0,22,22,0.0,1.0
6058,22,3,0,69,69,0.0,1.0
6001,22,3,3,21,24,0.125,0.875
5964,22,3,0,10,10,0.0,1.0
5950,22,3,0,7,7,0.0,1.0
5991,22,3,0,20,20,0.0,1.0
6177,22,3,0,3,3,0.0,1.0
5961,22,3,0,45,45,0.0,1.0
5938,22,3,0,340,340,0.0,1.0
5960,22,3,0,36,36,0.0,1.0
5947,22,3,0,78,78,0.0,1.0
5957,22,3,0,7,7,0.0,1.0
6043,22,3,0,29,29,0.0,1.0
6014,22,3,4,6,10,0.4,0.6
6015,22,3,1,1,2,0.5,0.5
5978,22,3,1,15,16,0.0625,0.9375
5986,22,3,1,3,4,0.25,0.75
5969,22,3,1,3,4,0.25,0.75
5949,22,3,0,30,30,0.0,1.0
5959,22,3,1,39,40,0.025,0.975
6051,22,3,0,108,108,0.0,1.0
6029,22,3,0,20,20,0.0,1.0
6070,22,3,1,3,4,0.25,0.75
5942,22,3,0,108,108,0.0,1.0
5953,22,3,0,28,28,0.0,1.0
6076,22,3,0,14,14,0.0,1.0
5940,22,3,3,6,9,0.3333333333333333,0.6666666666666666
6109,22,3,1,94,95,0.010526315789473684,0.9894736842105263
6187,22,3,2,4,6,0.3333333333333333,0.6666666666666666
6053,22,3,0,15,15,0.0,1.0
6104,22,3,2,2,4,0.5,0.5
5943,22,3,0,9,9,0.0,1.0
6168,22,3,0,240,240,0.0,1.0
5989,22,3,0,6,6,0.0,1.0
5963,22,3,0,20,20,0.0,1.0
6194,22,3,0,80,80,0.0,1.0
6003,22,3,0,238,238,0.0,1.0
6167,22,3,0,10,10,0.0,1.0
6004,22,3,1,134,135,0.007407407407407408,0.9925925925925926
6054,22,3,0,14,14,0.0,1.0
6170,22,3,0,34,34,0.0,1.0
6063,22,3,3,7,10,0.3,0.7
5988,22,3,0,17,17,0.0,1.0
6075,22,3,0,12,12,0.0,1.0
6061,22,3,0,26,26,0.0,1.0
5965,22,3,0,45,45,0.0,1.0
6040,22,3,4,8,12,0.3333333333333333,0.6666666666666666
6106,22,3,2,28,30,0.06666666666666667,0.9333333333333333
6082,22,3,2,11,13,0.15384615384615385,0.8461538461538461
6031,22,3,2,23,25,0.08,0.92
6039,22,3,1,57,58,0.017241379310344827,0.9827586206896551
6189,23,3,0,22,22,0.0,1.0
5936,23,3,0,31,31,0.0,1.0
6087,23,3,0,18,18,0.0,1.0
5973,23,3,0,34,34,0.0,1.0
6085,23,3,0,34,34,0.0,1.0
5948,23,3,0,42,42,0.0,1.0
5974,23,3,0,10,10,0.0,1.0
6090,23,3,0,1,1,0.0,1.0
6068,23,3,0,35,35,0.0,1.0
6024,23,3,1,1,2,0.5,0.5
5976,23,3,0,80,80,0.0,1.0
5962,23,3,0,59,59,0.0,1.0
6033,23,3,7,17,24,0.2916666666666667,0.7083333333333334
6038,23,3,0,7,7,0.0,1.0
6042,23,3,0,49,49,0.0,1.0
5924,23,3,0,50,50,0.0,1.0
6083,23,3,1,11,12,0.08333333333333333,0.9166666666666666
6178,23,3,0,225,225,0.0,1.0
6086,23,3,0,25,25,0.0,1.0
5945,23,3,0,95,95,0.0,1.0
5925,23,3,0,122,122,0.0,1.0
5935,23,3,0,3,3,0.0,1.0
6073,23,3,1,6,7,0.14285714285714285,0.8571428571428571
5980,23,3,0,12,12,0.0,1.0
5993,23,3,0,24,24,0.0,1.0
5979,23,3,0,33,33,0.0,1.0
5966,23,3,0,26,26,0.0,1.0
5967,23,3,0,101,101,0.0,1.0
5970,23,3,0,14,14,0.0,1.0
6188,23,3,0,3,3,0.0,1.0
6096,23,3,1,0,1,1.0,0.0
6069,23,3,0,17,17,0.0,1.0
5937,23,3,0,6,6,0.0,1.0
5990,23,3,0,50,50,0.0,1.0
5928,23,3,0,22,22,0.0,1.0
6058,23,3,3,66,69,0.043478260869565216,0.9565217391304348
6001,23,3,3,21,24,0.125,0.875
5964,23,3,0,10,10,0.0,1.0
5950,23,3,1,6,7,0.14285714285714285,0.8571428571428571
5991,23,3,0,20,20,0.0,1.0
6177,23,3,0,3,3,0.0,1.0
5961,23,3,0,45,45,0.0,1.0
5938,23,3,0,340,340,0.0,1.0
5960,23,3,0,36,36,0.0,1.0
5947,23,3,0,78,78,0.0,1.0
5957,23,3,1,6,7,0.14285714285714285,0.8571428571428571
6043,23,3,0,29,29,0.0,1.0
6014,23,3,8,2,10,0.8,0.2
6015,23,3,1,1,2,0.5,0.5
5978,23,3,0,16,16,0.0,1.0
5986,23,3,2,2,4,0.5,0.5
5969,23,3,0,4,4,0.0,1.0
5949,23,3,0,30,30,0.0,1.0
5959,23,3,0,40,40,0.0,1.0
6051,23,3,0,108,108,0.0,1.0
6029,23,3,1,19,20,0.05,0.95
6070,23,3,1,3,4,0.25,0.75
5942,23,3,0,108,108,0.0,1.0
5953,23,3,0,28,28,0.0,1.0
6076,23,3,0,14,14,0.0,1.0
5940,23,3,3,6,9,0.3333333333333333,0.6666666666666666
6109,23,3,1,94,95,0.010526315789473684,0.9894736842105263
6187,23,3,0,6,6,0.0,1.0
6053,23,3,0,15,15,0.0,1.0
6104,23,3,2,2,4,0.5,0.5
5943,23,3,0,9,9,0.0,1.0
6168,23,3,0,240,240,0.0,1.0
5989,23,3,0,6,6,0.0,1.0
5963,23,3,1,19,20,0.05,0.95
6194,23,3,0,80,80,0.0,1.0
6003,23,3,0,238,238,0.0,1.0
6167,23,3,0,10,10,0.0,1.0
6004,23,3,1,134,135,0.007407407407407408,0.9925925925925926
6054,23,3,0,14,14,0.0,1.0
6170,23,3,1,33,34,0.029411764705882353,0.9705882352941176
6063,23,3,1,9,10,0.1,0.9
5988,23,3,0,17,17,0.0,1.0
6075,23,3,2,10,12,0.16666666666666666,0.8333333333333334
6061,23,3,0,26,26,0.0,1.0
5965,23,3,0,45,45,0.0,1.0
6040,23,3,3,9,12,0.25,0.75
6106,23,3,0,30,30,0.0,1.0
6082,23,3,2,11,13,0.15384615384615385,0.8461538461538461
6031,23,3,1,24,25,0.04,0.96
6039,23,3,1,57,58,0.017241379310344827,0.9827586206896551
6189,24,3,0,22,22,0.0,1.0
5936,24,3,0,31,31,0.0,1.0
6087,24,3,0,18,18,0.0,1.0
5973,24,3,0,34,34,0.0,1.0
6085,24,3,0,34,34,0.0,1.0
5948,24,3,0,42,42,0.0,1.0
5974,24,3,0,10,10,0.0,1.0
6090,24,3,0,1,1,0.0,1.0
6068,24,3,0,35,35,0.0,1.0
6024,24,3,1,1,2,0.5,0.5
5976,24,3,2,78,80,0.025,0.975
5962,24,3,0,59,59,0.0,1.0
6033,24,3,0,24,24,0.0,1.0
6038,24,3,0,7,7,0.0,1.0
6042,24,3,0,49,49,0.0,1.0
5924,24,3,0,50,50,0.0,1.0
6083,24,3,3,9,12,0.25,0.75
6178,24,3,0,225,225,0.0,1.0
6086,24,3,0,25,25,0.0,1.0
5945,24,3,0,95,95,0.0,1.0
5925,24,3,0,122,122,0.0,1.0
5935,24,3,0,3,3,0.0,1.0
6073,24,3,1,6,7,0.14285714285714285,0.8571428571428571
5980,24,3,2,10,12,0.16666666666666666,0.8333333333333334
5993,24,3,0,24,24,0.0,1.0
5979,24,3,0,33,33,0.0,1.0
5966,24,3,3,23,26,0.11538461538461539,0.8846153846153846
5967,24,3,0,101,101,0.0,1.0
5970,24,3,0,14,14,0.0,1.0
6188,24,3,1,2,3,0.3333333333333333,0.6666666666666666
6096,24,3,1,0,1,1.0,0.0
6069,24,3,0,17,17,0.0,1.0
5937,24,3,0,6,6,0.0,1.0
5990,24,3,0,50,50,0.0,1.0
5928,24,3,0,22,22,0.0,1.0
6058,24,3,5,64,69,0.07246376811594203,0.927536231884058
6001,24,3,1,23,24,0.041666666666666664,0.9583333333333334
5964,24,3,1,9,10,0.1,0.9
5950,24,3,1,6,7,0.14285714285714285,0.8571428571428571
5991,24,3,0,20,20,0.0,1.0
6177,24,3,0,3,3,0.0,1.0
5961,24,3,0,45,45,0.0,1.0
5938,24,3,0,340,340,0.0,1.0
5960,24,3,0,36,36,0.0,1.0
5947,24,3,0,78,78,0.0,1.0
5957,24,3,4,3,7,0.5714285714285714,0.42857142857142855
6043,24,3,0,29,29,0.0,1.0
6014,24,3,5,5,10,0.5,0.5
6015,24,3,2,0,2,1.0,0.0
5978,24,3,0,16,16,0.0,1.0
5986,24,3,3,1,4,0.75,0.25
5969,24,3,0,4,4,0.0,1.0
5949,24,3,0,30,30,0.0,1.0
5959,24,3,1,39,40,0.025,0.975
6051,24,3,0,108,108,0.0,1.0
6029,24,3,1,19,20,0.05,0.95
6070,24,3,2,2,4,0.5,0.5
5942,24,3,0,108,108,0.0,1.0
5953,24,3,0,28,28,0.0,1.0
6076,24,3,1,13,14,0.07142857142857142,0.9285714285714286
5940,24,3,3,6,9,0.3333333333333333,0.6666666666666666
6109,24,3,1,94,95,0.010526315789473684,0.9894736842105263
6187,24,3,0,6,6,0.0,1.0
6053,24,3,0,15,15,0.0,1.0
6104,24,3,2,2,4,0.5,0.5
5943,24,3,0,9,9,0.0,1.0
6168,24,3,0,240,240,0.0,1.0
5989,24,3,0,6,6,0.0,1.0
5963,24,3,0,20,20,0.0,1.0
6194,24,3,0,80,80,0.0,1.0
6003,24,3,0,238,238,0.0,1.0
6167,24,3,1,9,10,0.1,0.9
6004,24,3,1,134,135,0.007407407407407408,0.9925925925925926
6054,24,3,0,14,14,0.0,1.0
6170,24,3,0,34,34,0.0,1.0
6063,24,3,3,7,10,0.3,0.7
5988,24,3,0,17,17,0.0,1.0
6075,24,3,1,11,12,0.08333333333333333,0.9166666666666666
6061,24,3,0,26,26,0.0,1.0
5965,24,3,0,45,45,0.0,1.0
6040,24,3,4,8,12,0.3333333333333333,0.6666666666666666
6106,24,3,0,30,30,0.0,1.0
6082,24,3,0,13,13,0.0,1.0
6031,24,3,0,25,25,0.0,1.0
6039,24,3,3,55,58,0.05172413793103448,0.9482758620689655
6189,25,3,1,21,22,0.045454545454545456,0.9545454545454546
5936,25,3,0,31,31,0.0,1.0
6087,25,3,0,18,18,0.0,1.0
5973,25,3,0,34,34,0.0,1.0
6085,25,3,0,34,34,0.0,1.0
5948,25,3,0,42,42,0.0,1.0
5974,25,3,0,10,10,0.0,1.0
6090,25,3,0,1,1,0.0,1.0
6068,25,3,0,35,35,0.0,1.0
6024,25,3,1,1,2,0.5,0.5
5976,25,3,1,79,80,0.0125,0.9875
5962,25,3,0,59,59,0.0,1.0
6033,25,3,2,22,24,0.08333333333333333,0.9166666666666666
6038,25,3,0,7,7,0.0,1.0
6042,25,3,0,49,49,0.0,1.0
5924,25,3,0,50,50,0.0,1.0
6083,25,3,2,10,12,0.16666666666666666,0.8333333333333334
6178,25,3,0,225,225,0.0,1.0
6086,25,3,0,25,25,0.0,1.0
5945,25,3,0,95,95,0.0,1.0
5925,25,3,0,122,122,0.0,1.0
5935,25,3,0,3,3,0.0,1.0
6073,25,3,2,5,7,0.2857142857142857,0.7142857142857143
5980,25,3,0,12,12,0.0,1.0
5993,25,3,0,24,24,0.0,1.0
5979,25,3,0,33,33,0.0,1.0
5966,25,3,0,26,26,0.0,1.0
5967,25,3,0,101,101,0.0,1.0
5970,25,3,0,14,14,0.0,1.0
6188,25,3,0,3,3,0.0,1.0
6096,25,3,1,0,1,1.0,0.0
6069,25,3,0,17,17,0.0,1.0
5937,25,3,0,6,6,0.0,1.0
5990,25,3,0,50,50,0.0,1.0
5928,25,3,0,22,22,0.0,1.0
6058,25,3,4,65,69,0.057971014492753624,0.9420289855072463
6001,25,3,3,21,24,0.125,0.875
5964,25,3,1,9,10,0.1,0.9
5950,25,3,1,6,7,0.14285714285714285,0.8571428571428571
5991,25,3,0,20,20,0.0,1.0
6177,25,3,0,3,3,0.0,1.0
5961,25,3,0,45,45,0.0,1.0
5938,25,3,0,340,340,0.0,1.0
5960,25,3,0,36,36,0.0,1.0
5947,25,3,0,78,78,0.0,1.0
5957,25,3,2,5,7,0.2857142857142857,0.7142857142857143
6043,25,3,0,29,29,0.0,1.0
6014,25,3,3,7,10,0.3,0.7
6015,25,3,1,1,2,0.5,0.5
5978,25,3,1,15,16,0.0625,0.9375
5986,25,3,3,1,4,0.75,0.25
5969,25,3,0,4,4,0.0,1.0
5949,25,3,0,30,30,0.0,1.0
5959,25,3,0,40,40,0.0,1.0
6051,25,3,0,108,108,0.0,1.0
6029,25,3,1,19,20,0.05,0.95
6070,25,3,2,2,4,0.5,0.5
5942,25,3,0,108,108,0.0,1.0
5953,25,3,0,28,28,0.0,1.0
6076,25,3,0,14,14,0.0,1.0
5940,25,3,3,6,9,0.3333333333333333,0.6666666666666666
6109,25,3,0,95,95,0.0,1.0
6187,25,3,2,4,6,0.3333333333333333,0.6666666666666666
6053,25,3,0,15,15,0.0,1.0
6104,25,3,3,1,4,0.75,0.25
5943,25,3,0,9,9,0.0,1.0
6168,25,3,0,240,240,0.0,1.0
5989,25,3,0,6,6,0.0,1.0
5963,25,3,1,19,20,0.05,0.95
6194,25,3,0,80,80,0.0,1.0
6003,25,3,1,237,238,0.004201680672268907,0.9957983193277311
6167,25,3,0,10,10,0.0,1.0
6004,25,3,5,130,135,0.037037037037037035,0.9629629629629629
6054,25,3,0,14,14,0.0,1.0
6170,25,3,1,33,34,0.029411764705882353,0.9705882352941176
6063,25,3,2,8,10,0.2,0.8
5988,25,3,0,17,17,0.0,1.0
6075,25,3,0,12,12,0.0,1.0
6061,25,3,0,26,26,0.0,1.0
5965,25,3,0,45,45,0.0,1.0
6040,25,3,5,7,12,0.4166666666666667,0.5833333333333334
6106,25,3,1,29,30,0.03333333333333333,0.9666666666666667
6082,25,3,0,13,13,0.0,1.0
6031,25,3,0,25,25,0.0,1.0
6039,25,3,1,57,58,0.017241379310344827,0.9827586206896551
6189,26,3,0,22,22,0.0,1.0
5936,26,3,0,31,31,0.0,1.0
6087,26,3,0,18,18,0.0,1.0
5973,26,3,0,34,34,0.0,1.0
6085,26,3,0,34,34,0.0,1.0
5948,26,3,1,41,42,0.023809523809523808,0.9761904761904762
5974,26,3,0,10,10,0.0,1.0
6090,26,3,0,1,1,0.0,1.0
6068,26,3,0,35,35,0.0,1.0
6024,26,3,2,0,2,1.0,0.0
5976,26,3,1,79,80,0.0125,0.9875
5962,26,3,0,59,59,0.0,1.0
6033,26,3,2,22,24,0.08333333333333333,0.9166666666666666
6038,26,3,0,7,7,0.0,1.0
6042,26,3,0,49,49,0.0,1.0
5924,26,3,0,50,50,0.0,1.0
6083,26,3,4,8,12,0.3333333333333333,0.6666666666666666
6178,26,3,0,225,225,0.0,1.0
6086,26,3,0,25,25,0.0,1.0
5945,26,3,0,95,95,0.0,1.0
5925,26,3,0,122,122,0.0,1.0
5935,26,3,0,3,3,0.0,1.0
6073,26,3,1,6,7,0.14285714285714285,0.8571428571428571
5980,26,3,0,12,12,0.0,1.0
5993,26,3,0,24,24,0.0,1.0
5979,26,3,0,33,33,0.0,1.0
5966,26,3,0,26,26,0.0,1.0
5967,26,3,0,101,101,0.0,1.0
5970,26,3,0,14,14,0.0,1.0
6188,26,3,1,2,3,0.3333333333333333,0.6666666666666666
6096,26,3,1,0,1,1.0,0.0
6069,26,3,0,17,17,0.0,1.0
5937,26,3,0,6,6,0.0,1.0
5990,26,3,0,50,50,0.0,1.0
5928,26,3,0,22,22,0.0,1.0
6058,26,3,3,66,69,0.043478260869565216,0.9565217391304348
6001,26,3,2,22,24,0.08333333333333333,0.9166666666666666
5964,26,3,0,10,10,0.0,1.0
5950,26,3,0,7,7,0.0,1.0
5991,26,3,0,20,20,0.0,1.0
6177,26,3,0,3,3,0.0,1.0
5961,26,3,0,45,45,0.0,1.0
5938,26,3,0,340,340,0.0,1.0
5960,26,3,0,36,36,0.0,1.0
5947,26,3,0,78,78,0.0,1.0
5957,26,3,1,6,7,0.14285714285714285,0.8571428571428571
6043,26,3,0,29,29,0.0,1.0
6014,26,3,6,4,10,0.6,0.4
6015,26,3,1,1,2,0.5,0.5
5978,26,3,1,15,16,0.0625,0.9375
5986,26,3,1,3,4,0.25,0.75
5969,26,3,0,4,4,0.0,1.0
5949,26,3,0,30,30,0.0,1.0
5959,26,3,0,40,40,0.0,1.0
6051,26,3,0,108,108,0.0,1.0
6029,26,3,1,19,20,0.05,0.95
6070,26,3,0,4,4,0.0,1.0
5942,26,3,0,108,108,0.0,1.0
5953,26,3,0,28,28,0.0,1.0
6076,26,3,0,14,14,0.0,1.0
5940,26,3,4,5,9,0.4444444444444444,0.5555555555555556
6109,26,3,0,95,95,0.0,1.0
6187,26,3,0,6,6,0.0,1.0
6053,26,3,0,15,15,0.0,1.0
6104,26,3,1,3,4,0.25,0.75
5943,26,3,0,9,9,0.0,1.0
6168,26,3,0,240,240,0.0,1.0
5989,26,3,0,6,6,0.0,1.0
5963,26,3,0,20,20,0.0,1.0
6194,26,3,0,80,80,0.0,1.0
6003,26,3,1,237,238,0.004201680672268907,0.9957983193277311
6167,26,3,0,10,10,0.0,1.0
6004,26,3,0,135,135,0.0,1.0
6054,26,3,0,14,14,0.0,1.0
6170,26,3,1,33,34,0.029411764705882353,0.9705882352941176
6063,26,3,3,7,10,0.3,0.7
5988,26,3,0,17,17,0.0,1.0
6075,26,3,1,11,12,0.08333333333333333,0.9166666666666666
6061,26,3,0,26,26,0.0,1.0
5965,26,3,0,45,45,0.0,1.0
6040,26,3,3,9,12,0.25,0.75
6106,26,3,2,28,30,0.06666666666666667,0.9333333333333333
6082,26,3,2,11,13,0.15384615384615385,0.8461538461538461
6031,26,3,1,24,25,0.04,0.96
6039,26,3,0,58,58,0.0,1.0
6189,27,3,0,22,22,0.0,1.0
5936,27,3,0,31,31,0.0,1.0
6087,27,3,0,18,18,0.0,1.0
5973,27,3,0,34,34,0.0,1.0
6085,27,3,0,34,34,0.0,1.0
5948,27,3,0,42,42,0.0,1.0
5974,27,3,0,10,10,0.0,1.0
6090,27,3,0,1,1,0.0,1.0
6068,27,3,0,35,35,0.0,1.0
6024,27,3,1,1,2,0.5,0.5
5976,27,3,1,79,80,0.0125,0.9875
5962,27,3,0,59,59,0.0,1.0
6033,27,3,0,24,24,0.0,1.0
6038,27,3,0,7,7,0.0,1.0
6042,27,3,0,49,49,0.0,1.0
5924,27,3,0,50,50,0.0,1.0
6083,27,3,1,11,12,0.08333333333333333,0.9166666666666666
6178,27,3,0,225,225,0.0,1.0
6086,27,3,0,25,25,0.0,1.0
5945,27,3,0,95,95,0.0,1.0
5925,27,3,0,122,122,0.0,1.0
5935,27,3,0,3,3,0.0,1.0
6073,27,3,3,4,7,0.42857142857142855,0.5714285714285714
5980,27,3,0,12,12,0.0,1.0
5993,27,3,0,24,24,0.0,1.0
5979,27,3,0,33,33,0.0,1.0
5966,27,3,0,26,26,0.0,1.0
5967,27,3,1,100,101,0.009900990099009901,0.9900990099009901
5970,27,3,0,14,14,0.0,1.0
6188,27,3,1,2,3,0.3333333333333333,0.6666666666666666
6096,27,3,1,0,1,1.0,0.0
6069,27,3,0,17,17,0.0,1.0
5937,27,3,0,6,6,0.0,1.0
5990,27,3,0,50,50,0.0,1.0
5928,27,3,0,22,22,0.0,1.0
6058,27,3,2,67,69,0.028985507246376812,0.9710144927536232
6001,27,3,4,20,24,0.16666666666666666,0.8333333333333334
5964,27,3,1,9,10,0.1,0.9
5950,27,3,1,6,7,0.14285714285714285,0.8571428571428571
5991,27,3,0,20,20,0.0,1.0
6177,27,3,0,3,3,0.0,1.0
5961,27,3,0,45,45,0.0,1.0
5938,27,3,0,340,340,0.0,1.0
5960,27,3,0,36,36,0.0,1.0
5947,27,3,0,78,78,0.0,1.0
5957,27,3,2,5,7,0.2857142857142857,0.7142857142857143
6043,27,3,0,29,29,0.0,1.0
6014,27,3,2,8,10,0.2,0.8
6015,27,3,1,1,2,0.5,0.5
5978,27,3,0,16,16,0.0,1.0
5986,27,3,4,0,4,1.0,0.0
5969,27,3,0,4,4,0.0,1.0
5949,27,3,0,30,30,0.0,1.0
5959,27,3,3,37,40,0.075,0.925
6051,27,3,0,108,108,0.0,1.0
6029,27,3,0,20,20,0.0,1.0
6070,27,3,0,4,4,0.0,1.0
5942,27,3,0,108,108,0.0,1.0
5953,27,3,0,28,28,0.0,1.0
6076,27,3,1,13,14,0.07142857142857142,0.9285714285714286
5940,27,3,5,4,9,0.5555555555555556,0.4444444444444444
6109,27,3,1,94,95,0.010526315789473684,0.9894736842105263
6187,27,3,0,6,6,0.0,1.0
6053,27,3,0,15,15,0.0,1.0
6104,27,3,4,0,4,1.0,0.0
5943,27,3,0,9,9,0.0,1.0
6168,27,3,0,240,240,0.0,1.0
5989,27,3,0,6,6,0.0,1.0
5963,27,3,0,20,20,0.0,1.0
6194,27,3,0,80,80,0.0,1.0
6003,27,3,1,237,238,0.004201680672268907,0.9957983193277311
6167,27,3,0,10,10,0.0,1.0
6004,27,3,5,130,135,0.037037037037037035,0.9629629629629629
6054,27,3,0,14,14,0.0,1.0
6170,27,3,3,31,34,0.08823529411764706,0.9117647058823529
6063,27,3,4,6,10,0.4,0.6
5988,27,3,0,17,17,0.0,1.0
6075,27,3,1,11,12,0.08333333333333333,0.9166666666666666
6061,27,3,0,26,26,0.0,1.0
5965,27,3,0,45,45,0.0,1.0
6040,27,3,2,10,12,0.16666666666666666,0.8333333333333334
6106,27,3,2,28,30,0.06666666666666667,0.9333333333333333
6082,27,3,0,13,13,0.0,1.0
6031,27,3,2,23,25,0.08,0.92
6039,27,3,0,58,58,0.0,1.0
6189,28,3,0,22,22,0.0,1.0
5936,28,3,0,31,31,0.0,1.0
6087,28,3,0,18,18,0.0,1.0
5973,28,3,0,34,34,0.0,1.0
6085,28,3,0,34,34,0.0,1.0
5948,28,3,1,41,42,0.023809523809523808,0.9761904761904762
5974,28,3,0,10,10,0.0,1.0
6090,28,3,0,1,1,0.0,1.0
6068,28,3,0,35,35,0.0,1.0
6024,28,3,1,1,2,0.5,0.5
5976,28,3,0,80,80,0.0,1.0
5962,28,3,0,59,59,0.0,1.0
6033,28,3,2,22,24,0.08333333333333333,0.9166666666666666
6038,28,3,0,7,7,0.0,1.0
6042,28,3,0,49,49,0.0,1.0
5924,28,3,0,50,50,0.0,1.0
6083,28,3,1,11,12,0.08333333333333333,0.9166666666666666
6178,28,3,0,225,225,0.0,1.0
6086,28,3,0,25,25,0.0,1.0
5945,28,3,0,95,95,0.0,1.0
5925,28,3,0,122,122,0.0,1.0
5935,28,3,0,3,3,0.0,1.0
6073,28,3,1,6,7,0.14285714285714285,0.8571428571428571
5980,28,3,2,10,12,0.16666666666666666,0.8333333333333334
5993,28,3,0,24,24,0.0,1.0
5979,28,3,0,33,33,0.0,1.0
5966,28,3,0,26,26,0.0,1.0
5967,28,3,1,100,101,0.009900990099009901,0.9900990099009901
5970,28,3,0,14,14,0.0,1.0
6188,28,3,0,3,3,0.0,1.0
6096,28,3,1,0,1,1.0,0.0
6069,28,3,0,17,17,0.0,1.0
5937,28,3,0,6,6,0.0,1.0
5990,28,3,0,50,50,0.0,1.0
5928,28,3,0,22,22,0.0,1.0
6058,28,3,1,68,69,0.014492753623188406,0.9855072463768116
6001,28,3,2,22,24,0.08333333333333333,0.9166666666666666
5964,28,3,4,6,10,0.4,0.6
5950,28,3,1,6,7,0.14285714285714285,0.8571428571428571
5991,28,3,0,20,20,0.0,1.0
6177,28,3,0,3,3,0.0,1.0
5961,28,3,0,45,45,0.0,1.0
5938,28,3,0,340,340,0.0,1.0
5960,28,3,0,36,36,0.0,1.0
5947,28,3,0,78,78,0.0,1.0
5957,28,3,0,7,7,0.0,1.0
6043,28,3,0,29,29,0.0,1.0
6014,28,3,4,6,10,0.4,0.6
6015,28,3,1,1,2,0.5,0.5
5978,28,3,0,16,16,0.0,1.0
5986,28,3,2,2,4,0.5,0.5
5969,28,3,0,4,4,0.0,1.0
5949,28,3,0,30,30,0.0,1.0
5959,28,3,1,39,40,0.025,0.975
6051,28,3,0,108,108,0.0,1.0
6029,28,3,1,19,20,0.05,0.95
6070,28,3,2,2,4,0.5,0.5
5942,28,3,0,108,108,0.0,1.0
5953,28,3,0,28,28,0.0,1.0
6076,28,3,0,14,14,0.0,1.0
5940,28,3,3,6,9,0.3333333333333333,0.6666666666666666
6109,28,3,0,95,95,0.0,1.0
6187,28,3,0,6,6,0.0,1.0
6053,28,3,0,15,15,0.0,1.0
6104,28,3,2,2,4,0.5,0.5
5943,28,3,5,4,9,0.5555555555555556,0.4444444444444444
6168,28,3,0,240,240,0.0,1.0
5989,28,3,0,6,6,0.0,1.0
5963,28,3,1,19,20,0.05,0.95
6194,28,3,0,80,80,0.0,1.0
6003,28,3,0,238,238,0.0,1.0
6167,28,3,1,9,10,0.1,0.9
6004,28,3,1,134,135,0.007407407407407408,0.9925925925925926
6054,28,3,0,14,14,0.0,1.0
6170,28,3,1,33,34,0.029411764705882353,0.9705882352941176
6063,28,3,3,7,10,0.3,0.7
5988,28,3,0,17,17,0.0,1.0
6075,28,3,1,11,12,0.08333333333333333,0.9166666666666666
6061,28,3,0,26,26,0.0,1.0
5965,28,3,0,45,45,0.0,1.0
6040,28,3,5,7,12,0.4166666666666667,0.5833333333333334
6106,28,3,2,28,30,0.06666666666666667,0.9333333333333333
6082,28,3,0,13,13,0.0,1.0
6031,28,3,1,24,25,0.04,0.96
6039,28,3,1,57,58,0.017241379310344827,0.9827586206896551
6189,29,3,0,22,22,0.0,1.0
5936,29,3,0,31,31,0.0,1.0
6087,29,3,0,18,18,0.0,1.0
5973,29,3,0,34,34,0.0,1.0
6085,29,3,0,34,34,0.0,1.0
5948,29,3,1,41,42,0.023809523809523808,0.9761904761904762
5974,29,3,0,10,10,0.0,1.0
6090,29,3,0,1,1,0.0,1.0
6068,29,3,0,35,35,0.0,1.0
6024,29,3,1,1,2,0.5,0.5
5976,29,3,0,80,80,0.0,1.0
5962,29,3,0,59,59,0.0,1.0
6033,29,3,2,22,24,0.08333333333333333,0.9166666666666666
6038,29,3,0,7,7,0.0,1.0
6042,29,3,0,49,49,0.0,1.0
5924,29,3,0,50,50,0.0,1.0
6083,29,3,4,8,12,0.3333333333333333,0.6666666666666666
6178,29,3,0,225,225,0.0,1.0
6086,29,3,0,25,25,0.0,1.0
5945,29,3,0,95,95,0.0,1.0
5925,29,3,0,122,122,0.0,1.0
5935,29,3,0,3,3,0.0,1.0
6073,29,3,0,7,7,0.0,1.0
5980,29,3,2,10,12,0.16666666666666666,0.8333333333333334
5993,29,3,0,24,24,0.0,1.0
5979,29,3,0,33,33,0.0,1.0
5966,29,3,0,26,26,0.0,1.0
5967,29,3,1,100,101,0.009900990099009901,0.9900990099009901
5970,29,3,0,14,14,0.0,1.0
6188,29,3,0,3,3,0.0,1.0
6096,29,3,1,0,1,1.0,0.0
6069,29,3,0,17,17,0.0,1.0
5937,29,3,0,6,6,0.0,1.0
5990,29,3,0,50,50,0.0,1.0
5928,29,3,0,22,22,0.0,1.0
6058,29,3,2,67,69,0.028985507246376812,0.9710144927536232
6001,29,3,0,24,24,0.0,1.0
5964,29,3,0,10,10,0.0,1.0
5950,29,3,1,6,7,0.14285714285714285,0.8571428571428571
5991,29,3,0,20,20,0.0,1.0
6177,29,3,0,3,3,0.0,1.0
5961,29,3,0,45,45,0.0,1.0
5938,29,3,0,340,340,0.0,1.0
5960,29,3,0,36,36,0.0,1.0
5947,29,3,0,78,78,0.0,1.0
5957,29,3,1,6,7,0.14285714285714285,0.8571428571428571
6043,29,3,0,29,29,0.0,1.0
6014,29,3,2,8,10,0.2,0.8
6015,29,3,1,1,2,0.5,0.5
5978,29,3,1,15,16,0.0625,0.9375
5986,29,3,1,3,4,0.25,0.75
5969,29,3,0,4,4,0.0,1.0
5949,29,3,0,30,30,0.0,1.0
5959,29,3,0,40,40,0.0,1.0
6051,29,3,0,108,108,0.0,1.0
6029,29,3,1,19,20,0.05,0.95
6070,29,3,0,4,4,0.0,1.0
5942,29,3,0,108,108,0.0,1.0
5953,29,3,0,28,28,0.0,1.0
6076,29,3,0,14,14,0.0,1.0
5940,29,3,6,3,9,0.6666666666666666,0.3333333333333333
6109,29,3,0,95,95,0.0,1.0
6187,29,3,2,4,6,0.3333333333333333,0.6666666666666666
6053,29,3,4,11,15,0.26666666666666666,0.7333333333333333
6104,29,3,2,2,4,0.5,0.5
5943,29,3,0,9,9,0.0,1.0
6168,29,3,0,240,240,0.0,1.0
5989,29,3,0,6,6,0.0,1.0
5963,29,3,1,19,20,0.05,0.95
6194,29,3,0,80,80,0.0,1.0
6003,29,3,1,237,238,0.004201680672268907,0.9957983193277311
6167,29,3,0,10,10,0.0,1.0
6004,29,3,5,130,135,0.037037037037037035,0.9629629629629629
6054,29,3,0,14,14,0.0,1.0
6170,29,3,3,31,34,0.08823529411764706,0.9117647058823529
6063,29,3,2,8,10,0.2,0.8
5988,29,3,0,17,17,0.0,1.0
6075,29,3,1,11,12,0.08333333333333333,0.9166666666666666
6061,29,3,0,26,26,0.0,1.0
5965,29,3,0,45,45,0.0,1.0
6040,29,3,4,8,12,0.3333333333333333,0.6666666666666666
6106,29,3,1,29,30,0.03333333333333333,0.9666666666666667
6082,29,3,0,13,13,0.0,1.0
6031,29,3,1,24,25,0.04,0.96
6039,29,3,1,57,58,0.017241379310344827,0.9827586206896551
6189,0,4,9,13,22,0.4090909090909091,0.5909090909090909
5936,0,4,0,31,31,0.0,1.0
6087,0,4,0,18,18,0.0,1.0
5973,0,4,0,34,34,0.0,1.0
6085,0,4,0,34,34,0.0,1.0
5948,0,4,0,42,42,0.0,1.0
5974,0,4,0,10,10,0.0,1.0
6090,0,4,0,1,1,0.0,1.0
6068,0,4,0,35,35,0.0,1.0
6024,0,4,1,1,2,0.5,0.5
5976,0,4,78,2,80,0.975,0.025
5962,0,4,0,59,59,0.0,1.0
6033,0,4,0,24,24,0.0,1.0
6038,0,4,0,7,7,0.0,1.0
6042,0,4,0,49,49,0.0,1.0
5924,0,4,0,50,50,0.0,1.0
6083,0,4,0,12,12,0.0,1.0
6178,0,4,196,29,225,0.8711111111111111,0.1288888888888889
6086,0,4,0,25,25,0.0,1.0
5945,0,4,0,95,95,0.0,1.0
5925,0,4,0,122,122,0.0,1.0
5935,0,4,0,3,3,0.0,1.0
6073,0,4,6,1,7,0.8571428571428571,0.14285714285714285
5980,0,4,2,10,12,0.16666666666666666,0.8333333333333334
5993,0,4,0,24,24,0.0,1.0
5979,0,4,0,33,33,0.0,1.0
5966,0,4,24,2,26,0.9230769230769231,0.07692307692307693
5967,0,4,91,10,101,0.900990099009901,0.09900990099009901
5970,0,4,0,14,14,0.0,1.0
6188,0,4,3,0,3,1.0,0.0
6096,0,4,1,0,1,1.0,0.0
6069,0,4,0,17,17,0.0,1.0
5937,0,4,0,6,6,0.0,1.0
5990,0,4,0,50,50,0.0,1.0
5928,0,4,0,22,22,0.0,1.0
6058,0,4,68,1,69,0.9855072463768116,0.014492753623188406
6001,0,4,5,19,24,0.20833333333333334,0.7916666666666666
5964,0,4,0,10,10,0.0,1.0
5950,0,4,1,6,7,0.14285714285714285,0.8571428571428571
5991,0,4,0,20,20,0.0,1.0
6177,0,4,0,3,3,0.0,1.0
5961,0,4,0,45,45,0.0,1.0
5938,0,4,229,111,340,0.6735294117647059,0.3264705882352941
5960,0,4,0,36,36,0.0,1.0
5947,0,4,0,78,78,0.0,1.0
5957,0,4,7,0,7,1.0,0.0
6043,0,4,0,29,29,0.0,1.0
6014,0,4,10,0,10,1.0,0.0
6015,0,4,2,0,2,1.0,0.0
5978,0,4,16,0,16,1.0,0.0
5986,0,4,4,0,4,1.0,0.0
5969,0,4,4,0,4,1.0,0.0
5949,0,4,0,30,30,0.0,1.0
5959,0,4,40,0,40,1.0,0.0
6051,0,4,0,108,108,0.0,1.0
6029,0,4,0,20,20,0.0,1.0
6070,0,4,4,0,4,1.0,0.0
5942,0,4,0,108,108,0.0,1.0
5953,0,4,0,28,28,0.0,1.0
6076,0,4,12,2,14,0.8571428571428571,0.14285714285714285
5940,0,4,8,1,9,0.8888888888888888,0.1111111111111111
6109,0,4,88,7,95,0.9263157894736842,0.07368421052631578
6187,0,4,0,6,6,0.0,1.0
6053,0,4,0,15,15,0.0,1.0
6104,0,4,3,1,4,0.75,0.25
5943,0,4,0,9,9,0.0,1.0
6168,0,4,0,240,240,0.0,1.0
5989,0,4,0,6,6,0.0,1.0
5963,0,4,20,0,20,1.0,0.0
6194,0,4,0,80,80,0.0,1.0
6003,0,4,102,136,238,0.42857142857142855,0.5714285714285714
6167,0,4,8,2,10,0.8,0.2
6004,0,4,75,60,135,0.5555555555555556,0.4444444444444444
6054,0,4,0,14,14,0.0,1.0
6170,0,4,10,24,34,0.29411764705882354,0.7058823529411765
6063,0,4,8,2,10,0.8,0.2
5988,0,4,0,17,17,0.0,1.0
6075,0,4,2,10,12,0.16666666666666666,0.8333333333333334
6061,0,4,0,26,26,0.0,1.0
5965,0,4,0,45,45,0.0,1.0
6040,0,4,12,0,12,1.0,0.0
6106,0,4,0,30,30,0.0,1.0
6082,0,4,0,13,13,0.0,1.0
6031,0,4,2,23,25,0.08,0.92
6039,0,4,6,52,58,0.10344827586206896,0.896551724137931
6189,1,4,9,13,22,0.4090909090909091,0.5909090909090909
5936,1,4,0,31,31,0.0,1.0
6087,1,4,0,18,18,0.0,1.0
5973,1,4,0,34,34,0.0,1.0
6085,1,4,0,34,34,0.0,1.0
5948,1,4,0,42,42,0.0,1.0
5974,1,4,0,10,10,0.0,1.0
6090,1,4,0,1,1,0.0,1.0
6068,1,4,0,35,35,0.0,1.0
6024,1,4,2,0,2,1.0,0.0
5976,1,4,76,4,80,0.95,0.05
5962,1,4,0,59,59,0.0,1.0
6033,1,4,4,20,24,0.16666666666666666,0.8333333333333334
6038,1,4,0,7,7,0.0,1.0
6042,1,4,0,49,49,0.0,1.0
5924,1,4,0,50,50,0.0,1.0
6083,1,4,3,9,12,0.25,0.75
6178,1,4,155,70,225,0.6888888888888889,0.3111111111111111
6086,1,4,0,25,25,0.0,1.0
5945,1,4,0,95,95,0.0,1.0
5925,1,4,0,122,122,0.0,1.0
5935,1,4,0,3,3,0.0,1.0
6073,1,4,6,1,7,0.8571428571428571,0.14285714285714285
5980,1,4,2,10,12,0.16666666666666666,0.8333333333333334
5993,1,4,0,24,24,0.0,1.0
5979,1,4,0,33,33,0.0,1.0
5966,1,4,25,1,26,0.9615384615384616,0.038461538461538464
5967,1,4,81,20,101,0.801980198019802,0.19801980198019803
5970,1,4,0,14,14,0.0,1.0
6188,1,4,3,0,3,1.0,0.0
6096,1,4,1,0,1,1.0,0.0
6069,1,4,0,17,17,0.0,1.0
5937,1,4,0,6,6,0.0,1.0
5990,1,4,0,50,50,0.0,1.0
5928,1,4,0,22,22,0.0,1.0
6058,1,4,64,5,69,0.927536231884058,0.07246376811594203
6001,1,4,5,19,24,0.20833333333333334,0.7916666666666666
5964,1,4,0,10,10,0.0,1.0
5950,1,4,0,7,7,0.0,1.0
5991,1,4,0,20,20,0.0,1.0
6177,1,4,0,3,3,0.0,1.0
5961,1,4,0,45,45,0.0,1.0
5938,1,4,135,205,340,0.39705882352941174,0.6029411764705882
5960,1,4,0,36,36,0.0,1.0
5947,1,4,0,78,78,0.0,1.0
5957,1,4,7,0,7,1.0,0.0
6043,1,4,0,29,29,0.0,1.0
6014,1,4,10,0,10,1.0,0.0
6015,1,4,2,0,2,1.0,0.0
5978,1,4,16,0,16,1.0,0.0
5986,1,4,4,0,4,1.0,0.0
5969,1,4,4,0,4,1.0,0.0
5949,1,4,0,30,30,0.0,1.0
5959,1,4,38,2,40,0.95,0.05
6051,1,4,0,108,108,0.0,1.0
6029,1,4,0,20,20,0.0,1.0
6070,1,4,4,0,4,1.0,0.0
5942,1,4,0,108,108,0.0,1.0
5953,1,4,0,28,28,0.0,1.0
6076,1,4,10,4,14,0.7142857142857143,0.2857142857142857
5940,1,4,9,0,9,1.0,0.0
6109,1,4,79,16,95,0.8315789473684211,0.16842105263157894
6187,1,4,2,4,6,0.3333333333333333,0.6666666666666666
6053,1,4,0,15,15,0.0,1.0
6104,1,4,3,1,4,0.75,0.25
5943,1,4,0,9,9,0.0,1.0
6168,1,4,0,240,240,0.0,1.0
5989,1,4,0,6,6,0.0,1.0
5963,1,4,19,1,20,0.95,0.05
6194,1,4,0,80,80,0.0,1.0
6003,1,4,100,138,238,0.42016806722689076,0.5798319327731093
6167,1,4,9,1,10,0.9,0.1
6004,1,4,59,76,135,0.43703703703703706,0.562962962962963
6054,1,4,0,14,14,0.0,1.0
6170,1,4,11,23,34,0.3235294117647059,0.6764705882352942
6063,1,4,8,2,10,0.8,0.2
5988,1,4,0,17,17,0.0,1.0
6075,1,4,1,11,12,0.08333333333333333,0.9166666666666666
6061,1,4,0,26,26,0.0,1.0
5965,1,4,0,45,45,0.0,1.0
6040,1,4,12,0,12,1.0,0.0
6106,1,4,1,29,30,0.03333333333333333,0.9666666666666667
6082,1,4,0,13,13,0.0,1.0
6031,1,4,2,23,25,0.08,0.92
6039,1,4,1,57,58,0.017241379310344827,0.9827586206896551
6189,2,4,10,12,22,0.45454545454545453,0.5454545454545454
5936,2,4,0,31,31,0.0,1.0
6087,2,4,0,18,18,0.0,1.0
5973,2,4,0,34,34,0.0,1.0
6085,2,4,0,34,34,0.0,1.0
5948,2,4,0,42,42,0.0,1.0
5974,2,4,0,10,10,0.0,1.0
6090,2,4,0,1,1,0.0,1.0
6068,2,4,0,35,35,0.0,1.0
6024,2,4,2,0,2,1.0,0.0
5976,2,4,40,40,80,0.5,0.5
5962,2,4,0,59,59,0.0,1.0
6033,2,4,4,20,24,0.16666666666666666,0.8333333333333334
6038,2,4,0,7,7,0.0,1.0
6042,2,4,0,49,49,0.0,1.0
5924,2,4,0,50,50,0.0,1.0
6083,2,4,3,9,12,0.25,0.75
6178,2,4,57,168,225,0.25333333333333335,0.7466666666666667
6086,2,4,0,25,25,0.0,1.0
5945,2,4,0,95,95,0.0,1.0
5925,2,4,0,122,122,0.0,1.0
5935,2,4,0,3,3,0.0,1.0
6073,2,4,5,2,7,0.7142857142857143,0.2857142857142857
5980,2,4,0,12,12,0.0,1.0
5993,2,4,0,24,24,0.0,1.0
5979,2,4,0,33,33,0.0,1.0
5966,2,4,22,4,26,0.8461538461538461,0.15384615384615385
5967,2,4,51,50,101,0.504950495049505,0.49504950495049505
5970,2,4,0,14,14,0.0,1.0
6188,2,4,3,0,3,1.0,0.0
6096,2,4,1,0,1,1.0,0.0
6069,2,4,0,17,17,0.0,1.0
5937,2,4,0,6,6,0.0,1.0
5990,2,4,0,50,50,0.0,1.0
5928,2,4,0,22,22,0.0,1.0
6058,2,4,46,23,69,0.6666666666666666,0.3333333333333333
6001,2,4,7,17,24,0.2916666666666667,0.7083333333333334
5964,2,4,4,6,10,0.4,0.6
5950,2,4,1,6,7,0.14285714285714285,0.8571428571428571
5991,2,4,0,20,20,0.0,1.0
6177,2,4,0,3,3,0.0,1.0
5961,2,4,0,45,45,0.0,1.0
5938,2,4,30,310,340,0.08823529411764706,0.9117647058823529
5960,2,4,0,36,36,0.0,1.0
5947,2,4,0,78,78,0.0,1.0
5957,2,4,6,1,7,0.8571428571428571,0.14285714285714285
6043,2,4,0,29,29,0.0,1.0
6014,2,4,10,0,10,1.0,0.0
6015,2,4,2,0,2,1.0,0.0
5978,2,4,15,1,16,0.9375,0.0625
5986,2,4,4,0,4,1.0,0.0
5969,2,4,4,0,4,1.0,0.0
5949,2,4,0,30,30,0.0,1.0
5959,2,4,29,11,40,0.725,0.275
6051,2,4,0,108,108,0.0,1.0
6029,2,4,0,20,20,0.0,1.0
6070,2,4,3,1,4,0.75,0.25
5942,2,4,0,108,108,0.0,1.0
5953,2,4,0,28,28,0.0,1.0
6076,2,4,12,2,14,0.8571428571428571,0.14285714285714285
5940,2,4,9,0,9,1.0,0.0
6109,2,4,58,37,95,0.6105263157894737,0.3894736842105263
6187,2,4,0,6,6,0.0,1.0
6053,2,4,0,15,15,0.0,1.0
6104,2,4,4,0,4,1.0,0.0
5943,2,4,0,9,9,0.0,1.0
6168,2,4,0,240,240,0.0,1.0
5989,2,4,0,6,6,0.0,1.0
5963,2,4,19,1,20,0.95,0.05
6194,2,4,0,80,80,0.0,1.0
6003,2,4,50,188,238,0.21008403361344538,0.7899159663865546
6167,2,4,6,4,10,0.6,0.4
6004,2,4,35,100,135,0.25925925925925924,0.7407407407407407
6054,2,4,0,14,14,0.0,1.0
6170,2,4,6,28,34,0.17647058823529413,0.8235294117647058
6063,2,4,7,3,10,0.7,0.3
5988,2,4,0,17,17,0.0,1.0
6075,2,4,2,10,12,0.16666666666666666,0.8333333333333334
6061,2,4,0,26,26,0.0,1.0
5965,2,4,0,45,45,0.0,1.0
6040,2,4,11,1,12,0.9166666666666666,0.08333333333333333
6106,2,4,1,29,30,0.03333333333333333,0.9666666666666667
6082,2,4,0,13,13,0.0,1.0
6031,2,4,1,24,25,0.04,0.96
6039,2,4,0,58,58,0.0,1.0
6189,3,4,4,18,22,0.18181818181818182,0.8181818181818182
5936,3,4,0,31,31,0.0,1.0
6087,3,4,0,18,18,0.0,1.0
5973,3,4,0,34,34,0.0,1.0
6085,3,4,0,34,34,0.0,1.0
5948,3,4,0,42,42,0.0,1.0
5974,3,4,0,10,10,0.0,1.0
6090,3,4,0,1,1,0.0,1.0
6068,3,4,0,35,35,0.0,1.0
6024,3,4,2,0,2,1.0,0.0
5976,3,4,33,47,80,0.4125,0.5875
5962,3,4,0,59,59,0.0,1.0
6033,3,4,6,18,24,0.25,0.75
6038,3,4,0,7,7,0.0,1.0
6042,3,4,0,49,49,0.0,1.0
5924,3,4,0,50,50,0.0,1.0
6083,3,4,0,12,12,0.0,1.0
6178,3,4,42,183,225,0.18666666666666668,0.8133333333333334
6086,3,4,0,25,25,0.0,1.0
5945,3,4,0,95,95,0.0,1.0
5925,3,4,0,122,122,0.0,1.0
5935,3,4,0,3,3,0.0,1.0
6073,3,4,4,3,7,0.5714285714285714,0.42857142857142855
5980,3,4,0,12,12,0.0,1.0
5993,3,4,0,24,24,0.0,1.0
5979,3,4,0,33,33,0.0,1.0
5966,3,4,16,10,26,0.6153846153846154,0.38461538461538464
5967,3,4,35,66,101,0.3465346534653465,0.6534653465346535
5970,3,4,0,14,14,0.0,1.0
6188,3,4,3,0,3,1.0,0.0
6096,3,4,1,0,1,1.0,0.0
6069,3,4,0,17,17,0.0,1.0
5937,3,4,0,6,6,0.0,1.0
5990,3,4,0,50,50,0.0,1.0
5928,3,4,0,22,22,0.0,1.0
6058,3,4,34,35,69,0.4927536231884058,0.5072463768115942
6001,3,4,7,17,24,0.2916666666666667,0.7083333333333334
5964,3,4,4,6,10,0.4,0.6
5950,3,4,3,4,7,0.42857142857142855,0.5714285714285714
5991,3,4,0,20,20,0.0,1.0
6177,3,4,0,3,3,0.0,1.0
5961,3,4,0,45,45,0.0,1.0
5938,3,4,23,317,340,0.06764705882352941,0.9323529411764706
5960,3,4,0,36,36,0.0,1.0
5947,3,4,0,78,78,0.0,1.0
5957,3,4,6,1,7,0.8571428571428571,0.14285714285714285
6043,3,4,0,29,29,0.0,1.0
6014,3,4,10,0,10,1.0,0.0
6015,3,4,2,0,2,1.0,0.0
5978,3,4,12,4,16,0.75,0.25
5986,3,4,4,0,4,1.0,0.0
5969,3,4,3,1,4,0.75,0.25
5949,3,4,0,30,30,0.0,1.0
5959,3,4,24,16,40,0.6,0.4
6051,3,4,0,108,108,0.0,1.0
6029,3,4,1,19,20,0.05,0.95
6070,3,4,3,1,4,0.75,0.25
5942,3,4,0,108,108,0.0,1.0
5953,3,4,0,28,28,0.0,1.0
6076,3,4,9,5,14,0.6428571428571429,0.35714285714285715
5940,3,4,9,0,9,1.0,0.0
6109,3,4,33,62,95,0.3473684210526316,0.6526315789473685
6187,3,4,0,6,6,0.0,1.0
6053,3,4,0,15,15,0.0,1.0
6104,3,4,3,1,4,0.75,0.25
5943,3,4,0,9,9,0.0,1.0
6168,3,4,0,240,240,0.0,1.0
5989,3,4,0,6,6,0.0,1.0
5963,3,4,14,6,20,0.7,0.3
6194,3,4,0,80,80,0.0,1.0
6003,3,4,26,212,238,0.1092436974789916,0.8907563025210085
6167,3,4,4,6,10,0.4,0.6
6004,3,4,20,115,135,0.14814814814814814,0.8518518518518519
6054,3,4,0,14,14,0.0,1.0
6170,3,4,4,30,34,0.11764705882352941,0.8823529411764706
6063,3,4,8,2,10,0.8,0.2
5988,3,4,0,17,17,0.0,1.0
6075,3,4,2,10,12,0.16666666666666666,0.8333333333333334
6061,3,4,0,26,26,0.0,1.0
5965,3,4,0,45,45,0.0,1.0
6040,3,4,10,2,12,0.8333333333333334,0.16666666666666666
6106,3,4,2,28,30,0.06666666666666667,0.9333333333333333
6082,3,4,0,13,13,0.0,1.0
6031,3,4,2,23,25,0.08,0.92
6039,3,4,1,57,58,0.017241379310344827,0.9827586206896551
6189,4,4,5,17,22,0.22727272727272727,0.7727272727272727
5936,4,4,0,31,31,0.0,1.0
6087,4,4,0,18,18,0.0,1.0
5973,4,4,0,34,34,0.0,1.0
6085,4,4,0,34,34,0.0,1.0
5948,4,4,0,42,42,0.0,1.0
5974,4,4,0,10,10,0.0,1.0
6090,4,4,0,1,1,0.0,1.0
6068,4,4,0,35,35,0.0,1.0
6024,4,4,1,1,2,0.5,0.5
5976,4,4,20,60,80,0.25,0.75
5962,4,4,0,59,59,0.0,1.0
6033,4,4,4,20,24,0.16666666666666666,0.8333333333333334
6038,4,4,0,7,7,0.0,1.0
6042,4,4,0,49,49,0.0,1.0
5924,4,4,0,50,50,0.0,1.0
6083,4,4,5,7,12,0.4166666666666667,0.5833333333333334
6178,4,4,16,209,225,0.07111111111111111,0.9288888888888889
6086,4,4,0,25,25,0.0,1.0
5945,4,4,0,95,95,0.0,1.0
5925,4,4,0,122,122,0.0,1.0
5935,4,4,0,3,3,0.0,1.0
6073,4,4,5,2,7,0.7142857142857143,0.2857142857142857
5980,4,4,0,12,12,0.0,1.0
5993,4,4,0,24,24,0.0,1.0
5979,4,4,0,33,33,0.0,1.0
5966,4,4,19,7,26,0.7307692307692307,0.2692307692307692
5967,4,4,27,74,101,0.26732673267326734,0.7326732673267327
5970,4,4,0,14,14,0.0,1.0
6188,4,4,3,0,3,1.0,0.0
6096,4,4,1,0,1,1.0,0.0
6069,4,4,0,17,17,0.0,1.0
5937,4,4,0,6,6,0.0,1.0
5990,4,4,0,50,50,0.0,1.0
5928,4,4,0,22,22,0.0,1.0
6058,4,4,28,41,69,0.4057971014492754,0.5942028985507246
6001,4,4,2,22,24,0.08333333333333333,0.9166666666666666
5964,4,4,0,10,10,0.0,1.0
5950,4,4,1,6,7,0.14285714285714285,0.8571428571428571
5991,4,4,0,20,20,0.0,1.0
6177,4,4,0,3,3,0.0,1.0
5961,4,4,0,45,45,0.0,1.0
5938,4,4,15,325,340,0.04411764705882353,0.9558823529411765
5960,4,4,0,36,36,0.0,1.0
5947,4,4,0,78,78,0.0,1.0
5957,4,4,6,1,7,0.8571428571428571,0.14285714285714285
6043,4,4,0,29,29,0.0,1.0
6014,4,4,10,0,10,1.0,0.0
6015,4,4,2,0,2,1.0,0.0
5978,4,4,12,4,16,0.75,0.25
5986,4,4,4,0,4,1.0,0.0
5969,4,4,4,0,4,1.0,0.0
5949,4,4,0,30,30,0.0,1.0
5959,4,4,14,26,40,0.35,0.65
6051,4,4,0,108,108,0.0,1.0
6029,4,4,1,19,20,0.05,0.95
6070,4,4,3,1,4,0.75,0.25
5942,4,4,0,108,108,0.0,1.0
5953,4,4,0,28,28,0.0,1.0
6076,4,4,9,5,14,0.6428571428571429,0.35714285714285715
5940,4,4,8,1,9,0.8888888888888888,0.1111111111111111
6109,4,4,31,64,95,0.3263157894736842,0.6736842105263158
6187,4,4,0,6,6,0.0,1.0
6053,4,4,0,15,15,0.0,1.0
6104,4,4,4,0,4,1.0,0.0
5943,4,4,0,9,9,0.0,1.0
6168,4,4,0,240,240,0.0,1.0
5989,4,4,0,6,6,0.0,1.0
5963,4,4,11,9,20,0.55,0.45
6194,4,4,0,80,80,0.0,1.0
6003,4,4,15,223,238,0.06302521008403361,0.9369747899159664
6167,4,4,3,7,10,0.3,0.7
6004,4,4,15,120,135,0.1111111111111111,0.8888888888888888
6054,4,4,0,14,14,0.0,1.0
6170,4,4,5,29,34,0.14705882352941177,0.8529411764705882
6063,4,4,9,1,10,0.9,0.1
5988,4,4,0,17,17,0.0,1.0
6075,4,4,1,11,12,0.08333333333333333,0.9166666666666666
6061,4,4,0,26,26,0.0,1.0
5965,4,4,0,45,45,0.0,1.0
6040,4,4,10,2,12,0.8333333333333334,0.16666666666666666
6106,4,4,2,28,30,0.06666666666666667,0.9333333333333333
6082,4,4,0,13,13,0.0,1.0
6031,4,4,2,23,25,0.08,0.92
6039,4,4,0,58,58,0.0,1.0
6189,5,4,4,18,22,0.18181818181818182,0.8181818181818182
5936,5,4,0,31,31,0.0,1.0
6087,5,4,0,18,18,0.0,1.0
5973,5,4,0,34,34,0.0,1.0
6085,5,4,0,34,34,0.0,1.0
5948,5,4,0,42,42,0.0,1.0
5974,5,4,0,10,10,0.0,1.0
6090,5,4,0,1,1,0.0,1.0
6068,5,4,0,35,35,0.0,1.0
6024,5,4,1,1,2,0.5,0.5
5976,5,4,21,59,80,0.2625,0.7375
5962,5,4,0,59,59,0.0,1.0
6033,5,4,2,22,24,0.08333333333333333,0.9166666666666666
6038,5,4,0,7,7,0.0,1.0
6042,5,4,0,49,49,0.0,1.0
5924,5,4,0,50,50,0.0,1.0
6083,5,4,2,10,12,0.16666666666666666,0.8333333333333334
6178,5,4,25,200,225,0.1111111111111111,0.8888888888888888
6086,5,4,0,25,25,0.0,1.0
5945,5,4,0,95,95,0.0,1.0
5925,5,4,0,122,122,0.0,1.0
5935,5,4,0,3,3,0.0,1.0
6073,5,4,3,4,7,0.42857142857142855,0.5714285714285714
5980,5,4,2,10,12,0.16666666666666666,0.8333333333333334
5993,5,4,0,24,24,0.0,1.0
5979,5,4,0,33,33,0.0,1.0
5966,5,4,11,15,26,0.4230769230769231,0.5769230769230769
5967,5,4,22,79,101,0.21782178217821782,0.7821782178217822
5970,5,4,0,14,14,0.0,1.0
6188,5,4,3,0,3,1.0,0.0
6096,5,4,1,0,1,1.0,0.0
6069,5,4,0,17,17,0.0,1.0
5937,5,4,0,6,6,0.0,1.0
5990,5,4,0,50,50,0.0,1.0
5928,5,4,0,22,22,0.0,1.0
6058,5,4,22,47,69,0.3188405797101449,0.6811594202898551
6001,5,4,4,20,24,0.16666666666666666,0.8333333333333334
5964,5,4,0,10,10,0.0,1.0
5950,5,4,2,5,7,0.2857142857142857,0.7142857142857143
5991,5,4,0,20,20,0.0,1.0
6177,5,4,0,3,3,0.0,1.0
5961,5,4,0,45,45,0.0,1.0
5938,5,4,13,327,340,0.03823529411764706,0.961764705882353
5960,5,4,0,36,36,0.0,1.0
5947,5,4,0,78,78,0.0,1.0
5957,5,4,5,2,7,0.7142857142857143,0.2857142857142857
6043,5,4,0,29,29,0.0,1.0
6014,5,4,10,0,10,1.0,0.0
6015,5,4,2,0,2,1.0,0.0
5978,5,4,10,6,16,0.625,0.375
5986,5,4,4,0,4,1.0,0.0
5969,5,4,3,1,4,0.75,0.25
5949,5,4,0,30,30,0.0,1.0
5959,5,4,14,26,40,0.35,0.65
6051,5,4,0,108,108,0.0,1.0
6029,5,4,1,19,20,0.05,0.95
6070,5,4,4,0,4,1.0,0.0
5942,5,4,0,108,108,0.0,1.0
5953,5,4,0,28,28,0.0,1.0
6076,5,4,12,2,14,0.8571428571428571,0.14285714285714285
5940,5,4,8,1,9,0.8888888888888888,0.1111111111111111
6109,5,4,29,66,95,0.30526315789473685,0.6947368421052632
6187,5,4,0,6,6,0.0,1.0
6053,5,4,4,11,15,0.26666666666666666,0.7333333333333333
6104,5,4,3,1,4,0.75,0.25
5943,5,4,0,9,9,0.0,1.0
6168,5,4,0,240,240,0.0,1.0
5989,5,4,0,6,6,0.0,1.0
5963,5,4,14,6,20,0.7,0.3
6194,5,4,0,80,80,0.0,1.0
6003,5,4,10,228,238,0.04201680672268908,0.957983193277311
6167,5,4,5,5,10,0.5,0.5
6004,5,4,11,124,135,0.08148148148148149,0.9185185185185185
6054,5,4,0,14,14,0.0,1.0
6170,5,4,4,30,34,0.11764705882352941,0.8823529411764706
6063,5,4,9,1,10,0.9,0.1
5988,5,4,0,17,17,0.0,1.0
6075,5,4,2,10,12,0.16666666666666666,0.8333333333333334
6061,5,4,0,26,26,0.0,1.0
5965,5,4,0,45,45,0.0,1.0
6040,5,4,11,1,12,0.9166666666666666,0.08333333333333333
6106,5,4,1,29,30,0.03333333333333333,0.9666666666666667
6082,5,4,0,13,13,0.0,1.0
6031,5,4,1,24,25,0.04,0.96
6039,5,4,1,57,58,0.017241379310344827,0.9827586206896551
6189,6,4,3,19,22,0.13636363636363635,0.8636363636363636
5936,6,4,0,31,31,0.0,1.0
6087,6,4,0,18,18,0.0,1.0
5973,6,4,0,34,34,0.0,1.0
6085,6,4,0,34,34,0.0,1.0
5948,6,4,0,42,42,0.0,1.0
5974,6,4,0,10,10,0.0,1.0
6090,6,4,0,1,1,0.0,1.0
6068,6,4,0,35,35,0.0,1.0
6024,6,4,1,1,2,0.5,0.5
5976,6,4,16,64,80,0.2,0.8
5962,6,4,0,59,59,0.0,1.0
6033,6,4,4,20,24,0.16666666666666666,0.8333333333333334
6038,6,4,0,7,7,0.0,1.0
6042,6,4,0,49,49,0.0,1.0
5924,6,4,0,50,50,0.0,1.0
6083,6,4,2,10,12,0.16666666666666666,0.8333333333333334
6178,6,4,13,212,225,0.057777777777777775,0.9422222222222222
6086,6,4,0,25,25,0.0,1.0
5945,6,4,0,95,95,0.0,1.0
5925,6,4,0,122,122,0.0,1.0
5935,6,4,0,3,3,0.0,1.0
6073,6,4,5,2,7,0.7142857142857143,0.2857142857142857
5980,6,4,5,7,12,0.4166666666666667,0.5833333333333334
5993,6,4,3,21,24,0.125,0.875
5979,6,4,0,33,33,0.0,1.0
5966,6,4,9,17,26,0.34615384615384615,0.6538461538461539
5967,6,4,12,89,101,0.1188118811881188,0.8811881188118812
5970,6,4,0,14,14,0.0,1.0
6188,6,4,2,1,3,0.6666666666666666,0.3333333333333333
6096,6,4,1,0,1,1.0,0.0
6069,6,4,0,17,17,0.0,1.0
5937,6,4,0,6,6,0.0,1.0
5990,6,4,0,50,50,0.0,1.0
5928,6,4,0,22,22,0.0,1.0
6058,6,4,18,51,69,0.2608695652173913,0.7391304347826086
6001,6,4,2,22,24,0.08333333333333333,0.9166666666666666
5964,6,4,0,10,10,0.0,1.0
5950,6,4,2,5,7,0.2857142857142857,0.7142857142857143
5991,6,4,0,20,20,0.0,1.0
6177,6,4,0,3,3,0.0,1.0
5961,6,4,0,45,45,0.0,1.0
5938,6,4,12,328,340,0.03529411764705882,0.9647058823529412
5960,6,4,0,36,36,0.0,1.0
5947,6,4,0,78,78,0.0,1.0
5957,6,4,4,3,7,0.5714285714285714,0.42857142857142855
6043,6,4,0,29,29,0.0,1.0
6014,6,4,10,0,10,1.0,0.0
6015,6,4,2,0,2,1.0,0.0
5978,6,4,10,6,16,0.625,0.375
5986,6,4,4,0,4,1.0,0.0
5969,6,4,4,0,4,1.0,0.0
5949,6,4,0,30,30,0.0,1.0
5959,6,4,11,29,40,0.275,0.725
6051,6,4,0,108,108,0.0,1.0
6029,6,4,0,20,20,0.0,1.0
6070,6,4,4,0,4,1.0,0.0
5942,6,4,0,108,108,0.0,1.0
5953,6,4,0,28,28,0.0,1.0
6076,6,4,8,6,14,0.5714285714285714,0.42857142857142855
5940,6,4,5,4,9,0.5555555555555556,0.4444444444444444
6109,6,4,19,76,95,0.2,0.8
6187,6,4,0,6,6,0.0,1.0
6053,6,4,0,15,15,0.0,1.0
6104,6,4,3,1,4,0.75,0.25
5943,6,4,0,9,9,0.0,1.0
6168,6,4,0,240,240,0.0,1.0
5989,6,4,0,6,6,0.0,1.0
5963,6,4,10,10,20,0.5,0.5
6194,6,4,0,80,80,0.0,1.0
6003,6,4,7,231,238,0.029411764705882353,0.9705882352941176
6167,6,4,2,8,10,0.2,0.8
6004,6,4,10,125,135,0.07407407407407407,0.9259259259259259
6054,6,4,0,14,14,0.0,1.0
6170,6,4,5,29,34,0.14705882352941177,0.8529411764705882
6063,6,4,5,5,10,0.5,0.5
5988,6,4,0,17,17,0.0,1.0
6075,6,4,0,12,12,0.0,1.0
6061,6,4,0,26,26,0.0,1.0
5965,6,4,0,45,45,0.0,1.0
6040,6,4,9,3,12,0.75,0.25
6106,6,4,0,30,30,0.0,1.0
6082,6,4,0,13,13,0.0,1.0
6031,6,4,1,24,25,0.04,0.96
6039,6,4,0,58,58,0.0,1.0
6189,7,4,3,19,22,0.13636363636363635,0.8636363636363636
5936,7,4,0,31,31,0.0,1.0
6087,7,4,0,18,18,0.0,1.0
5973,7,4,0,34,34,0.0,1.0
6085,7,4,0,34,34,0.0,1.0
5948,7,4,0,42,42,0.0,1.0
5974,7,4,0,10,10,0.0,1.0
6090,7,4,0,1,1,0.0,1.0
6068,7,4,0,35,35,0.0,1.0
6024,7,4,1,1,2,0.5,0.5
5976,7,4,6,74,80,0.075,0.925
5962,7,4,0,59,59,0.0,1.0
6033,7,4,6,18,24,0.25,0.75
6038,7,4,0,7,7,0.0,1.0
6042,7,4,0,49,49,0.0,1.0
5924,7,4,0,50,50,0.0,1.0
6083,7,4,0,12,12,0.0,1.0
6178,7,4,7,218,225,0.03111111111111111,0.9688888888888889
6086,7,4,0,25,25,0.0,1.0
5945,7,4,0,95,95,0.0,1.0
5925,7,4,0,122,122,0.0,1.0
5935,7,4,0,3,3,0.0,1.0
6073,7,4,3,4,7,0.42857142857142855,0.5714285714285714
5980,7,4,0,12,12,0.0,1.0
5993,7,4,0,24,24,0.0,1.0
5979,7,4,0,33,33,0.0,1.0
5966,7,4,6,20,26,0.23076923076923078,0.7692307692307693
5967,7,4,9,92,101,0.0891089108910891,0.9108910891089109
5970,7,4,0,14,14,0.0,1.0
6188,7,4,1,2,3,0.3333333333333333,0.6666666666666666
6096,7,4,1,0,1,1.0,0.0
6069,7,4,0,17,17,0.0,1.0
5937,7,4,0,6,6,0.0,1.0
5990,7,4,0,50,50,0.0,1.0
5928,7,4,0,22,22,0.0,1.0
6058,7,4,17,52,69,0.2463768115942029,0.7536231884057971
6001,7,4,2,22,24,0.08333333333333333,0.9166666666666666
5964,7,4,1,9,10,0.1,0.9
5950,7,4,1,6,7,0.14285714285714285,0.8571428571428571
5991,7,4,0,20,20,0.0,1.0
6177,7,4,0,3,3,0.0,1.0
5961,7,4,0,45,45,0.0,1.0
5938,7,4,3,337,340,0.008823529411764706,0.9911764705882353
5960,7,4,0,36,36,0.0,1.0
5947,7,4,0,78,78,0.0,1.0
5957,7,4,4,3,7,0.5714285714285714,0.42857142857142855
6043,7,4,0,29,29,0.0,1.0
6014,7,4,10,0,10,1.0,0.0
6015,7,4,2,0,2,1.0,0.0
5978,7,4,8,8,16,0.5,0.5
5986,7,4,3,1,4,0.75,0.25
5969,7,4,4,0,4,1.0,0.0
5949,7,4,0,30,30,0.0,1.0
5959,7,4,11,29,40,0.275,0.725
6051,7,4,0,108,108,0.0,1.0
6029,7,4,1,19,20,0.05,0.95
6070,7,4,3,1,4,0.75,0.25
5942,7,4,0,108,108,0.0,1.0
5953,7,4,0,28,28,0.0,1.0
6076,7,4,5,9,14,0.35714285714285715,0.6428571428571429
5940,7,4,4,5,9,0.4444444444444444,0.5555555555555556
6109,7,4,9,86,95,0.09473684210526316,0.9052631578947369
6187,7,4,2,4,6,0.3333333333333333,0.6666666666666666
6053,7,4,0,15,15,0.0,1.0
6104,7,4,3,1,4,0.75,0.25
5943,7,4,5,4,9,0.5555555555555556,0.4444444444444444
6168,7,4,0,240,240,0.0,1.0
5989,7,4,0,6,6,0.0,1.0
5963,7,4,7,13,20,0.35,0.65
6194,7,4,0,80,80,0.0,1.0
6003,7,4,6,232,238,0.025210084033613446,0.9747899159663865
6167,7,4,2,8,10,0.2,0.8
6004,7,4,5,130,135,0.037037037037037035,0.9629629629629629
6054,7,4,0,14,14,0.0,1.0
6170,7,4,7,27,34,0.20588235294117646,0.7941176470588235
6063,7,4,7,3,10,0.7,0.3
5988,7,4,0,17,17,0.0,1.0
6075,7,4,0,12,12,0.0,1.0
6061,7,4,0,26,26,0.0,1.0
5965,7,4,0,45,45,0.0,1.0
6040,7,4,6,6,12,0.5,0.5
6106,7,4,2,28,30,0.06666666666666667,0.9333333333333333
6082,7,4,0,13,13,0.0,1.0
6031,7,4,1,24,25,0.04,0.96
6039,7,4,1,57,58,0.017241379310344827,0.9827586206896551
6189,8,4,3,19,22,0.13636363636363635,0.8636363636363636
5936,8,4,0,31,31,0.0,1.0
6087,8,4,0,18,18,0.0,1.0
5973,8,4,0,34,34,0.0,1.0
6085,8,4,0,34,34,0.0,1.0
5948,8,4,0,42,42,0.0,1.0
5974,8,4,0,10,10,0.0,1.0
6090,8,4,0,1,1,0.0,1.0
6068,8,4,0,35,35,0.0,1.0
6024,8,4,1,1,2,0.5,0.5
5976,8,4,5,75,80,0.0625,0.9375
5962,8,4,0,59,59,0.0,1.0
6033,8,4,2,22,24,0.08333333333333333,0.9166666666666666
6038,8,4,0,7,7,0.0,1.0
6042,8,4,0,49,49,0.0,1.0
5924,8,4,0,50,50,0.0,1.0
6083,8,4,1,11,12,0.08333333333333333,0.9166666666666666
6178,8,4,3,222,225,0.013333333333333334,0.9866666666666667
6086,8,4,0,25,25,0.0,1.0
5945,8,4,0,95,95,0.0,1.0
5925,8,4,0,122,122,0.0,1.0
5935,8,4,0,3,3,0.0,1.0
6073,8,4,2,5,7,0.2857142857142857,0.7142857142857143
5980,8,4,0,12,12,0.0,1.0
5993,8,4,3,21,24,0.125,0.875
5979,8,4,0,33,33,0.0,1.0
5966,8,4,8,18,26,0.3076923076923077,0.6923076923076923
5967,8,4,8,93,101,0.07920792079207921,0.9207920792079208
5970,8,4,0,14,14,0.0,1.0
6188,8,4,2,1,3,0.6666666666666666,0.3333333333333333
6096,8,4,1,0,1,1.0,0.0
6069,8,4,0,17,17,0.0,1.0
5937,8,4,0,6,6,0.0,1.0
5990,8,4,0,50,50,0.0,1.0
5928,8,4,0,22,22,0.0,1.0
6058,8,4,14,55,69,0.2028985507246377,0.7971014492753623
6001,8,4,2,22,24,0.08333333333333333,0.9166666666666666
5964,8,4,1,9,10,0.1,0.9
5950,8,4,1,6,7,0.14285714285714285,0.8571428571428571
5991,8,4,0,20,20,0.0,1.0
6177,8,4,0,3,3,0.0,1.0
5961,8,4,0,45,45,0.0,1.0
5938,8,4,5,335,340,0.014705882352941176,0.9852941176470589
5960,8,4,0,36,36,0.0,1.0
5947,8,4,0,78,78,0.0,1.0
5957,8,4,3,4,7,0.42857142857142855,0.5714285714285714
6043,8,4,0,29,29,0.0,1.0
6014,8,4,9,1,10,0.9,0.1
6015,8,4,2,0,2,1.0,0.0
5978,8,4,3,13,16,0.1875,0.8125
5986,8,4,3,1,4,0.75,0.25
5969,8,4,4,0,4,1.0,0.0
5949,8,4,0,30,30,0.0,1.0
5959,8,4,7,33,40,0.175,0.825
6051,8,4,0,108,108,0.0,1.0
6029,8,4,1,19,20,0.05,0.95
6070,8,4,3,1,4,0.75,0.25
5942,8,4,0,108,108,0.0,1.0
5953,8,4,0,28,28,0.0,1.0
6076,8,4,6,8,14,0.42857142857142855,0.5714285714285714
5940,8,4,6,3,9,0.6666666666666666,0.3333333333333333
6109,8,4,10,85,95,0.10526315789473684,0.8947368421052632
6187,8,4,0,6,6,0.0,1.0
6053,8,4,4,11,15,0.26666666666666666,0.7333333333333333
6104,8,4,4,0,4,1.0,0.0
5943,8,4,0,9,9,0.0,1.0
6168,8,4,0,240,240,0.0,1.0
5989,8,4,0,6,6,0.0,1.0
5963,8,4,12,8,20,0.6,0.4
6194,8,4,0,80,80,0.0,1.0
6003,8,4,3,235,238,0.012605042016806723,0.9873949579831933
6167,8,4,2,8,10,0.2,0.8
6004,8,4,2,133,135,0.014814814814814815,0.9851851851851852
6054,8,4,0,14,14,0.0,1.0
6170,8,4,1,33,34,0.029411764705882353,0.9705882352941176
6063,8,4,5,5,10,0.5,0.5
5988,8,4,0,17,17,0.0,1.0
6075,8,4,0,12,12,0.0,1.0
6061,8,4,0,26,26,0.0,1.0
5965,8,4,0,45,45,0.0,1.0
6040,8,4,7,5,12,0.5833333333333334,0.4166666666666667
6106,8,4,1,29,30,0.03333333333333333,0.9666666666666667
6082,8,4,2,11,13,0.15384615384615385,0.8461538461538461
6031,8,4,1,24,25,0.04,0.96
6039,8,4,0,58,58,0.0,1.0
6189,9,4,3,19,22,0.13636363636363635,0.8636363636363636
5936,9,4,0,31,31,0.0,1.0
6087,9,4,0,18,18,0.0,1.0
5973,9,4,0,34,34,0.0,1.0
6085,9,4,0,34,34,0.0,1.0
5948,9,4,1,41,42,0.023809523809523808,0.9761904761904762
5974,9,4,0,10,10,0.0,1.0
6090,9,4,0,1,1,0.0,1.0
6068,9,4,0,35,35,0.0,1.0
6024,9,4,2,0,2,1.0,0.0
5976,9,4,6,74,80,0.075,0.925
5962,9,4,0,59,59,0.0,1.0
6033,9,4,4,20,24,0.16666666666666666,0.8333333333333334
6038,9,4,0,7,7,0.0,1.0
6042,9,4,0,49,49,0.0,1.0
5924,9,4,0,50,50,0.0,1.0
6083,9,4,4,8,12,0.3333333333333333,0.6666666666666666
6178,9,4,9,216,225,0.04,0.96
6086,9,4,0,25,25,0.0,1.0
5945,9,4,0,95,95,0.0,1.0
5925,9,4,0,122,122,0.0,1.0
5935,9,4,0,3,3,0.0,1.0
6073,9,4,4,3,7,0.5714285714285714,0.42857142857142855
5980,9,4,0,12,12,0.0,1.0
5993,9,4,0,24,24,0.0,1.0
5979,9,4,0,33,33,0.0,1.0
5966,9,4,6,20,26,0.23076923076923078,0.7692307692307693
5967,9,4,7,94,101,0.06930693069306931,0.9306930693069307
5970,9,4,0,14,14,0.0,1.0
6188,9,4,1,2,3,0.3333333333333333,0.6666666666666666
6096,9,4,1,0,1,1.0,0.0
6069,9,4,0,17,17,0.0,1.0
5937,9,4,0,6,6,0.0,1.0
5990,9,4,0,50,50,0.0,1.0
5928,9,4,0,22,22,0.0,1.0
6058,9,4,16,53,69,0.2318840579710145,0.7681159420289855
6001,9,4,0,24,24,0.0,1.0
5964,9,4,1,9,10,0.1,0.9
5950,9,4,1,6,7,0.14285714285714285,0.8571428571428571
5991,9,4,0,20,20,0.0,1.0
6177,9,4,0,3,3,0.0,1.0
5961,9,4,0,45,45,0.0,1.0
5938,9,4,6,334,340,0.01764705882352941,0.9823529411764705
5960,9,4,0,36,36,0.0,1.0
5947,9,4,0,78,78,0.0,1.0
5957,9,4,5,2,7,0.7142857142857143,0.2857142857142857
6043,9,4,0,29,29,0.0,1.0
6014,9,4,8,2,10,0.8,0.2
6015,9,4,2,0,2,1.0,0.0
5978,9,4,5,11,16,0.3125,0.6875
5986,9,4,3,1,4,0.75,0.25
5969,9,4,4,0,4,1.0,0.0
5949,9,4,0,30,30,0.0,1.0
5959,9,4,0,40,40,0.0,1.0
6051,9,4,0,108,108,0.0,1.0
6029,9,4,1,19,20,0.05,0.95
6070,9,4,4,0,4,1.0,0.0
5942,9,4,0,108,108,0.0,1.0
5953,9,4,0,28,28,0.0,1.0
6076,9,4,5,9,14,0.35714285714285715,0.6428571428571429
5940,9,4,5,4,9,0.5555555555555556,0.4444444444444444
6109,9,4,11,84,95,0.11578947368421053,0.8842105263157894
6187,9,4,0,6,6,0.0,1.0
6053,9,4,0,15,15,0.0,1.0
6104,9,4,3,1,4,0.75,0.25
5943,9,4,0,9,9,0.0,1.0
6168,9,4,0,240,240,0.0,1.0
5989,9,4,0,6,6,0.0,1.0
5963,9,4,5,15,20,0.25,0.75
6194,9,4,0,80,80,0.0,1.0
6003,9,4,5,233,238,0.02100840336134454,0.9789915966386554
6167,9,4,1,9,10,0.1,0.9
6004,9,4,2,133,135,0.014814814814814815,0.9851851851851852
6054,9,4,0,14,14,0.0,1.0
6170,9,4,7,27,34,0.20588235294117646,0.7941176470588235
6063,9,4,6,4,10,0.6,0.4
5988,9,4,0,17,17,0.0,1.0
6075,9,4,1,11,12,0.08333333333333333,0.9166666666666666
6061,9,4,0,26,26,0.0,1.0
5965,9,4,0,45,45,0.0,1.0
6040,9,4,6,6,12,0.5,0.5
6106,9,4,1,29,30,0.03333333333333333,0.9666666666666667
6082,9,4,0,13,13,0.0,1.0
6031,9,4,1,24,25,0.04,0.96
6039,9,4,1,57,58,0.017241379310344827,0.9827586206896551
6189,10,4,3,19,22,0.13636363636363635,0.8636363636363636
5936,10,4,0,31,31,0.0,1.0
6087,10,4,0,18,18,0.0,1.0
5973,10,4,0,34,34,0.0,1.0
6085,10,4,0,34,34,0.0,1.0
5948,10,4,0,42,42,0.0,1.0
5974,10,4,0,10,10,0.0,1.0
6090,10,4,0,1,1,0.0,1.0
6068,10,4,0,35,35,0.0,1.0
6024,10,4,1,1,2,0.5,0.5
5976,10,4,2,78,80,0.025,0.975
5962,10,4,0,59,59,0.0,1.0
6033,10,4,2,22,24,0.08333333333333333,0.9166666666666666
6038,10,4,0,7,7,0.0,1.0
6042,10,4,0,49,49,0.0,1.0
5924,10,4,0,50,50,0.0,1.0
6083,10,4,0,12,12,0.0,1.0
6178,10,4,8,217,225,0.035555555555555556,0.9644444444444444
6086,10,4,0,25,25,0.0,1.0
5945,10,4,0,95,95,0.0,1.0
5925,10,4,0,122,122,0.0,1.0
5935,10,4,0,3,3,0.0,1.0
6073,10,4,4,3,7,0.5714285714285714,0.42857142857142855
5980,10,4,0,12,12,0.0,1.0
5993,10,4,0,24,24,0.0,1.0
5979,10,4,0,33,33,0.0,1.0
5966,10,4,6,20,26,0.23076923076923078,0.7692307692307693
5967,10,4,2,99,101,0.019801980198019802,0.9801980198019802
5970,10,4,0,14,14,0.0,1.0
6188,10,4,1,2,3,0.3333333333333333,0.6666666666666666
6096,10,4,1,0,1,1.0,0.0
6069,10,4,0,17,17,0.0,1.0
5937,10,4,0,6,6,0.0,1.0
5990,10,4,0,50,50,0.0,1.0
5928,10,4,0,22,22,0.0,1.0
6058,10,4,11,58,69,0.15942028985507245,0.8405797101449275
6001,10,4,4,20,24,0.16666666666666666,0.8333333333333334
5964,10,4,1,9,10,0.1,0.9
5950,10,4,3,4,7,0.42857142857142855,0.5714285714285714
5991,10,4,0,20,20,0.0,1.0
6177,10,4,0,3,3,0.0,1.0
5961,10,4,0,45,45,0.0,1.0
5938,10,4,0,340,340,0.0,1.0
5960,10,4,0,36,36,0.0,1.0
5947,10,4,0,78,78,0.0,1.0
5957,10,4,3,4,7,0.42857142857142855,0.5714285714285714
6043,10,4,0,29,29,0.0,1.0
6014,10,4,8,2,10,0.8,0.2
6015,10,4,2,0,2,1.0,0.0
5978,10,4,7,9,16,0.4375,0.5625
5986,10,4,4,0,4,1.0,0.0
5969,10,4,2,2,4,0.5,0.5
5949,10,4,0,30,30,0.0,1.0
5959,10,4,8,32,40,0.2,0.8
6051,10,4,0,108,108,0.0,1.0
6029,10,4,0,20,20,0.0,1.0
6070,10,4,4,0,4,1.0,0.0
5942,10,4,0,108,108,0.0,1.0
5953,10,4,0,28,28,0.0,1.0
6076,10,4,3,11,14,0.21428571428571427,0.7857142857142857
5940,10,4,6,3,9,0.6666666666666666,0.3333333333333333
6109,10,4,6,89,95,0.06315789473684211,0.9368421052631579
6187,10,4,0,6,6,0.0,1.0
6053,10,4,0,15,15,0.0,1.0
6104,10,4,3,1,4,0.75,0.25
5943,10,4,0,9,9,0.0,1.0
6168,10,4,0,240,240,0.0,1.0
5989,10,4,0,6,6,0.0,1.0
5963,10,4,3,17,20,0.15,0.85
6194,10,4,0,80,80,0.0,1.0
6003,10,4,3,235,238,0.012605042016806723,0.9873949579831933
6167,10,4,1,9,10,0.1,0.9
6004,10,4,4,131,135,0.02962962962962963,0.9703703703703703
6054,10,4,0,14,14,0.0,1.0
6170,10,4,9,25,34,0.2647058823529412,0.7352941176470589
6063,10,4,4,6,10,0.4,0.6
5988,10,4,0,17,17,0.0,1.0
6075,10,4,2,10,12,0.16666666666666666,0.8333333333333334
6061,10,4,0,26,26,0.0,1.0
5965,10,4,0,45,45,0.0,1.0
6040,10,4,6,6,12,0.5,0.5
6106,10,4,2,28,30,0.06666666666666667,0.9333333333333333
6082,10,4,2,11,13,0.15384615384615385,0.8461538461538461
6031,10,4,1,24,25,0.04,0.96
6039,10,4,0,58,58,0.0,1.0
6189,11,4,3,19,22,0.13636363636363635,0.8636363636363636
5936,11,4,0,31,31,0.0,1.0
6087,11,4,0,18,18,0.0,1.0
5973,11,4,0,34,34,0.0,1.0
6085,11,4,0,34,34,0.0,1.0
5948,11,4,1,41,42,0.023809523809523808,0.9761904761904762
5974,11,4,0,10,10,0.0,1.0
6090,11,4,0,1,1,0.0,1.0
6068,11,4,0,35,35,0.0,1.0
6024,11,4,2,0,2,1.0,0.0
5976,11,4,3,77,80,0.0375,0.9625
5962,11,4,0,59,59,0.0,1.0
6033,11,4,2,22,24,0.08333333333333333,0.9166666666666666
6038,11,4,0,7,7,0.0,1.0
6042,11,4,0,49,49,0.0,1.0
5924,11,4,0,50,50,0.0,1.0
6083,11,4,1,11,12,0.08333333333333333,0.9166666666666666
6178,11,4,0,225,225,0.0,1.0
6086,11,4,0,25,25,0.0,1.0
5945,11,4,0,95,95,0.0,1.0
5925,11,4,0,122,122,0.0,1.0
5935,11,4,0,3,3,0.0,1.0
6073,11,4,4,3,7,0.5714285714285714,0.42857142857142855
5980,11,4,0,12,12,0.0,1.0
5993,11,4,0,24,24,0.0,1.0
5979,11,4,0,33,33,0.0,1.0
5966,11,4,3,23,26,0.11538461538461539,0.8846153846153846
5967,11,4,3,98,101,0.0297029702970297,0.9702970297029703
5970,11,4,0,14,14,0.0,1.0
6188,11,4,1,2,3,0.3333333333333333,0.6666666666666666
6096,11,4,1,0,1,1.0,0.0
6069,11,4,0,17,17,0.0,1.0
5937,11,4,0,6,6,0.0,1.0
5990,11,4,0,50,50,0.0,1.0
5928,11,4,0,22,22,0.0,1.0
6058,11,4,16,53,69,0.2318840579710145,0.7681159420289855
6001,11,4,3,21,24,0.125,0.875
5964,11,4,0,10,10,0.0,1.0
5950,11,4,1,6,7,0.14285714285714285,0.8571428571428571
5991,11,4,0,20,20,0.0,1.0
6177,11,4,0,3,3,0.0,1.0
5961,11,4,0,45,45,0.0,1.0
5938,11,4,3,337,340,0.008823529411764706,0.9911764705882353
5960,11,4,0,36,36,0.0,1.0
5947,11,4,0,78,78,0.0,1.0
5957,11,4,3,4,7,0.42857142857142855,0.5714285714285714
6043,11,4,0,29,29,0.0,1.0
6014,11,4,8,2,10,0.8,0.2
6015,11,4,1,1,2,0.5,0.5
5978,11,4,3,13,16,0.1875,0.8125
5986,11,4,2,2,4,0.5,0.5
5969,11,4,2,2,4,0.5,0.5
5949,11,4,0,30,30,0.0,1.0
5959,11,4,4,36,40,0.1,0.9
6051,11,4,0,108,108,0.0,1.0
6029,11,4,0,20,20,0.0,1.0
6070,11,4,4,0,4,1.0,0.0
5942,11,4,0,108,108,0.0,1.0
5953,11,4,0,28,28,0.0,1.0
6076,11,4,4,10,14,0.2857142857142857,0.7142857142857143
5940,11,4,4,5,9,0.4444444444444444,0.5555555555555556
6109,11,4,5,90,95,0.05263157894736842,0.9473684210526315
6187,11,4,2,4,6,0.3333333333333333,0.6666666666666666
6053,11,4,0,15,15,0.0,1.0
6104,11,4,3,1,4,0.75,0.25
5943,11,4,0,9,9,0.0,1.0
6168,11,4,0,240,240,0.0,1.0
5989,11,4,0,6,6,0.0,1.0
5963,11,4,4,16,20,0.2,0.8
6194,11,4,0,80,80,0.0,1.0
6003,11,4,0,238,238,0.0,1.0
6167,11,4,1,9,10,0.1,0.9
6004,11,4,1,134,135,0.007407407407407408,0.9925925925925926
6054,11,4,0,14,14,0.0,1.0
6170,11,4,1,33,34,0.029411764705882353,0.9705882352941176
6063,11,4,5,5,10,0.5,0.5
5988,11,4,0,17,17,0.0,1.0
6075,11,4,0,12,12,0.0,1.0
6061,11,4,0,26,26,0.0,1.0
5965,11,4,0,45,45,0.0,1.0
6040,11,4,6,6,12,0.5,0.5
6106,11,4,1,29,30,0.03333333333333333,0.9666666666666667
6082,11,4,0,13,13,0.0,1.0
6031,11,4,0,25,25,0.0,1.0
6039,11,4,0,58,58,0.0,1.0
6189,12,4,4,18,22,0.18181818181818182,0.8181818181818182
5936,12,4,0,31,31,0.0,1.0
6087,12,4,0,18,18,0.0,1.0
5973,12,4,0,34,34,0.0,1.0
6085,12,4,0,34,34,0.0,1.0
5948,12,4,1,41,42,0.023809523809523808,0.9761904761904762
5974,12,4,0,10,10,0.0,1.0
6090,12,4,0,1,1,0.0,1.0
6068,12,4,0,35,35,0.0,1.0
6024,12,4,1,1,2,0.5,0.5
5976,12,4,4,76,80,0.05,0.95
5962,12,4,0,59,59,0.0,1.0
6033,12,4,0,24,24,0.0,1.0
6038,12,4,0,7,7,0.0,1.0
6042,12,4,0,49,49,0.0,1.0
5924,12,4,0,50,50,0.0,1.0
6083,12,4,1,11,12,0.08333333333333333,0.9166666666666666
6178,12,4,4,221,225,0.017777777777777778,0.9822222222222222
6086,12,4,0,25,25,0.0,1.0
5945,12,4,0,95,95,0.0,1.0
5925,12,4,0,122,122,0.0,1.0
5935,12,4,0,3,3,0.0,1.0
6073,12,4,2,5,7,0.2857142857142857,0.7142857142857143
5980,12,4,0,12,12,0.0,1.0
5993,12,4,3,21,24,0.125,0.875
5979,12,4,0,33,33,0.0,1.0
5966,12,4,2,24,26,0.07692307692307693,0.9230769230769231
5967,12,4,4,97,101,0.039603960396039604,0.9603960396039604
5970,12,4,0,14,14,0.0,1.0
6188,12,4,2,1,3,0.6666666666666666,0.3333333333333333
6096,12,4,1,0,1,1.0,0.0
6069,12,4,0,17,17,0.0,1.0
5937,12,4,0,6,6,0.0,1.0
5990,12,4,0,50,50,0.0,1.0
5928,12,4,0,22,22,0.0,1.0
6058,12,4,8,61,69,0.11594202898550725,0.8840579710144928
6001,12,4,2,22,24,0.08333333333333333,0.9166666666666666
5964,12,4,0,10,10,0.0,1.0
5950,12,4,0,7,7,0.0,1.0
5991,12,4,0,20,20,0.0,1.0
6177,12,4,0,3,3,0.0,1.0
5961,12,4,0,45,45,0.0,1.0
5938,12,4,2,338,340,0.0058823529411764705,0.9941176470588236
5960,12,4,0,36,36,0.0,1.0
5947,12,4,0,78,78,0.0,1.0
5957,12,4,5,2,7,0.7142857142857143,0.2857142857142857
6043,12,4,0,29,29,0.0,1.0
6014,12,4,8,2,10,0.8,0.2
6015,12,4,1,1,2,0.5,0.5
5978,12,4,3,13,16,0.1875,0.8125
5986,12,4,3,1,4,0.75,0.25
5969,12,4,1,3,4,0.25,0.75
5949,12,4,0,30,30,0.0,1.0
5959,12,4,5,35,40,0.125,0.875
6051,12,4,0,108,108,0.0,1.0
6029,12,4,1,19,20,0.05,0.95
6070,12,4,3,1,4,0.75,0.25
5942,12,4,0,108,108,0.0,1.0
5953,12,4,0,28,28,0.0,1.0
6076,12,4,3,11,14,0.21428571428571427,0.7857142857142857
5940,12,4,4,5,9,0.4444444444444444,0.5555555555555556
6109,12,4,5,90,95,0.05263157894736842,0.9473684210526315
6187,12,4,0,6,6,0.0,1.0
6053,12,4,0,15,15,0.0,1.0
6104,12,4,4,0,4,1.0,0.0
5943,12,4,0,9,9,0.0,1.0
6168,12,4,0,240,240,0.0,1.0
5989,12,4,0,6,6,0.0,1.0
5963,12,4,3,17,20,0.15,0.85
6194,12,4,0,80,80,0.0,1.0
6003,12,4,2,236,238,0.008403361344537815,0.9915966386554622
6167,12,4,1,9,10,0.1,0.9
6004,12,4,2,133,135,0.014814814814814815,0.9851851851851852
6054,12,4,0,14,14,0.0,1.0
6170,12,4,5,29,34,0.14705882352941177,0.8529411764705882
6063,12,4,7,3,10,0.7,0.3
5988,12,4,0,17,17,0.0,1.0
6075,12,4,2,10,12,0.16666666666666666,0.8333333333333334
6061,12,4,0,26,26,0.0,1.0
5965,12,4,0,45,45,0.0,1.0
6040,12,4,5,7,12,0.4166666666666667,0.5833333333333334
6106,12,4,1,29,30,0.03333333333333333,0.9666666666666667
6082,12,4,2,11,13,0.15384615384615385,0.8461538461538461
6031,12,4,0,25,25,0.0,1.0
6039,12,4,0,58,58,0.0,1.0
6189,13,4,1,21,22,0.045454545454545456,0.9545454545454546
5936,13,4,0,31,31,0.0,1.0
6087,13,4,0,18,18,0.0,1.0
5973,13,4,0,34,34,0.0,1.0
6085,13,4,0,34,34,0.0,1.0
5948,13,4,1,41,42,0.023809523809523808,0.9761904761904762
5974,13,4,0,10,10,0.0,1.0
6090,13,4,0,1,1,0.0,1.0
6068,13,4,0,35,35,0.0,1.0
6024,13,4,1,1,2,0.5,0.5
5976,13,4,0,80,80,0.0,1.0
5962,13,4,0,59,59,0.0,1.0
6033,13,4,4,20,24,0.16666666666666666,0.8333333333333334
6038,13,4,0,7,7,0.0,1.0
6042,13,4,0,49,49,0.0,1.0
5924,13,4,0,50,50,0.0,1.0
6083,13,4,2,10,12,0.16666666666666666,0.8333333333333334
6178,13,4,1,224,225,0.0044444444444444444,0.9955555555555555
6086,13,4,0,25,25,0.0,1.0
5945,13,4,0,95,95,0.0,1.0
5925,13,4,0,122,122,0.0,1.0
5935,13,4,0,3,3,0.0,1.0
6073,13,4,1,6,7,0.14285714285714285,0.8571428571428571
5980,13,4,2,10,12,0.16666666666666666,0.8333333333333334
5993,13,4,0,24,24,0.0,1.0
5979,13,4,0,33,33,0.0,1.0
5966,13,4,2,24,26,0.07692307692307693,0.9230769230769231
5967,13,4,5,96,101,0.04950495049504951,0.9504950495049505
5970,13,4,0,14,14,0.0,1.0
6188,13,4,1,2,3,0.3333333333333333,0.6666666666666666
6096,13,4,1,0,1,1.0,0.0
6069,13,4,0,17,17,0.0,1.0
5937,13,4,0,6,6,0.0,1.0
5990,13,4,0,50,50,0.0,1.0
5928,13,4,0,22,22,0.0,1.0
6058,13,4,12,57,69,0.17391304347826086,0.8260869565217391
6001,13,4,3,21,24,0.125,0.875
5964,13,4,1,9,10,0.1,0.9
5950,13,4,2,5,7,0.2857142857142857,0.7142857142857143
5991,13,4,0,20,20,0.0,1.0
6177,13,4,0,3,3,0.0,1.0
5961,13,4,0,45,45,0.0,1.0
5938,13,4,3,337,340,0.008823529411764706,0.9911764705882353
5960,13,4,0,36,36,0.0,1.0
5947,13,4,0,78,78,0.0,1.0
5957,13,4,4,3,7,0.5714285714285714,0.42857142857142855
6043,13,4,0,29,29,0.0,1.0
6014,13,4,9,1,10,0.9,0.1
6015,13,4,1,1,2,0.5,0.5
5978,13,4,0,16,16,0.0,1.0
5986,13,4,2,2,4,0.5,0.5
5969,13,4,2,2,4,0.5,0.5
5949,13,4,0,30,30,0.0,1.0
5959,13,4,1,39,40,0.025,0.975
6051,13,4,0,108,108,0.0,1.0
6029,13,4,1,19,20,0.05,0.95
6070,13,4,3,1,4,0.75,0.25
5942,13,4,0,108,108,0.0,1.0
5953,13,4,0,28,28,0.0,1.0
6076,13,4,1,13,14,0.07142857142857142,0.9285714285714286
5940,13,4,4,5,9,0.4444444444444444,0.5555555555555556
6109,13,4,7,88,95,0.07368421052631578,0.9263157894736842
6187,13,4,0,6,6,0.0,1.0
6053,13,4,0,15,15,0.0,1.0
6104,13,4,2,2,4,0.5,0.5
5943,13,4,0,9,9,0.0,1.0
6168,13,4,0,240,240,0.0,1.0
5989,13,4,0,6,6,0.0,1.0
5963,13,4,0,20,20,0.0,1.0
6194,13,4,0,80,80,0.0,1.0
6003,13,4,1,237,238,0.004201680672268907,0.9957983193277311
6167,13,4,1,9,10,0.1,0.9
6004,13,4,4,131,135,0.02962962962962963,0.9703703703703703
6054,13,4,0,14,14,0.0,1.0
6170,13,4,4,30,34,0.11764705882352941,0.8823529411764706
6063,13,4,6,4,10,0.6,0.4
5988,13,4,0,17,17,0.0,1.0
6075,13,4,1,11,12,0.08333333333333333,0.9166666666666666
6061,13,4,0,26,26,0.0,1.0
5965,13,4,0,45,45,0.0,1.0
6040,13,4,8,4,12,0.6666666666666666,0.3333333333333333
6106,13,4,1,29,30,0.03333333333333333,0.9666666666666667
6082,13,4,0,13,13,0.0,1.0
6031,13,4,0,25,25,0.0,1.0
6039,13,4,1,57,58,0.017241379310344827,0.9827586206896551
6189,14,4,2,20,22,0.09090909090909091,0.9090909090909091
5936,14,4,0,31,31,0.0,1.0
6087,14,4,0,18,18,0.0,1.0
5973,14,4,0,34,34,0.0,1.0
6085,14,4,0,34,34,0.0,1.0
5948,14,4,1,41,42,0.023809523809523808,0.9761904761904762
5974,14,4,0,10,10,0.0,1.0
6090,14,4,0,1,1,0.0,1.0
6068,14,4,0,35,35,0.0,1.0
6024,14,4,2,0,2,1.0,0.0
5976,14,4,5,75,80,0.0625,0.9375
5962,14,4,0,59,59,0.0,1.0
6033,14,4,0,24,24,0.0,1.0
6038,14,4,0,7,7,0.0,1.0
6042,14,4,0,49,49,0.0,1.0
5924,14,4,0,50,50,0.0,1.0
6083,14,4,1,11,12,0.08333333333333333,0.9166666666666666
6178,14,4,1,224,225,0.0044444444444444444,0.9955555555555555
6086,14,4,0,25,25,0.0,1.0
5945,14,4,0,95,95,0.0,1.0
5925,14,4,0,122,122,0.0,1.0
5935,14,4,0,3,3,0.0,1.0
6073,14,4,2,5,7,0.2857142857142857,0.7142857142857143
5980,14,4,2,10,12,0.16666666666666666,0.8333333333333334
5993,14,4,3,21,24,0.125,0.875
5979,14,4,0,33,33,0.0,1.0
5966,14,4,3,23,26,0.11538461538461539,0.8846153846153846
5967,14,4,5,96,101,0.04950495049504951,0.9504950495049505
5970,14,4,0,14,14,0.0,1.0
6188,14,4,1,2,3,0.3333333333333333,0.6666666666666666
6096,14,4,1,0,1,1.0,0.0
6069,14,4,0,17,17,0.0,1.0
5937,14,4,0,6,6,0.0,1.0
5990,14,4,0,50,50,0.0,1.0
5928,14,4,0,22,22,0.0,1.0
6058,14,4,10,59,69,0.14492753623188406,0.855072463768116
6001,14,4,5,19,24,0.20833333333333334,0.7916666666666666
5964,14,4,3,7,10,0.3,0.7
5950,14,4,2,5,7,0.2857142857142857,0.7142857142857143
5991,14,4,0,20,20,0.0,1.0
6177,14,4,0,3,3,0.0,1.0
5961,14,4,0,45,45,0.0,1.0
5938,14,4,0,340,340,0.0,1.0
5960,14,4,0,36,36,0.0,1.0
5947,14,4,0,78,78,0.0,1.0
5957,14,4,3,4,7,0.42857142857142855,0.5714285714285714
6043,14,4,0,29,29,0.0,1.0
6014,14,4,8,2,10,0.8,0.2
6015,14,4,2,0,2,1.0,0.0
5978,14,4,1,15,16,0.0625,0.9375
5986,14,4,4,0,4,1.0,0.0
5969,14,4,1,3,4,0.25,0.75
5949,14,4,0,30,30,0.0,1.0
5959,14,4,2,38,40,0.05,0.95
6051,14,4,0,108,108,0.0,1.0
6029,14,4,0,20,20,0.0,1.0
6070,14,4,3,1,4,0.75,0.25
5942,14,4,0,108,108,0.0,1.0
5953,14,4,0,28,28,0.0,1.0
6076,14,4,0,14,14,0.0,1.0
5940,14,4,4,5,9,0.4444444444444444,0.5555555555555556
6109,14,4,6,89,95,0.06315789473684211,0.9368421052631579
6187,14,4,2,4,6,0.3333333333333333,0.6666666666666666
6053,14,4,0,15,15,0.0,1.0
6104,14,4,3,1,4,0.75,0.25
5943,14,4,0,9,9,0.0,1.0
6168,14,4,0,240,240,0.0,1.0
5989,14,4,0,6,6,0.0,1.0
5963,14,4,4,16,20,0.2,0.8
6194,14,4,0,80,80,0.0,1.0
6003,14,4,1,237,238,0.004201680672268907,0.9957983193277311
6167,14,4,1,9,10,0.1,0.9
6004,14,4,1,134,135,0.007407407407407408,0.9925925925925926
6054,14,4,0,14,14,0.0,1.0
6170,14,4,1,33,34,0.029411764705882353,0.9705882352941176
6063,14,4,4,6,10,0.4,0.6
5988,14,4,0,17,17,0.0,1.0
6075,14,4,0,12,12,0.0,1.0
6061,14,4,0,26,26,0.0,1.0
5965,14,4,0,45,45,0.0,1.0
6040,14,4,7,5,12,0.5833333333333334,0.4166666666666667
6106,14,4,0,30,30,0.0,1.0
6082,14,4,2,11,13,0.15384615384615385,0.8461538461538461
6031,14,4,2,23,25,0.08,0.92
6039,14,4,1,57,58,0.017241379310344827,0.9827586206896551
6189,15,4,2,20,22,0.09090909090909091,0.9090909090909091
5936,15,4,0,31,31,0.0,1.0
6087,15,4,0,18,18,0.0,1.0
5973,15,4,0,34,34,0.0,1.0
6085,15,4,0,34,34,0.0,1.0
5948,15,4,0,42,42,0.0,1.0
5974,15,4,0,10,10,0.0,1.0
6090,15,4,0,1,1,0.0,1.0
6068,15,4,0,35,35,0.0,1.0
6024,15,4,1,1,2,0.5,0.5
5976,15,4,4,76,80,0.05,0.95
5962,15,4,0,59,59,0.0,1.0
6033,15,4,2,22,24,0.08333333333333333,0.9166666666666666
6038,15,4,0,7,7,0.0,1.0
6042,15,4,0,49,49,0.0,1.0
5924,15,4,0,50,50,0.0,1.0
6083,15,4,0,12,12,0.0,1.0
6178,15,4,2,223,225,0.008888888888888889,0.9911111111111112
6086,15,4,0,25,25,0.0,1.0
5945,15,4,0,95,95,0.0,1.0
5925,15,4,0,122,122,0.0,1.0
5935,15,4,0,3,3,0.0,1.0
6073,15,4,2,5,7,0.2857142857142857,0.7142857142857143
5980,15,4,2,10,12,0.16666666666666666,0.8333333333333334
5993,15,4,0,24,24,0.0,1.0
5979,15,4,0,33,33,0.0,1.0
5966,15,4,2,24,26,0.07692307692307693,0.9230769230769231
5967,15,4,1,100,101,0.009900990099009901,0.9900990099009901
5970,15,4,0,14,14,0.0,1.0
6188,15,4,1,2,3,0.3333333333333333,0.6666666666666666
6096,15,4,1,0,1,1.0,0.0
6069,15,4,0,17,17,0.0,1.0
5937,15,4,0,6,6,0.0,1.0
5990,15,4,0,50,50,0.0,1.0
5928,15,4,0,22,22,0.0,1.0
6058,15,4,9,60,69,0.13043478260869565,0.8695652173913043
6001,15,4,3,21,24,0.125,0.875
5964,15,4,0,10,10,0.0,1.0
5950,15,4,3,4,7,0.42857142857142855,0.5714285714285714
5991,15,4,0,20,20,0.0,1.0
6177,15,4,0,3,3,0.0,1.0
5961,15,4,0,45,45,0.0,1.0
5938,15,4,4,336,340,0.011764705882352941,0.9882352941176471
5960,15,4,0,36,36,0.0,1.0
5947,15,4,0,78,78,0.0,1.0
5957,15,4,4,3,7,0.5714285714285714,0.42857142857142855
6043,15,4,0,29,29,0.0,1.0
6014,15,4,9,1,10,0.9,0.1
6015,15,4,1,1,2,0.5,0.5
5978,15,4,2,14,16,0.125,0.875
5986,15,4,3,1,4,0.75,0.25
5969,15,4,2,2,4,0.5,0.5
5949,15,4,0,30,30,0.0,1.0
5959,15,4,3,37,40,0.075,0.925
6051,15,4,0,108,108,0.0,1.0
6029,15,4,0,20,20,0.0,1.0
6070,15,4,4,0,4,1.0,0.0
5942,15,4,0,108,108,0.0,1.0
5953,15,4,0,28,28,0.0,1.0
6076,15,4,2,12,14,0.14285714285714285,0.8571428571428571
5940,15,4,4,5,9,0.4444444444444444,0.5555555555555556
6109,15,4,5,90,95,0.05263157894736842,0.9473684210526315
6187,15,4,0,6,6,0.0,1.0
6053,15,4,0,15,15,0.0,1.0
6104,15,4,2,2,4,0.5,0.5
5943,15,4,0,9,9,0.0,1.0
6168,15,4,0,240,240,0.0,1.0
5989,15,4,0,6,6,0.0,1.0
5963,15,4,2,18,20,0.1,0.9
6194,15,4,0,80,80,0.0,1.0
6003,15,4,0,238,238,0.0,1.0
6167,15,4,1,9,10,0.1,0.9
6004,15,4,3,132,135,0.022222222222222223,0.9777777777777777
6054,15,4,0,14,14,0.0,1.0
6170,15,4,3,31,34,0.08823529411764706,0.9117647058823529
6063,15,4,2,8,10,0.2,0.8
5988,15,4,0,17,17,0.0,1.0
6075,15,4,1,11,12,0.08333333333333333,0.9166666666666666
6061,15,4,0,26,26,0.0,1.0
5965,15,4,0,45,45,0.0,1.0
6040,15,4,8,4,12,0.6666666666666666,0.3333333333333333
6106,15,4,0,30,30,0.0,1.0
6082,15,4,0,13,13,0.0,1.0
6031,15,4,2,23,25,0.08,0.92
6039,15,4,0,58,58,0.0,1.0
6189,16,4,1,21,22,0.045454545454545456,0.9545454545454546
5936,16,4,0,31,31,0.0,1.0
6087,16,4,0,18,18,0.0,1.0
5973,16,4,0,34,34,0.0,1.0
6085,16,4,0,34,34,0.0,1.0
5948,16,4,1,41,42,0.023809523809523808,0.9761904761904762
5974,16,4,0,10,10,0.0,1.0
6090,16,4,0,1,1,0.0,1.0
6068,16,4,0,35,35,0.0,1.0
6024,16,4,2,0,2,1.0,0.0
5976,16,4,2,78,80,0.025,0.975
5962,16,4,0,59,59,0.0,1.0
6033,16,4,0,24,24,0.0,1.0
6038,16,4,0,7,7,0.0,1.0
6042,16,4,0,49,49,0.0,1.0
5924,16,4,0,50,50,0.0,1.0
6083,16,4,1,11,12,0.08333333333333333,0.9166666666666666
6178,16,4,0,225,225,0.0,1.0
6086,16,4,0,25,25,0.0,1.0
5945,16,4,0,95,95,0.0,1.0
5925,16,4,0,122,122,0.0,1.0
5935,16,4,0,3,3,0.0,1.0
6073,16,4,0,7,7,0.0,1.0
5980,16,4,0,12,12,0.0,1.0
5993,16,4,0,24,24,0.0,1.0
5979,16,4,0,33,33,0.0,1.0
5966,16,4,1,25,26,0.038461538461538464,0.9615384615384616
5967,16,4,3,98,101,0.0297029702970297,0.9702970297029703
5970,16,4,0,14,14,0.0,1.0
6188,16,4,3,0,3,1.0,0.0
6096,16,4,1,0,1,1.0,0.0
6069,16,4,0,17,17,0.0,1.0
5937,16,4,0,6,6,0.0,1.0
5990,16,4,0,50,50,0.0,1.0
5928,16,4,0,22,22,0.0,1.0
6058,16,4,11,58,69,0.15942028985507245,0.8405797101449275
6001,16,4,0,24,24,0.0,1.0
5964,16,4,1,9,10,0.1,0.9
5950,16,4,1,6,7,0.14285714285714285,0.8571428571428571
5991,16,4,0,20,20,0.0,1.0
6177,16,4,0,3,3,0.0,1.0
5961,16,4,0,45,45,0.0,1.0
5938,16,4,3,337,340,0.008823529411764706,0.9911764705882353
5960,16,4,0,36,36,0.0,1.0
5947,16,4,0,78,78,0.0,1.0
5957,16,4,3,4,7,0.42857142857142855,0.5714285714285714
6043,16,4,0,29,29,0.0,1.0
6014,16,4,6,4,10,0.6,0.4
6015,16,4,1,1,2,0.5,0.5
5978,16,4,0,16,16,0.0,1.0
5986,16,4,2,2,4,0.5,0.5
5969,16,4,0,4,4,0.0,1.0
5949,16,4,0,30,30,0.0,1.0
5959,16,4,1,39,40,0.025,0.975
6051,16,4,0,108,108,0.0,1.0
6029,16,4,1,19,20,0.05,0.95
6070,16,4,3,1,4,0.75,0.25
5942,16,4,0,108,108,0.0,1.0
5953,16,4,0,28,28,0.0,1.0
6076,16,4,2,12,14,0.14285714285714285,0.8571428571428571
5940,16,4,2,7,9,0.2222222222222222,0.7777777777777778
6109,16,4,0,95,95,0.0,1.0
6187,16,4,2,4,6,0.3333333333333333,0.6666666666666666
6053,16,4,0,15,15,0.0,1.0
6104,16,4,3,1,4,0.75,0.25
5943,16,4,0,9,9,0.0,1.0
6168,16,4,0,240,240,0.0,1.0
5989,16,4,0,6,6,0.0,1.0
5963,16,4,3,17,20,0.15,0.85
6194,16,4,0,80,80,0.0,1.0
6003,16,4,1,237,238,0.004201680672268907,0.9957983193277311
6167,16,4,1,9,10,0.1,0.9
6004,16,4,2,133,135,0.014814814814814815,0.9851851851851852
6054,16,4,0,14,14,0.0,1.0
6170,16,4,1,33,34,0.029411764705882353,0.9705882352941176
6063,16,4,5,5,10,0.5,0.5
5988,16,4,0,17,17,0.0,1.0
6075,16,4,1,11,12,0.08333333333333333,0.9166666666666666
6061,16,4,0,26,26,0.0,1.0
5965,16,4,0,45,45,0.0,1.0
6040,16,4,8,4,12,0.6666666666666666,0.3333333333333333
6106,16,4,2,28,30,0.06666666666666667,0.9333333333333333
6082,16,4,0,13,13,0.0,1.0
6031,16,4,1,24,25,0.04,0.96
6039,16,4,0,58,58,0.0,1.0
6189,17,4,1,21,22,0.045454545454545456,0.9545454545454546
5936,17,4,0,31,31,0.0,1.0
6087,17,4,0,18,18,0.0,1.0
5973,17,4,0,34,34,0.0,1.0
6085,17,4,0,34,34,0.0,1.0
5948,17,4,1,41,42,0.023809523809523808,0.9761904761904762
5974,17,4,0,10,10,0.0,1.0
6090,17,4,0,1,1,0.0,1.0
6068,17,4,0,35,35,0.0,1.0
6024,17,4,2,0,2,1.0,0.0
5976,17,4,1,79,80,0.0125,0.9875
5962,17,4,0,59,59,0.0,1.0
6033,17,4,0,24,24,0.0,1.0
6038,17,4,0,7,7,0.0,1.0
6042,17,4,0,49,49,0.0,1.0
5924,17,4,0,50,50,0.0,1.0
6083,17,4,1,11,12,0.08333333333333333,0.9166666666666666
6178,17,4,1,224,225,0.0044444444444444444,0.9955555555555555
6086,17,4,0,25,25,0.0,1.0
5945,17,4,0,95,95,0.0,1.0
5925,17,4,0,122,122,0.0,1.0
5935,17,4,0,3,3,0.0,1.0
6073,17,4,0,7,7,0.0,1.0
5980,17,4,0,12,12,0.0,1.0
5993,17,4,0,24,24,0.0,1.0
5979,17,4,0,33,33,0.0,1.0
5966,17,4,0,26,26,0.0,1.0
5967,17,4,3,98,101,0.0297029702970297,0.9702970297029703
5970,17,4,0,14,14,0.0,1.0
6188,17,4,2,1,3,0.6666666666666666,0.3333333333333333
6096,17,4,1,0,1,1.0,0.0
6069,17,4,0,17,17,0.0,1.0
5937,17,4,0,6,6,0.0,1.0
5990,17,4,0,50,50,0.0,1.0
5928,17,4,0,22,22,0.0,1.0
6058,17,4,4,65,69,0.057971014492753624,0.9420289855072463
6001,17,4,1,23,24,0.041666666666666664,0.9583333333333334
5964,17,4,1,9,10,0.1,0.9
5950,17,4,0,7,7,0.0,1.0
5991,17,4,0,20,20,0.0,1.0
6177,17,4,0,3,3,0.0,1.0
5961,17,4,0,45,45,0.0,1.0
5938,17,4,3,337,340,0.008823529411764706,0.9911764705882353
5960,17,4,0,36,36,0.0,1.0
5947,17,4,0,78,78,0.0,1.0
5957,17,4,4,3,7,0.5714285714285714,0.42857142857142855
6043,17,4,0,29,29,0.0,1.0
6014,17,4,9,1,10,0.9,0.1
6015,17,4,1,1,2,0.5,0.5
5978,17,4,0,16,16,0.0,1.0
5986,17,4,2,2,4,0.5,0.5
5969,17,4,0,4,4,0.0,1.0
5949,17,4,0,30,30,0.0,1.0
5959,17,4,1,39,40,0.025,0.975
6051,17,4,0,108,108,0.0,1.0
6029,17,4,0,20,20,0.0,1.0
6070,17,4,3,1,4,0.75,0.25
5942,17,4,0,108,108,0.0,1.0
5953,17,4,0,28,28,0.0,1.0
6076,17,4,2,12,14,0.14285714285714285,0.8571428571428571
5940,17,4,3,6,9,0.3333333333333333,0.6666666666666666
6109,17,4,7,88,95,0.07368421052631578,0.9263157894736842
6187,17,4,2,4,6,0.3333333333333333,0.6666666666666666
6053,17,4,0,15,15,0.0,1.0
6104,17,4,4,0,4,1.0,0.0
5943,17,4,0,9,9,0.0,1.0
6168,17,4,0,240,240,0.0,1.0
5989,17,4,0,6,6,0.0,1.0
5963,17,4,1,19,20,0.05,0.95
6194,17,4,0,80,80,0.0,1.0
6003,17,4,1,237,238,0.004201680672268907,0.9957983193277311
6167,17,4,2,8,10,0.2,0.8
6004,17,4,2,133,135,0.014814814814814815,0.9851851851851852
6054,17,4,0,14,14,0.0,1.0
6170,17,4,4,30,34,0.11764705882352941,0.8823529411764706
6063,17,4,5,5,10,0.5,0.5
5988,17,4,0,17,17,0.0,1.0
6075,17,4,1,11,12,0.08333333333333333,0.9166666666666666
6061,17,4,0,26,26,0.0,1.0
5965,17,4,0,45,45,0.0,1.0
6040,17,4,7,5,12,0.5833333333333334,0.4166666666666667
6106,17,4,1,29,30,0.03333333333333333,0.9666666666666667
6082,17,4,0,13,13,0.0,1.0
6031,17,4,1,24,25,0.04,0.96
6039,17,4,1,57,58,0.017241379310344827,0.9827586206896551
6189,18,4,2,20,22,0.09090909090909091,0.9090909090909091
5936,18,4,0,31,31,0.0,1.0
6087,18,4,0,18,18,0.0,1.0
5973,18,4,0,34,34,0.0,1.0
6085,18,4,0,34,34,0.0,1.0
5948,18,4,1,41,42,0.023809523809523808,0.9761904761904762
5974,18,4,0,10,10,0.0,1.0
6090,18,4,0,1,1,0.0,1.0
6068,18,4,0,35,35,0.0,1.0
6024,18,4,1,1,2,0.5,0.5
5976,18,4,2,78,80,0.025,0.975
5962,18,4,0,59,59,0.0,1.0
6033,18,4,2,22,24,0.08333333333333333,0.9166666666666666
6038,18,4,0,7,7,0.0,1.0
6042,18,4,0,49,49,0.0,1.0
5924,18,4,0,50,50,0.0,1.0
6083,18,4,0,12,12,0.0,1.0
6178,18,4,0,225,225,0.0,1.0
6086,18,4,0,25,25,0.0,1.0
5945,18,4,0,95,95,0.0,1.0
5925,18,4,0,122,122,0.0,1.0
5935,18,4,0,3,3,0.0,1.0
6073,18,4,1,6,7,0.14285714285714285,0.8571428571428571
5980,18,4,0,12,12,0.0,1.0
5993,18,4,0,24,24,0.0,1.0
5979,18,4,0,33,33,0.0,1.0
5966,18,4,3,23,26,0.11538461538461539,0.8846153846153846
5967,18,4,3,98,101,0.0297029702970297,0.9702970297029703
5970,18,4,0,14,14,0.0,1.0
6188,18,4,1,2,3,0.3333333333333333,0.6666666666666666
6096,18,4,1,0,1,1.0,0.0
6069,18,4,0,17,17,0.0,1.0
5937,18,4,0,6,6,0.0,1.0
5990,18,4,0,50,50,0.0,1.0
5928,18,4,0,22,22,0.0,1.0
6058,18,4,3,66,69,0.043478260869565216,0.9565217391304348
6001,18,4,2,22,24,0.08333333333333333,0.9166666666666666
5964,18,4,0,10,10,0.0,1.0
5950,18,4,0,7,7,0.0,1.0
5991,18,4,0,20,20,0.0,1.0
6177,18,4,0,3,3,0.0,1.0
5961,18,4,0,45,45,0.0,1.0
5938,18,4,1,339,340,0.0029411764705882353,0.9970588235294118
5960,18,4,0,36,36,0.0,1.0
5947,18,4,0,78,78,0.0,1.0
5957,18,4,5,2,7,0.7142857142857143,0.2857142857142857
6043,18,4,0,29,29,0.0,1.0
6014,18,4,7,3,10,0.7,0.3
6015,18,4,2,0,2,1.0,0.0
5978,18,4,0,16,16,0.0,1.0
5986,18,4,2,2,4,0.5,0.5
5969,18,4,0,4,4,0.0,1.0
5949,18,4,0,30,30,0.0,1.0
5959,18,4,0,40,40,0.0,1.0
6051,18,4,0,108,108,0.0,1.0
6029,18,4,1,19,20,0.05,0.95
6070,18,4,3,1,4,0.75,0.25
5942,18,4,0,108,108,0.0,1.0
5953,18,4,0,28,28,0.0,1.0
6076,18,4,1,13,14,0.07142857142857142,0.9285714285714286
5940,18,4,7,2,9,0.7777777777777778,0.2222222222222222
6109,18,4,1,94,95,0.010526315789473684,0.9894736842105263
6187,18,4,0,6,6,0.0,1.0
6053,18,4,0,15,15,0.0,1.0
6104,18,4,2,2,4,0.5,0.5
5943,18,4,0,9,9,0.0,1.0
6168,18,4,0,240,240,0.0,1.0
5989,18,4,0,6,6,0.0,1.0
5963,18,4,1,19,20,0.05,0.95
6194,18,4,0,80,80,0.0,1.0
6003,18,4,1,237,238,0.004201680672268907,0.9957983193277311
6167,18,4,2,8,10,0.2,0.8
6004,18,4,1,134,135,0.007407407407407408,0.9925925925925926
6054,18,4,0,14,14,0.0,1.0
6170,18,4,1,33,34,0.029411764705882353,0.9705882352941176
6063,18,4,3,7,10,0.3,0.7
5988,18,4,0,17,17,0.0,1.0
6075,18,4,1,11,12,0.08333333333333333,0.9166666666666666
6061,18,4,0,26,26,0.0,1.0
5965,18,4,0,45,45,0.0,1.0
6040,18,4,9,3,12,0.75,0.25
6106,18,4,0,30,30,0.0,1.0
6082,18,4,0,13,13,0.0,1.0
6031,18,4,0,25,25,0.0,1.0
6039,18,4,1,57,58,0.017241379310344827,0.9827586206896551
6189,19,4,2,20,22,0.09090909090909091,0.9090909090909091
5936,19,4,0,31,31,0.0,1.0
6087,19,4,0,18,18,0.0,1.0
5973,19,4,0,34,34,0.0,1.0
6085,19,4,0,34,34,0.0,1.0
5948,19,4,0,42,42,0.0,1.0
5974,19,4,0,10,10,0.0,1.0
6090,19,4,0,1,1,0.0,1.0
6068,19,4,0,35,35,0.0,1.0
6024,19,4,1,1,2,0.5,0.5
5976,19,4,0,80,80,0.0,1.0
5962,19,4,0,59,59,0.0,1.0
6033,19,4,0,24,24,0.0,1.0
6038,19,4,0,7,7,0.0,1.0
6042,19,4,0,49,49,0.0,1.0
5924,19,4,0,50,50,0.0,1.0
6083,19,4,0,12,12,0.0,1.0
6178,19,4,0,225,225,0.0,1.0
6086,19,4,0,25,25,0.0,1.0
5945,19,4,0,95,95,0.0,1.0
5925,19,4,0,122,122,0.0,1.0
5935,19,4,0,3,3,0.0,1.0
6073,19,4,1,6,7,0.14285714285714285,0.8571428571428571
5980,19,4,0,12,12,0.0,1.0
5993,19,4,0,24,24,0.0,1.0
5979,19,4,0,33,33,0.0,1.0
5966,19,4,2,24,26,0.07692307692307693,0.9230769230769231
5967,19,4,3,98,101,0.0297029702970297,0.9702970297029703
5970,19,4,0,14,14,0.0,1.0
6188,19,4,1,2,3,0.3333333333333333,0.6666666666666666
6096,19,4,1,0,1,1.0,0.0
6069,19,4,0,17,17,0.0,1.0
5937,19,4,0,6,6,0.0,1.0
5990,19,4,0,50,50,0.0,1.0
5928,19,4,0,22,22,0.0,1.0
6058,19,4,6,63,69,0.08695652173913043,0.9130434782608695
6001,19,4,2,22,24,0.08333333333333333,0.9166666666666666
5964,19,4,1,9,10,0.1,0.9
5950,19,4,0,7,7,0.0,1.0
5991,19,4,0,20,20,0.0,1.0
6177,19,4,0,3,3,0.0,1.0
5961,19,4,0,45,45,0.0,1.0
5938,19,4,0,340,340,0.0,1.0
5960,19,4,0,36,36,0.0,1.0
5947,19,4,0,78,78,0.0,1.0
5957,19,4,2,5,7,0.2857142857142857,0.7142857142857143
6043,19,4,0,29,29,0.0,1.0
6014,19,4,8,2,10,0.8,0.2
6015,19,4,2,0,2,1.0,0.0
5978,19,4,2,14,16,0.125,0.875
5986,19,4,3,1,4,0.75,0.25
5969,19,4,0,4,4,0.0,1.0
5949,19,4,0,30,30,0.0,1.0
5959,19,4,1,39,40,0.025,0.975
6051,19,4,0,108,108,0.0,1.0
6029,19,4,0,20,20,0.0,1.0
6070,19,4,3,1,4,0.75,0.25
5942,19,4,0,108,108,0.0,1.0
5953,19,4,0,28,28,0.0,1.0
6076,19,4,0,14,14,0.0,1.0
5940,19,4,5,4,9,0.5555555555555556,0.4444444444444444
6109,19,4,3,92,95,0.031578947368421054,0.968421052631579
6187,19,4,2,4,6,0.3333333333333333,0.6666666666666666
6053,19,4,0,15,15,0.0,1.0
6104,19,4,4,0,4,1.0,0.0
5943,19,4,4,5,9,0.4444444444444444,0.5555555555555556
6168,19,4,0,240,240,0.0,1.0
5989,19,4,0,6,6,0.0,1.0
5963,19,4,1,19,20,0.05,0.95
6194,19,4,0,80,80,0.0,1.0
6003,19,4,1,237,238,0.004201680672268907,0.9957983193277311
6167,19,4,1,9,10,0.1,0.9
6004,19,4,1,134,135,0.007407407407407408,0.9925925925925926
6054,19,4,0,14,14,0.0,1.0
6170,19,4,0,34,34,0.0,1.0
6063,19,4,2,8,10,0.2,0.8
5988,19,4,0,17,17,0.0,1.0
6075,19,4,2,10,12,0.16666666666666666,0.8333333333333334
6061,19,4,0,26,26,0.0,1.0
5965,19,4,0,45,45,0.0,1.0
6040,19,4,9,3,12,0.75,0.25
6106,19,4,2,28,30,0.06666666666666667,0.9333333333333333
6082,19,4,0,13,13,0.0,1.0
6031,19,4,2,23,25,0.08,0.92
6039,19,4,0,58,58,0.0,1.0
6189,20,4,0,22,22,0.0,1.0
5936,20,4,0,31,31,0.0,1.0
6087,20,4,0,18,18,0.0,1.0
5973,20,4,0,34,34,0.0,1.0
6085,20,4,0,34,34,0.0,1.0
5948,20,4,1,41,42,0.023809523809523808,0.9761904761904762
5974,20,4,0,10,10,0.0,1.0
6090,20,4,0,1,1,0.0,1.0
6068,20,4,0,35,35,0.0,1.0
6024,20,4,2,0,2,1.0,0.0
5976,20,4,3,77,80,0.0375,0.9625
5962,20,4,0,59,59,0.0,1.0
6033,20,4,2,22,24,0.08333333333333333,0.9166666666666666
6038,20,4,0,7,7,0.0,1.0
6042,20,4,0,49,49,0.0,1.0
5924,20,4,0,50,50,0.0,1.0
6083,20,4,0,12,12,0.0,1.0
6178,20,4,0,225,225,0.0,1.0
6086,20,4,0,25,25,0.0,1.0
5945,20,4,0,95,95,0.0,1.0
5925,20,4,0,122,122,0.0,1.0
5935,20,4,0,3,3,0.0,1.0
6073,20,4,3,4,7,0.42857142857142855,0.5714285714285714
5980,20,4,0,12,12,0.0,1.0
5993,20,4,0,24,24,0.0,1.0
5979,20,4,0,33,33,0.0,1.0
5966,20,4,1,25,26,0.038461538461538464,0.9615384615384616
5967,20,4,3,98,101,0.0297029702970297,0.9702970297029703
5970,20,4,0,14,14,0.0,1.0
6188,20,4,0,3,3,0.0,1.0
6096,20,4,1,0,1,1.0,0.0
6069,20,4,0,17,17,0.0,1.0
5937,20,4,0,6,6,0.0,1.0
5990,20,4,0,50,50,0.0,1.0
5928,20,4,0,22,22,0.0,1.0
6058,20,4,9,60,69,0.13043478260869565,0.8695652173913043
6001,20,4,2,22,24,0.08333333333333333,0.9166666666666666
5964,20,4,1,9,10,0.1,0.9
5950,20,4,3,4,7,0.42857142857142855,0.5714285714285714
5991,20,4,0,20,20,0.0,1.0
6177,20,4,0,3,3,0.0,1.0
5961,20,4,0,45,45,0.0,1.0
5938,20,4,0,340,340,0.0,1.0
5960,20,4,0,36,36,0.0,1.0
5947,20,4,0,78,78,0.0,1.0
5957,20,4,1,6,7,0.14285714285714285,0.8571428571428571
6043,20,4,0,29,29,0.0,1.0
6014,20,4,8,2,10,0.8,0.2
6015,20,4,1,1,2,0.5,0.5
5978,20,4,1,15,16,0.0625,0.9375
5986,20,4,3,1,4,0.75,0.25
5969,20,4,1,3,4,0.25,0.75
5949,20,4,0,30,30,0.0,1.0
5959,20,4,1,39,40,0.025,0.975
6051,20,4,0,108,108,0.0,1.0
6029,20,4,0,20,20,0.0,1.0
6070,20,4,3,1,4,0.75,0.25
5942,20,4,0,108,108,0.0,1.0
5953,20,4,0,28,28,0.0,1.0
6076,20,4,1,13,14,0.07142857142857142,0.9285714285714286
5940,20,4,5,4,9,0.5555555555555556,0.4444444444444444
6109,20,4,0,95,95,0.0,1.0
6187,20,4,0,6,6,0.0,1.0
6053,20,4,0,15,15,0.0,1.0
6104,20,4,3,1,4,0.75,0.25
5943,20,4,0,9,9,0.0,1.0
6168,20,4,0,240,240,0.0,1.0
5989,20,4,0,6,6,0.0,1.0
5963,20,4,1,19,20,0.05,0.95
6194,20,4,0,80,80,0.0,1.0
6003,20,4,0,238,238,0.0,1.0
6167,20,4,0,10,10,0.0,1.0
6004,20,4,1,134,135,0.007407407407407408,0.9925925925925926
6054,20,4,0,14,14,0.0,1.0
6170,20,4,1,33,34,0.029411764705882353,0.9705882352941176
6063,20,4,2,8,10,0.2,0.8
5988,20,4,0,17,17,0.0,1.0
6075,20,4,0,12,12,0.0,1.0
6061,20,4,0,26,26,0.0,1.0
5965,20,4,0,45,45,0.0,1.0
6040,20,4,6,6,12,0.5,0.5
6106,20,4,1,29,30,0.03333333333333333,0.9666666666666667
6082,20,4,2,11,13,0.15384615384615385,0.8461538461538461
6031,20,4,0,25,25,0.0,1.0
6039,20,4,3,55,58,0.05172413793103448,0.9482758620689655
6189,21,4,1,21,22,0.045454545454545456,0.9545454545454546
5936,21,4,0,31,31,0.0,1.0
6087,21,4,0,18,18,0.0,1.0
5973,21,4,0,34,34,0.0,1.0
6085,21,4,0,34,34,0.0,1.0
5948,21,4,1,41,42,0.023809523809523808,0.9761904761904762
5974,21,4,0,10,10,0.0,1.0
6090,21,4,0,1,1,0.0,1.0
6068,21,4,0,35,35,0.0,1.0
6024,21,4,1,1,2,0.5,0.5
5976,21,4,1,79,80,0.0125,0.9875
5962,21,4,0,59,59,0.0,1.0
6033,21,4,4,20,24,0.16666666666666666,0.8333333333333334
6038,21,4,0,7,7,0.0,1.0
6042,21,4,0,49,49,0.0,1.0
5924,21,4,0,50,50,0.0,1.0
6083,21,4,5,7,12,0.4166666666666667,0.5833333333333334
6178,21,4,0,225,225,0.0,1.0
6086,21,4,0,25,25,0.0,1.0
5945,21,4,0,95,95,0.0,1.0
5925,21,4,0,122,122,0.0,1.0
5935,21,4,0,3,3,0.0,1.0
6073,21,4,0,7,7,0.0,1.0
5980,21,4,2,10,12,0.16666666666666666,0.8333333333333334
5993,21,4,0,24,24,0.0,1.0
5979,21,4,0,33,33,0.0,1.0
5966,21,4,2,24,26,0.07692307692307693,0.9230769230769231
5967,21,4,1,100,101,0.009900990099009901,0.9900990099009901
5970,21,4,0,14,14,0.0,1.0
6188,21,4,0,3,3,0.0,1.0
6096,21,4,1,0,1,1.0,0.0
6069,21,4,0,17,17,0.0,1.0
5937,21,4,0,6,6,0.0,1.0
5990,21,4,0,50,50,0.0,1.0
5928,21,4,0,22,22,0.0,1.0
6058,21,4,1,68,69,0.014492753623188406,0.9855072463768116
6001,21,4,2,22,24,0.08333333333333333,0.9166666666666666
5964,21,4,0,10,10,0.0,1.0
5950,21,4,1,6,7,0.14285714285714285,0.8571428571428571
5991,21,4,0,20,20,0.0,1.0
6177,21,4,0,3,3,0.0,1.0
5961,21,4,0,45,45,0.0,1.0
5938,21,4,2,338,340,0.0058823529411764705,0.9941176470588236
5960,21,4,0,36,36,0.0,1.0
5947,21,4,0,78,78,0.0,1.0
5957,21,4,5,2,7,0.7142857142857143,0.2857142857142857
6043,21,4,0,29,29,0.0,1.0
6014,21,4,4,6,10,0.4,0.6
6015,21,4,1,1,2,0.5,0.5
5978,21,4,0,16,16,0.0,1.0
5986,21,4,1,3,4,0.25,0.75
5969,21,4,0,4,4,0.0,1.0
5949,21,4,0,30,30,0.0,1.0
5959,21,4,0,40,40,0.0,1.0
6051,21,4,0,108,108,0.0,1.0
6029,21,4,0,20,20,0.0,1.0
6070,21,4,2,2,4,0.5,0.5
5942,21,4,0,108,108,0.0,1.0
5953,21,4,0,28,28,0.0,1.0
6076,21,4,1,13,14,0.07142857142857142,0.9285714285714286
5940,21,4,2,7,9,0.2222222222222222,0.7777777777777778
6109,21,4,1,94,95,0.010526315789473684,0.9894736842105263
6187,21,4,0,6,6,0.0,1.0
6053,21,4,0,15,15,0.0,1.0
6104,21,4,1,3,4,0.25,0.75
5943,21,4,4,5,9,0.4444444444444444,0.5555555555555556
6168,21,4,0,240,240,0.0,1.0
5989,21,4,0,6,6,0.0,1.0
5963,21,4,1,19,20,0.05,0.95
6194,21,4,0,80,80,0.0,1.0
6003,21,4,1,237,238,0.004201680672268907,0.9957983193277311
6167,21,4,0,10,10,0.0,1.0
6004,21,4,1,134,135,0.007407407407407408,0.9925925925925926
6054,21,4,0,14,14,0.0,1.0
6170,21,4,6,28,34,0.17647058823529413,0.8235294117647058
6063,21,4,4,6,10,0.4,0.6
5988,21,4,0,17,17,0.0,1.0
6075,21,4,1,11,12,0.08333333333333333,0.9166666666666666
6061,21,4,0,26,26,0.0,1.0
5965,21,4,0,45,45,0.0,1.0
6040,21,4,3,9,12,0.25,0.75
6106,21,4,1,29,30,0.03333333333333333,0.9666666666666667
6082,21,4,0,13,13,0.0,1.0
6031,21,4,1,24,25,0.04,0.96
6039,21,4,0,58,58,0.0,1.0
6189,22,4,6,16,22,0.2727272727272727,0.7272727272727273
5936,22,4,0,31,31,0.0,1.0
6087,22,4,0,18,18,0.0,1.0
5973,22,4,0,34,34,0.0,1.0
6085,22,4,0,34,34,0.0,1.0
5948,22,4,0,42,42,0.0,1.0
5974,22,4,0,10,10,0.0,1.0
6090,22,4,0,1,1,0.0,1.0
6068,22,4,0,35,35,0.0,1.0
6024,22,4,1,1,2,0.5,0.5
5976,22,4,3,77,80,0.0375,0.9625
5962,22,4,0,59,59,0.0,1.0
6033,22,4,2,22,24,0.08333333333333333,0.9166666666666666
6038,22,4,0,7,7,0.0,1.0
6042,22,4,0,49,49,0.0,1.0
5924,22,4,0,50,50,0.0,1.0
6083,22,4,3,9,12,0.25,0.75
6178,22,4,0,225,225,0.0,1.0
6086,22,4,0,25,25,0.0,1.0
5945,22,4,0,95,95,0.0,1.0
5925,22,4,0,122,122,0.0,1.0
5935,22,4,0,3,3,0.0,1.0
6073,22,4,1,6,7,0.14285714285714285,0.8571428571428571
5980,22,4,0,12,12,0.0,1.0
5993,22,4,0,24,24,0.0,1.0
5979,22,4,0,33,33,0.0,1.0
5966,22,4,0,26,26,0.0,1.0
5967,22,4,2,99,101,0.019801980198019802,0.9801980198019802
5970,22,4,0,14,14,0.0,1.0
6188,22,4,0,3,3,0.0,1.0
6096,22,4,1,0,1,1.0,0.0
6069,22,4,0,17,17,0.0,1.0
5937,22,4,0,6,6,0.0,1.0
5990,22,4,0,50,50,0.0,1.0
5928,22,4,0,22,22,0.0,1.0
6058,22,4,3,66,69,0.043478260869565216,0.9565217391304348
6001,22,4,0,24,24,0.0,1.0
5964,22,4,4,6,10,0.4,0.6
5950,22,4,0,7,7,0.0,1.0
5991,22,4,0,20,20,0.0,1.0
6177,22,4,0,3,3,0.0,1.0
5961,22,4,0,45,45,0.0,1.0
5938,22,4,0,340,340,0.0,1.0
5960,22,4,0,36,36,0.0,1.0
5947,22,4,0,78,78,0.0,1.0
5957,22,4,1,6,7,0.14285714285714285,0.8571428571428571
6043,22,4,0,29,29,0.0,1.0
6014,22,4,5,5,10,0.5,0.5
6015,22,4,2,0,2,1.0,0.0
5978,22,4,1,15,16,0.0625,0.9375
5986,22,4,3,1,4,0.75,0.25
5969,22,4,1,3,4,0.25,0.75
5949,22,4,0,30,30,0.0,1.0
5959,22,4,0,40,40,0.0,1.0
6051,22,4,0,108,108,0.0,1.0
6029,22,4,0,20,20,0.0,1.0
6070,22,4,2,2,4,0.5,0.5
5942,22,4,0,108,108,0.0,1.0
5953,22,4,0,28,28,0.0,1.0
6076,22,4,1,13,14,0.07142857142857142,0.9285714285714286
5940,22,4,3,6,9,0.3333333333333333,0.6666666666666666
6109,22,4,1,94,95,0.010526315789473684,0.9894736842105263
6187,22,4,0,6,6,0.0,1.0
6053,22,4,0,15,15,0.0,1.0
6104,22,4,3,1,4,0.75,0.25
5943,22,4,0,9,9,0.0,1.0
6168,22,4,0,240,240,0.0,1.0
5989,22,4,0,6,6,0.0,1.0
5963,22,4,4,16,20,0.2,0.8
6194,22,4,0,80,80,0.0,1.0
6003,22,4,0,238,238,0.0,1.0
6167,22,4,0,10,10,0.0,1.0
6004,22,4,0,135,135,0.0,1.0
6054,22,4,0,14,14,0.0,1.0
6170,22,4,0,34,34,0.0,1.0
6063,22,4,5,5,10,0.5,0.5
5988,22,4,0,17,17,0.0,1.0
6075,22,4,0,12,12,0.0,1.0
6061,22,4,0,26,26,0.0,1.0
5965,22,4,0,45,45,0.0,1.0
6040,22,4,5,7,12,0.4166666666666667,0.5833333333333334
6106,22,4,1,29,30,0.03333333333333333,0.9666666666666667
6082,22,4,0,13,13,0.0,1.0
6031,22,4,0,25,25,0.0,1.0
6039,22,4,4,54,58,0.06896551724137931,0.9310344827586207
6189,23,4,3,19,22,0.13636363636363635,0.8636363636363636
5936,23,4,0,31,31,0.0,1.0
6087,23,4,0,18,18,0.0,1.0
5973,23,4,0,34,34,0.0,1.0
6085,23,4,0,34,34,0.0,1.0
5948,23,4,1,41,42,0.023809523809523808,0.9761904761904762
5974,23,4,0,10,10,0.0,1.0
6090,23,4,0,1,1,0.0,1.0
6068,23,4,0,35,35,0.0,1.0
6024,23,4,1,1,2,0.5,0.5
5976,23,4,1,79,80,0.0125,0.9875
5962,23,4,0,59,59,0.0,1.0
6033,23,4,2,22,24,0.08333333333333333,0.9166666666666666
6038,23,4,0,7,7,0.0,1.0
6042,23,4,0,49,49,0.0,1.0
5924,23,4,0,50,50,0.0,1.0
6083,23,4,2,10,12,0.16666666666666666,0.8333333333333334
6178,23,4,0,225,225,0.0,1.0
6086,23,4,0,25,25,0.0,1.0
5945,23,4,0,95,95,0.0,1.0
5925,23,4,0,122,122,0.0,1.0
5935,23,4,0,3,3,0.0,1.0
6073,23,4,1,6,7,0.14285714285714285,0.8571428571428571
5980,23,4,0,12,12,0.0,1.0
5993,23,4,0,24,24,0.0,1.0
5979,23,4,0,33,33,0.0,1.0
5966,23,4,3,23,26,0.11538461538461539,0.8846153846153846
5967,23,4,0,101,101,0.0,1.0
5970,23,4,0,14,14,0.0,1.0
6188,23,4,0,3,3,0.0,1.0
6096,23,4,1,0,1,1.0,0.0
6069,23,4,0,17,17,0.0,1.0
5937,23,4,0,6,6,0.0,1.0
5990,23,4,0,50,50,0.0,1.0
5928,23,4,0,22,22,0.0,1.0
6058,23,4,2,67,69,0.028985507246376812,0.9710144927536232
6001,23,4,3,21,24,0.125,0.875
5964,23,4,0,10,10,0.0,1.0
5950,23,4,0,7,7,0.0,1.0
5991,23,4,0,20,20,0.0,1.0
6177,23,4,0,3,3,0.0,1.0
5961,23,4,0,45,45,0.0,1.0
5938,23,4,0,340,340,0.0,1.0
5960,23,4,0,36,36,0.0,1.0
5947,23,4,0,78,78,0.0,1.0
5957,23,4,1,6,7,0.14285714285714285,0.8571428571428571
6043,23,4,0,29,29,0.0,1.0
6014,23,4,6,4,10,0.6,0.4
6015,23,4,1,1,2,0.5,0.5
5978,23,4,1,15,16,0.0625,0.9375
5986,23,4,2,2,4,0.5,0.5
5969,23,4,0,4,4,0.0,1.0
5949,23,4,3,27,30,0.1,0.9
5959,23,4,1,39,40,0.025,0.975
6051,23,4,0,108,108,0.0,1.0
6029,23,4,1,19,20,0.05,0.95
6070,23,4,1,3,4,0.25,0.75
5942,23,4,0,108,108,0.0,1.0
5953,23,4,0,28,28,0.0,1.0
6076,23,4,1,13,14,0.07142857142857142,0.9285714285714286
5940,23,4,2,7,9,0.2222222222222222,0.7777777777777778
6109,23,4,1,94,95,0.010526315789473684,0.9894736842105263
6187,23,4,0,6,6,0.0,1.0
6053,23,4,0,15,15,0.0,1.0
6104,23,4,2,2,4,0.5,0.5
5943,23,4,0,9,9,0.0,1.0
6168,23,4,0,240,240,0.0,1.0
5989,23,4,0,6,6,0.0,1.0
5963,23,4,1,19,20,0.05,0.95
6194,23,4,0,80,80,0.0,1.0
6003,23,4,1,237,238,0.004201680672268907,0.9957983193277311
6167,23,4,1,9,10,0.1,0.9
6004,23,4,1,134,135,0.007407407407407408,0.9925925925925926
6054,23,4,0,14,14,0.0,1.0
6170,23,4,0,34,34,0.0,1.0
6063,23,4,4,6,10,0.4,0.6
5988,23,4,0,17,17,0.0,1.0
6075,23,4,0,12,12,0.0,1.0
6061,23,4,0,26,26,0.0,1.0
5965,23,4,0,45,45,0.0,1.0
6040,23,4,1,11,12,0.08333333333333333,0.9166666666666666
6106,23,4,1,29,30,0.03333333333333333,0.9666666666666667
6082,23,4,0,13,13,0.0,1.0
6031,23,4,2,23,25,0.08,0.92
6039,23,4,0,58,58,0.0,1.0
6189,24,4,1,21,22,0.045454545454545456,0.9545454545454546
5936,24,4,0,31,31,0.0,1.0
6087,24,4,0,18,18,0.0,1.0
5973,24,4,0,34,34,0.0,1.0
6085,24,4,0,34,34,0.0,1.0
5948,24,4,1,41,42,0.023809523809523808,0.9761904761904762
5974,24,4,0,10,10,0.0,1.0
6090,24,4,0,1,1,0.0,1.0
6068,24,4,0,35,35,0.0,1.0
6024,24,4,2,0,2,1.0,0.0
5976,24,4,0,80,80,0.0,1.0
5962,24,4,0,59,59,0.0,1.0
6033,24,4,0,24,24,0.0,1.0
6038,24,4,0,7,7,0.0,1.0
6042,24,4,0,49,49,0.0,1.0
5924,24,4,0,50,50,0.0,1.0
6083,24,4,1,11,12,0.08333333333333333,0.9166666666666666
6178,24,4,0,225,225,0.0,1.0
6086,24,4,0,25,25,0.0,1.0
5945,24,4,0,95,95,0.0,1.0
5925,24,4,0,122,122,0.0,1.0
5935,24,4,0,3,3,0.0,1.0
6073,24,4,0,7,7,0.0,1.0
5980,24,4,0,12,12,0.0,1.0
5993,24,4,0,24,24,0.0,1.0
5979,24,4,0,33,33,0.0,1.0
5966,24,4,0,26,26,0.0,1.0
5967,24,4,1,100,101,0.009900990099009901,0.9900990099009901
5970,24,4,0,14,14,0.0,1.0
6188,24,4,0,3,3,0.0,1.0
6096,24,4,1,0,1,1.0,0.0
6069,24,4,0,17,17,0.0,1.0
5937,24,4,0,6,6,0.0,1.0
5990,24,4,0,50,50,0.0,1.0
5928,24,4,0,22,22,0.0,1.0
6058,24,4,4,65,69,0.057971014492753624,0.9420289855072463
6001,24,4,4,20,24,0.16666666666666666,0.8333333333333334
5964,24,4,0,10,10,0.0,1.0
5950,24,4,0,7,7,0.0,1.0
5991,24,4,0,20,20,0.0,1.0
6177,24,4,0,3,3,0.0,1.0
5961,24,4,0,45,45,0.0,1.0
5938,24,4,0,340,340,0.0,1.0
5960,24,4,0,36,36,0.0,1.0
5947,24,4,0,78,78,0.0,1.0
5957,24,4,2,5,7,0.2857142857142857,0.7142857142857143
6043,24,4,0,29,29,0.0,1.0
6014,24,4,7,3,10,0.7,0.3
6015,24,4,1,1,2,0.5,0.5
5978,24,4,1,15,16,0.0625,0.9375
5986,24,4,1,3,4,0.25,0.75
5969,24,4,0,4,4,0.0,1.0
5949,24,4,0,30,30,0.0,1.0
5959,24,4,7,33,40,0.175,0.825
6051,24,4,0,108,108,0.0,1.0
6029,24,4,1,19,20,0.05,0.95
6070,24,4,1,3,4,0.25,0.75
5942,24,4,0,108,108,0.0,1.0
5953,24,4,0,28,28,0.0,1.0
6076,24,4,1,13,14,0.07142857142857142,0.9285714285714286
5940,24,4,1,8,9,0.1111111111111111,0.8888888888888888
6109,24,4,0,95,95,0.0,1.0
6187,24,4,0,6,6,0.0,1.0
6053,24,4,0,15,15,0.0,1.0
6104,24,4,3,1,4,0.75,0.25
5943,24,4,0,9,9,0.0,1.0
6168,24,4,0,240,240,0.0,1.0
5989,24,4,0,6,6,0.0,1.0
5963,24,4,1,19,20,0.05,0.95
6194,24,4,0,80,80,0.0,1.0
6003,24,4,0,238,238,0.0,1.0
6167,24,4,0,10,10,0.0,1.0
6004,24,4,0,135,135,0.0,1.0
6054,24,4,0,14,14,0.0,1.0
6170,24,4,1,33,34,0.029411764705882353,0.9705882352941176
6063,24,4,6,4,10,0.6,0.4
5988,24,4,0,17,17,0.0,1.0
6075,24,4,0,12,12,0.0,1.0
6061,24,4,0,26,26,0.0,1.0
5965,24,4,0,45,45,0.0,1.0
6040,24,4,2,10,12,0.16666666666666666,0.8333333333333334
6106,24,4,1,29,30,0.03333333333333333,0.9666666666666667
6082,24,4,2,11,13,0.15384615384615385,0.8461538461538461
6031,24,4,1,24,25,0.04,0.96
6039,24,4,1,57,58,0.017241379310344827,0.9827586206896551
6189,25,4,1,21,22,0.045454545454545456,0.9545454545454546
5936,25,4,0,31,31,0.0,1.0
6087,25,4,0,18,18,0.0,1.0
5973,25,4,0,34,34,0.0,1.0
6085,25,4,0,34,34,0.0,1.0
5948,25,4,1,41,42,0.023809523809523808,0.9761904761904762
5974,25,4,0,10,10,0.0,1.0
6090,25,4,0,1,1,0.0,1.0
6068,25,4,0,35,35,0.0,1.0
6024,25,4,1,1,2,0.5,0.5
5976,25,4,1,79,80,0.0125,0.9875
5962,25,4,0,59,59,0.0,1.0
6033,25,4,2,22,24,0.08333333333333333,0.9166666666666666
6038,25,4,0,7,7,0.0,1.0
6042,25,4,0,49,49,0.0,1.0
5924,25,4,0,50,50,0.0,1.0
6083,25,4,2,10,12,0.16666666666666666,0.8333333333333334
6178,25,4,0,225,225,0.0,1.0
6086,25,4,0,25,25,0.0,1.0
5945,25,4,0,95,95,0.0,1.0
5925,25,4,0,122,122,0.0,1.0
5935,25,4,0,3,3,0.0,1.0
6073,25,4,0,7,7,0.0,1.0
5980,25,4,0,12,12,0.0,1.0
5993,25,4,0,24,24,0.0,1.0
5979,25,4,0,33,33,0.0,1.0
5966,25,4,0,26,26,0.0,1.0
5967,25,4,1,100,101,0.009900990099009901,0.9900990099009901
5970,25,4,0,14,14,0.0,1.0
6188,25,4,1,2,3,0.3333333333333333,0.6666666666666666
6096,25,4,1,0,1,1.0,0.0
6069,25,4,0,17,17,0.0,1.0
5937,25,4,0,6,6,0.0,1.0
5990,25,4,0,50,50,0.0,1.0
5928,25,4,0,22,22,0.0,1.0
6058,25,4,1,68,69,0.014492753623188406,0.9855072463768116
6001,25,4,3,21,24,0.125,0.875
5964,25,4,0,10,10,0.0,1.0
5950,25,4,2,5,7,0.2857142857142857,0.7142857142857143
5991,25,4,0,20,20,0.0,1.0
6177,25,4,0,3,3,0.0,1.0
5961,25,4,0,45,45,0.0,1.0
5938,25,4,0,340,340,0.0,1.0
5960,25,4,0,36,36,0.0,1.0
5947,25,4,0,78,78,0.0,1.0
5957,25,4,0,7,7,0.0,1.0
6043,25,4,0,29,29,0.0,1.0
6014,25,4,6,4,10,0.6,0.4
6015,25,4,1,1,2,0.5,0.5
5978,25,4,0,16,16,0.0,1.0
5986,25,4,2,2,4,0.5,0.5
5969,25,4,0,4,4,0.0,1.0
5949,25,4,0,30,30,0.0,1.0
5959,25,4,0,40,40,0.0,1.0
6051,25,4,0,108,108,0.0,1.0
6029,25,4,0,20,20,0.0,1.0
6070,25,4,0,4,4,0.0,1.0
5942,25,4,0,108,108,0.0,1.0
5953,25,4,0,28,28,0.0,1.0
6076,25,4,0,14,14,0.0,1.0
5940,25,4,2,7,9,0.2222222222222222,0.7777777777777778
6109,25,4,0,95,95,0.0,1.0
6187,25,4,0,6,6,0.0,1.0
6053,25,4,0,15,15,0.0,1.0
6104,25,4,2,2,4,0.5,0.5
5943,25,4,0,9,9,0.0,1.0
6168,25,4,0,240,240,0.0,1.0
5989,25,4,0,6,6,0.0,1.0
5963,25,4,1,19,20,0.05,0.95
6194,25,4,0,80,80,0.0,1.0
6003,25,4,1,237,238,0.004201680672268907,0.9957983193277311
6167,25,4,1,9,10,0.1,0.9
6004,25,4,1,134,135,0.007407407407407408,0.9925925925925926
6054,25,4,0,14,14,0.0,1.0
6170,25,4,1,33,34,0.029411764705882353,0.9705882352941176
6063,25,4,3,7,10,0.3,0.7
5988,25,4,0,17,17,0.0,1.0
6075,25,4,2,10,12,0.16666666666666666,0.8333333333333334
6061,25,4,0,26,26,0.0,1.0
5965,25,4,0,45,45,0.0,1.0
6040,25,4,4,8,12,0.3333333333333333,0.6666666666666666
6106,25,4,1,29,30,0.03333333333333333,0.9666666666666667
6082,25,4,0,13,13,0.0,1.0
6031,25,4,1,24,25,0.04,0.96
6039,25,4,3,55,58,0.05172413793103448,0.9482758620689655
6189,26,4,1,21,22,0.045454545454545456,0.9545454545454546
5936,26,4,0,31,31,0.0,1.0
6087,26,4,0,18,18,0.0,1.0
5973,26,4,0,34,34,0.0,1.0
6085,26,4,0,34,34,0.0,1.0
5948,26,4,1,41,42,0.023809523809523808,0.9761904761904762
5974,26,4,0,10,10,0.0,1.0
6090,26,4,0,1,1,0.0,1.0
6068,26,4,0,35,35,0.0,1.0
6024,26,4,2,0,2,1.0,0.0
5976,26,4,1,79,80,0.0125,0.9875
5962,26,4,0,59,59,0.0,1.0
6033,26,4,2,22,24,0.08333333333333333,0.9166666666666666
6038,26,4,0,7,7,0.0,1.0
6042,26,4,0,49,49,0.0,1.0
5924,26,4,0,50,50,0.0,1.0
6083,26,4,2,10,12,0.16666666666666666,0.8333333333333334
6178,26,4,0,225,225,0.0,1.0
6086,26,4,0,25,25,0.0,1.0
5945,26,4,0,95,95,0.0,1.0
5925,26,4,0,122,122,0.0,1.0
5935,26,4,0,3,3,0.0,1.0
6073,26,4,0,7,7,0.0,1.0
5980,26,4,0,12,12,0.0,1.0
5993,26,4,0,24,24,0.0,1.0
5979,26,4,0,33,33,0.0,1.0
5966,26,4,0,26,26,0.0,1.0
5967,26,4,1,100,101,0.009900990099009901,0.9900990099009901
5970,26,4,0,14,14,0.0,1.0
6188,26,4,0,3,3,0.0,1.0
6096,26,4,1,0,1,1.0,0.0
6069,26,4,0,17,17,0.0,1.0
5937,26,4,0,6,6,0.0,1.0
5990,26,4,0,50,50,0.0,1.0
5928,26,4,0,22,22,0.0,1.0
6058,26,4,2,67,69,0.028985507246376812,0.9710144927536232
6001,26,4,0,24,24,0.0,1.0
5964,26,4,0,10,10,0.0,1.0
5950,26,4,1,6,7,0.14285714285714285,0.8571428571428571
5991,26,4,0,20,20,0.0,1.0
6177,26,4,0,3,3,0.0,1.0
5961,26,4,0,45,45,0.0,1.0
5938,26,4,0,340,340,0.0,1.0
5960,26,4,0,36,36,0.0,1.0
5947,26,4,0,78,78,0.0,1.0
5957,26,4,2,5,7,0.2857142857142857,0.7142857142857143
6043,26,4,0,29,29,0.0,1.0
6014,26,4,7,3,10,0.7,0.3
6015,26,4,1,1,2,0.5,0.5
5978,26,4,0,16,16,0.0,1.0
5986,26,4,3,1,4,0.75,0.25
5969,26,4,0,4,4,0.0,1.0
5949,26,4,0,30,30,0.0,1.0
5959,26,4,1,39,40,0.025,0.975
6051,26,4,0,108,108,0.0,1.0
6029,26,4,1,19,20,0.05,0.95
6070,26,4,2,2,4,0.5,0.5
5942,26,4,0,108,108,0.0,1.0
5953,26,4,0,28,28,0.0,1.0
6076,26,4,1,13,14,0.07142857142857142,0.9285714285714286
5940,26,4,4,5,9,0.4444444444444444,0.5555555555555556
6109,26,4,1,94,95,0.010526315789473684,0.9894736842105263
6187,26,4,0,6,6,0.0,1.0
6053,26,4,0,15,15,0.0,1.0
6104,26,4,1,3,4,0.25,0.75
5943,26,4,0,9,9,0.0,1.0
6168,26,4,0,240,240,0.0,1.0
5989,26,4,0,6,6,0.0,1.0
5963,26,4,1,19,20,0.05,0.95
6194,26,4,0,80,80,0.0,1.0
6003,26,4,0,238,238,0.0,1.0
6167,26,4,0,10,10,0.0,1.0
6004,26,4,0,135,135,0.0,1.0
6054,26,4,0,14,14,0.0,1.0
6170,26,4,1,33,34,0.029411764705882353,0.9705882352941176
6063,26,4,0,10,10,0.0,1.0
5988,26,4,0,17,17,0.0,1.0
6075,26,4,2,10,12,0.16666666666666666,0.8333333333333334
6061,26,4,0,26,26,0.0,1.0
5965,26,4,0,45,45,0.0,1.0
6040,26,4,4,8,12,0.3333333333333333,0.6666666666666666
6106,26,4,2,28,30,0.06666666666666667,0.9333333333333333
6082,26,4,0,13,13,0.0,1.0
6031,26,4,2,23,25,0.08,0.92
6039,26,4,0,58,58,0.0,1.0
6189,27,4,3,19,22,0.13636363636363635,0.8636363636363636
5936,27,4,0,31,31,0.0,1.0
6087,27,4,0,18,18,0.0,1.0
5973,27,4,0,34,34,0.0,1.0
6085,27,4,0,34,34,0.0,1.0
5948,27,4,0,42,42,0.0,1.0
5974,27,4,0,10,10,0.0,1.0
6090,27,4,0,1,1,0.0,1.0
6068,27,4,0,35,35,0.0,1.0
6024,27,4,1,1,2,0.5,0.5
5976,27,4,0,80,80,0.0,1.0
5962,27,4,0,59,59,0.0,1.0
6033,27,4,0,24,24,0.0,1.0
6038,27,4,0,7,7,0.0,1.0
6042,27,4,0,49,49,0.0,1.0
5924,27,4,0,50,50,0.0,1.0
6083,27,4,1,11,12,0.08333333333333333,0.9166666666666666
6178,27,4,0,225,225,0.0,1.0
6086,27,4,0,25,25,0.0,1.0
5945,27,4,0,95,95,0.0,1.0
5925,27,4,0,122,122,0.0,1.0
5935,27,4,0,3,3,0.0,1.0
6073,27,4,2,5,7,0.2857142857142857,0.7142857142857143
5980,27,4,0,12,12,0.0,1.0
5993,27,4,0,24,24,0.0,1.0
5979,27,4,0,33,33,0.0,1.0
5966,27,4,0,26,26,0.0,1.0
5967,27,4,1,100,101,0.009900990099009901,0.9900990099009901
5970,27,4,0,14,14,0.0,1.0
6188,27,4,0,3,3,0.0,1.0
6096,27,4,1,0,1,1.0,0.0
6069,27,4,0,17,17,0.0,1.0
5937,27,4,0,6,6,0.0,1.0
5990,27,4,0,50,50,0.0,1.0
5928,27,4,0,22,22,0.0,1.0
6058,27,4,1,68,69,0.014492753623188406,0.9855072463768116
6001,27,4,2,22,24,0.08333333333333333,0.9166666666666666
5964,27,4,4,6,10,0.4,0.6
5950,27,4,1,6,7,0.14285714285714285,0.8571428571428571
5991,27,4,0,20,20,0.0,1.0
6177,27,4,0,3,3,0.0,1.0
5961,27,4,0,45,45,0.0,1.0
5938,27,4,0,340,340,0.0,1.0
5960,27,4,0,36,36,0.0,1.0
5947,27,4,0,78,78,0.0,1.0
5957,27,4,2,5,7,0.2857142857142857,0.7142857142857143
6043,27,4,0,29,29,0.0,1.0
6014,27,4,3,7,10,0.3,0.7
6015,27,4,1,1,2,0.5,0.5
5978,27,4,0,16,16,0.0,1.0
5986,27,4,3,1,4,0.75,0.25
5969,27,4,0,4,4,0.0,1.0
5949,27,4,3,27,30,0.1,0.9
5959,27,4,2,38,40,0.05,0.95
6051,27,4,0,108,108,0.0,1.0
6029,27,4,1,19,20,0.05,0.95
6070,27,4,0,4,4,0.0,1.0
5942,27,4,0,108,108,0.0,1.0
5953,27,4,0,28,28,0.0,1.0
6076,27,4,0,14,14,0.0,1.0
5940,27,4,3,6,9,0.3333333333333333,0.6666666666666666
6109,27,4,0,95,95,0.0,1.0
6187,27,4,2,4,6,0.3333333333333333,0.6666666666666666
6053,27,4,0,15,15,0.0,1.0
6104,27,4,2,2,4,0.5,0.5
5943,27,4,0,9,9,0.0,1.0
6168,27,4,0,240,240,0.0,1.0
5989,27,4,0,6,6,0.0,1.0
5963,27,4,1,19,20,0.05,0.95
6194,27,4,0,80,80,0.0,1.0
6003,27,4,1,237,238,0.004201680672268907,0.9957983193277311
6167,27,4,0,10,10,0.0,1.0
6004,27,4,0,135,135,0.0,1.0
6054,27,4,0,14,14,0.0,1.0
6170,27,4,0,34,34,0.0,1.0
6063,27,4,2,8,10,0.2,0.8
5988,27,4,0,17,17,0.0,1.0
6075,27,4,1,11,12,0.08333333333333333,0.9166666666666666
6061,27,4,0,26,26,0.0,1.0
5965,27,4,0,45,45,0.0,1.0
6040,27,4,2,10,12,0.16666666666666666,0.8333333333333334
6106,27,4,1,29,30,0.03333333333333333,0.9666666666666667
6082,27,4,0,13,13,0.0,1.0
6031,27,4,1,24,25,0.04,0.96
6039,27,4,0,58,58,0.0,1.0
6189,28,4,3,19,22,0.13636363636363635,0.8636363636363636
5936,28,4,0,31,31,0.0,1.0
6087,28,4,0,18,18,0.0,1.0
5973,28,4,0,34,34,0.0,1.0
6085,28,4,0,34,34,0.0,1.0
5948,28,4,1,41,42,0.023809523809523808,0.9761904761904762
5974,28,4,0,10,10,0.0,1.0
6090,28,4,0,1,1,0.0,1.0
6068,28,4,0,35,35,0.0,1.0
6024,28,4,2,0,2,1.0,0.0
5976,28,4,0,80,80,0.0,1.0
5962,28,4,0,59,59,0.0,1.0
6033,28,4,0,24,24,0.0,1.0
6038,28,4,0,7,7,0.0,1.0
6042,28,4,0,49,49,0.0,1.0
5924,28,4,0,50,50,0.0,1.0
6083,28,4,1,11,12,0.08333333333333333,0.9166666666666666
6178,28,4,0,225,225,0.0,1.0
6086,28,4,0,25,25,0.0,1.0
5945,28,4,0,95,95,0.0,1.0
5925,28,4,0,122,122,0.0,1.0
5935,28,4,0,3,3,0.0,1.0
6073,28,4,1,6,7,0.14285714285714285,0.8571428571428571
5980,28,4,0,12,12,0.0,1.0
5993,28,4,0,24,24,0.0,1.0
5979,28,4,0,33,33,0.0,1.0
5966,28,4,0,26,26,0.0,1.0
5967,28,4,1,100,101,0.009900990099009901,0.9900990099009901
5970,28,4,0,14,14,0.0,1.0
6188,28,4,0,3,3,0.0,1.0
6096,28,4,1,0,1,1.0,0.0
6069,28,4,0,17,17,0.0,1.0
5937,28,4,0,6,6,0.0,1.0
5990,28,4,0,50,50,0.0,1.0
5928,28,4,0,22,22,0.0,1.0
6058,28,4,0,69,69,0.0,1.0
6001,28,4,1,23,24,0.041666666666666664,0.9583333333333334
5964,28,4,1,9,10,0.1,0.9
5950,28,4,1,6,7,0.14285714285714285,0.8571428571428571
5991,28,4,0,20,20,0.0,1.0
6177,28,4,0,3,3,0.0,1.0
5961,28,4,0,45,45,0.0,1.0
5938,28,4,1,339,340,0.0029411764705882353,0.9970588235294118
5960,28,4,0,36,36,0.0,1.0
5947,28,4,0,78,78,0.0,1.0
5957,28,4,1,6,7,0.14285714285714285,0.8571428571428571
6043,28,4,0,29,29,0.0,1.0
6014,28,4,2,8,10,0.2,0.8
6015,28,4,1,1,2,0.5,0.5
5978,28,4,1,15,16,0.0625,0.9375
5986,28,4,1,3,4,0.25,0.75
5969,28,4,0,4,4,0.0,1.0
5949,28,4,0,30,30,0.0,1.0
5959,28,4,1,39,40,0.025,0.975
6051,28,4,0,108,108,0.0,1.0
6029,28,4,0,20,20,0.0,1.0
6070,28,4,3,1,4,0.75,0.25
5942,28,4,0,108,108,0.0,1.0
5953,28,4,0,28,28,0.0,1.0
6076,28,4,1,13,14,0.07142857142857142,0.9285714285714286
5940,28,4,2,7,9,0.2222222222222222,0.7777777777777778
6109,28,4,0,95,95,0.0,1.0
6187,28,4,2,4,6,0.3333333333333333,0.6666666666666666
6053,28,4,0,15,15,0.0,1.0
6104,28,4,2,2,4,0.5,0.5
5943,28,4,0,9,9,0.0,1.0
6168,28,4,0,240,240,0.0,1.0
5989,28,4,0,6,6,0.0,1.0
5963,28,4,0,20,20,0.0,1.0
6194,28,4,0,80,80,0.0,1.0
6003,28,4,0,238,238,0.0,1.0
6167,28,4,0,10,10,0.0,1.0
6004,28,4,1,134,135,0.007407407407407408,0.9925925925925926
6054,28,4,0,14,14,0.0,1.0
6170,28,4,0,34,34,0.0,1.0
6063,28,4,2,8,10,0.2,0.8
5988,28,4,0,17,17,0.0,1.0
6075,28,4,1,11,12,0.08333333333333333,0.9166666666666666
6061,28,4,0,26,26,0.0,1.0
5965,28,4,0,45,45,0.0,1.0
6040,28,4,4,8,12,0.3333333333333333,0.6666666666666666
6106,28,4,2,28,30,0.06666666666666667,0.9333333333333333
6082,28,4,0,13,13,0.0,1.0
6031,28,4,1,24,25,0.04,0.96
6039,28,4,1,57,58,0.017241379310344827,0.9827586206896551
6189,29,4,1,21,22,0.045454545454545456,0.9545454545454546
5936,29,4,0,31,31,0.0,1.0
6087,29,4,0,18,18,0.0,1.0
5973,29,4,0,34,34,0.0,1.0
6085,29,4,0,34,34,0.0,1.0
5948,29,4,1,41,42,0.023809523809523808,0.9761904761904762
5974,29,4,0,10,10,0.0,1.0
6090,29,4,0,1,1,0.0,1.0
6068,29,4,0,35,35,0.0,1.0
6024,29,4,2,0,2,1.0,0.0
5976,29,4,1,79,80,0.0125,0.9875
5962,29,4,0,59,59,0.0,1.0
6033,29,4,4,20,24,0.16666666666666666,0.8333333333333334
6038,29,4,0,7,7,0.0,1.0
6042,29,4,0,49,49,0.0,1.0
5924,29,4,0,50,50,0.0,1.0
6083,29,4,1,11,12,0.08333333333333333,0.9166666666666666
6178,29,4,0,225,225,0.0,1.0
6086,29,4,0,25,25,0.0,1.0
5945,29,4,0,95,95,0.0,1.0
5925,29,4,0,122,122,0.0,1.0
5935,29,4,0,3,3,0.0,1.0
6073,29,4,1,6,7,0.14285714285714285,0.8571428571428571
5980,29,4,0,12,12,0.0,1.0
5993,29,4,0,24,24,0.0,1.0
5979,29,4,0,33,33,0.0,1.0
5966,29,4,0,26,26,0.0,1.0
5967,29,4,1,100,101,0.009900990099009901,0.9900990099009901
5970,29,4,0,14,14,0.0,1.0
6188,29,4,0,3,3,0.0,1.0
6096,29,4,1,0,1,1.0,0.0
6069,29,4,0,17,17,0.0,1.0
5937,29,4,0,6,6,0.0,1.0
5990,29,4,0,50,50,0.0,1.0
5928,29,4,0,22,22,0.0,1.0
6058,29,4,1,68,69,0.014492753623188406,0.9855072463768116
6001,29,4,2,22,24,0.08333333333333333,0.9166666666666666
5964,29,4,1,9,10,0.1,0.9
5950,29,4,1,6,7,0.14285714285714285,0.8571428571428571
5991,29,4,0,20,20,0.0,1.0
6177,29,4,0,3,3,0.0,1.0
5961,29,4,0,45,45,0.0,1.0
5938,29,4,0,340,340,0.0,1.0
5960,29,4,0,36,36,0.0,1.0
5947,29,4,0,78,78,0.0,1.0
5957,29,4,1,6,7,0.14285714285714285,0.8571428571428571
6043,29,4,0,29,29,0.0,1.0
6014,29,4,3,7,10,0.3,0.7
6015,29,4,1,1,2,0.5,0.5
5978,29,4,1,15,16,0.0625,0.9375
5986,29,4,2,2,4,0.5,0.5
5969,29,4,0,4,4,0.0,1.0
5949,29,4,0,30,30,0.0,1.0
5959,29,4,0,40,40,0.0,1.0
6051,29,4,0,108,108,0.0,1.0
6029,29,4,0,20,20,0.0,1.0
6070,29,4,2,2,4,0.5,0.5
5942,29,4,0,108,108,0.0,1.0
5953,29,4,0,28,28,0.0,1.0
6076,29,4,1,13,14,0.07142857142857142,0.9285714285714286
5940,29,4,3,6,9,0.3333333333333333,0.6666666666666666
6109,29,4,0,95,95,0.0,1.0
6187,29,4,2,4,6,0.3333333333333333,0.6666666666666666
6053,29,4,0,15,15,0.0,1.0
6104,29,4,3,1,4,0.75,0.25
5943,29,4,0,9,9,0.0,1.0
6168,29,4,0,240,240,0.0,1.0
5989,29,4,0,6,6,0.0,1.0
5963,29,4,2,18,20,0.1,0.9
6194,29,4,0,80,80,0.0,1.0
6003,29,4,0,238,238,0.0,1.0
6167,29,4,0,10,10,0.0,1.0
6004,29,4,1,134,135,0.007407407407407408,0.9925925925925926
6054,29,4,0,14,14,0.0,1.0
6170,29,4,0,34,34,0.0,1.0
6063,29,4,1,9,10,0.1,0.9
5988,29,4,0,17,17,0.0,1.0
6075,29,4,2,10,12,0.16666666666666666,0.8333333333333334
6061,29,4,0,26,26,0.0,1.0
5965,29,4,0,45,45,0.0,1.0
6040,29,4,3,9,12,0.25,0.75
6106,29,4,1,29,30,0.03333333333333333,0.9666666666666667
6082,29,4,0,13,13,0.0,1.0
6031,29,4,1,24,25,0.04,0.96
6039,29,4,0,58,58,0.0,1.0
