user_id,radius,iteration,FN,TP,test_size,FN_p,TP_p
6189,0,0,0,18,18,0.0,1.0
5936,0,0,6,0,6,1.0,0.0
6087,0,0,2,9,11,0.18181818181818182,0.8181818181818182
5973,0,0,5,843,848,0.00589622641509434,0.9941037735849056
6085,0,0,12,0,12,1.0,0.0
6012,0,0,0,62,62,0.0,1.0
5982,0,0,0,6,6,0.0,1.0
5948,0,0,0,57,57,0.0,1.0
5974,0,0,6,0,6,1.0,0.0
6090,0,0,0,4,4,0.0,1.0
6068,0,0,3,0,3,1.0,0.0
5962,0,0,35,6,41,0.8536585365853658,0.14634146341463414
6033,0,0,1,0,1,1.0,0.0
6038,0,0,2,0,2,1.0,0.0
6042,0,0,86,11,97,0.8865979381443299,0.1134020618556701
5924,0,0,3,0,3,1.0,0.0
6083,0,0,0,27,27,0.0,1.0
6178,0,0,18,0,18,1.0,0.0
5958,0,0,4,0,4,1.0,0.0
6086,0,0,0,14,14,0.0,1.0
5945,0,0,19,0,19,1.0,0.0
5935,0,0,5,0,5,1.0,0.0
6073,0,0,15,0,15,1.0,0.0
5980,0,0,45,0,45,1.0,0.0
5993,0,0,172,311,483,0.35610766045548653,0.6438923395445134
6037,0,0,162,61,223,0.726457399103139,0.273542600896861
5979,0,0,5,0,5,1.0,0.0
5966,0,0,0,73,73,0.0,1.0
5985,0,0,3,0,3,1.0,0.0
5967,0,0,0,76,76,0.0,1.0
6188,0,0,22,0,22,1.0,0.0
6041,0,0,0,12,12,0.0,1.0
5972,0,0,13,0,13,1.0,0.0
6069,0,0,1,3,4,0.25,0.75
5937,0,0,1,0,1,1.0,0.0
6028,0,0,31,0,31,1.0,0.0
5990,0,0,0,130,130,0.0,1.0
5928,0,0,241,240,481,0.501039501039501,0.498960498960499
5992,0,0,4,0,4,1.0,0.0
6058,0,0,13,0,13,1.0,0.0
6001,0,0,28,1,29,0.9655172413793104,0.034482758620689655
5964,0,0,31,0,31,1.0,0.0
5950,0,0,4,0,4,1.0,0.0
5991,0,0,8,0,8,1.0,0.0
6177,0,0,254,55,309,0.8220064724919094,0.1779935275080906
5961,0,0,0,321,321,0.0,1.0
6176,0,0,0,93,93,0.0,1.0
5956,0,0,0,31,31,0.0,1.0
5938,0,0,82,557,639,0.12832550860719874,0.8716744913928013
6179,0,0,28,0,28,1.0,0.0
5947,0,0,54,6,60,0.9,0.1
5927,0,0,17,438,455,0.03736263736263736,0.9626373626373627
5977,0,0,7,299,306,0.02287581699346405,0.9771241830065359
6198,0,0,0,5,5,0.0,1.0
5957,0,0,0,45,45,0.0,1.0
6057,0,0,29,0,29,1.0,0.0
6043,0,0,8,0,8,1.0,0.0
6077,0,0,0,4,4,0.0,1.0
6014,0,0,14,0,14,1.0,0.0
6015,0,0,3,0,3,1.0,0.0
5978,0,0,3,0,3,1.0,0.0
5986,0,0,17,33,50,0.34,0.66
5959,0,0,256,103,359,0.713091922005571,0.28690807799442897
6051,0,0,32,6,38,0.8421052631578947,0.15789473684210525
6029,0,0,3,0,3,1.0,0.0
6070,0,0,1,0,1,1.0,0.0
5942,0,0,0,145,145,0.0,1.0
5953,0,0,4,0,4,1.0,0.0
6076,0,0,7,0,7,1.0,0.0
5940,0,0,10,0,10,1.0,0.0
6109,0,0,79,14,93,0.8494623655913979,0.15053763440860216
6187,0,0,3,0,3,1.0,0.0
6053,0,0,0,17,17,0.0,1.0
6104,0,0,9,0,9,1.0,0.0
5943,0,0,2,0,2,1.0,0.0
6017,0,0,3,0,3,1.0,0.0
6168,0,0,13,3,16,0.8125,0.1875
5989,0,0,6,0,6,1.0,0.0
5963,0,0,6,0,6,1.0,0.0
6194,0,0,0,26,26,0.0,1.0
6167,0,0,18,1,19,0.9473684210526315,0.05263157894736842
6004,0,0,0,64,64,0.0,1.0
6030,0,0,6,1,7,0.8571428571428571,0.14285714285714285
6054,0,0,6,0,6,1.0,0.0
6032,0,0,12,0,12,1.0,0.0
6170,0,0,62,2,64,0.96875,0.03125
6063,0,0,3,0,3,1.0,0.0
5988,0,0,1,0,1,1.0,0.0
6075,0,0,3,0,3,1.0,0.0
6061,0,0,0,67,67,0.0,1.0
5965,0,0,44,5,49,0.8979591836734694,0.10204081632653061
6040,0,0,9,1,10,0.9,0.1
6059,0,0,0,85,85,0.0,1.0
6106,0,0,61,2,63,0.9682539682539683,0.031746031746031744
6031,0,0,6,8,14,0.42857142857142855,0.5714285714285714
6180,0,0,0,6,6,0.0,1.0
6039,0,0,28,35,63,0.4444444444444444,0.5555555555555556
6189,1,0,0,18,18,0.0,1.0
5936,1,0,6,0,6,1.0,0.0
6087,1,0,3,8,11,0.2727272727272727,0.7272727272727273
5973,1,0,6,842,848,0.007075471698113208,0.9929245283018868
6085,1,0,12,0,12,1.0,0.0
6012,1,0,0,62,62,0.0,1.0
5982,1,0,1,5,6,0.16666666666666666,0.8333333333333334
5948,1,0,0,57,57,0.0,1.0
5974,1,0,6,0,6,1.0,0.0
6090,1,0,0,4,4,0.0,1.0
6068,1,0,3,0,3,1.0,0.0
5962,1,0,36,5,41,0.8780487804878049,0.12195121951219512
6033,1,0,1,0,1,1.0,0.0
6038,1,0,2,0,2,1.0,0.0
6042,1,0,67,30,97,0.6907216494845361,0.30927835051546393
5924,1,0,3,0,3,1.0,0.0
6083,1,0,0,27,27,0.0,1.0
6178,1,0,18,0,18,1.0,0.0
5958,1,0,4,0,4,1.0,0.0
6086,1,0,0,14,14,0.0,1.0
5945,1,0,18,1,19,0.9473684210526315,0.05263157894736842
5935,1,0,5,0,5,1.0,0.0
6073,1,0,14,1,15,0.9333333333333333,0.06666666666666667
5980,1,0,45,0,45,1.0,0.0
5993,1,0,98,385,483,0.2028985507246377,0.7971014492753623
6037,1,0,109,114,223,0.48878923766816146,0.5112107623318386
5979,1,0,5,0,5,1.0,0.0
5966,1,0,0,73,73,0.0,1.0
5985,1,0,3,0,3,1.0,0.0
5967,1,0,0,76,76,0.0,1.0
6188,1,0,21,1,22,0.9545454545454546,0.045454545454545456
6041,1,0,0,12,12,0.0,1.0
5972,1,0,13,0,13,1.0,0.0
6069,1,0,1,3,4,0.25,0.75
5937,1,0,1,0,1,1.0,0.0
6028,1,0,28,3,31,0.9032258064516129,0.0967741935483871
5990,1,0,0,130,130,0.0,1.0
5928,1,0,150,331,481,0.31185031185031187,0.6881496881496881
5992,1,0,4,0,4,1.0,0.0
6058,1,0,13,0,13,1.0,0.0
6001,1,0,27,2,29,0.9310344827586207,0.06896551724137931
5964,1,0,30,1,31,0.967741935483871,0.03225806451612903
5950,1,0,3,1,4,0.75,0.25
5991,1,0,8,0,8,1.0,0.0
6177,1,0,175,134,309,0.5663430420711975,0.4336569579288026
5961,1,0,0,321,321,0.0,1.0
6176,1,0,0,93,93,0.0,1.0
5956,1,0,0,31,31,0.0,1.0
5938,1,0,62,577,639,0.09702660406885759,0.9029733959311425
6179,1,0,26,2,28,0.9285714285714286,0.07142857142857142
5947,1,0,52,8,60,0.8666666666666667,0.13333333333333333
5927,1,0,13,442,455,0.02857142857142857,0.9714285714285714
5977,1,0,6,300,306,0.0196078431372549,0.9803921568627451
6198,1,0,0,5,5,0.0,1.0
5957,1,0,0,45,45,0.0,1.0
6057,1,0,26,3,29,0.896551724137931,0.10344827586206896
6043,1,0,8,0,8,1.0,0.0
6077,1,0,0,4,4,0.0,1.0
6014,1,0,14,0,14,1.0,0.0
6015,1,0,3,0,3,1.0,0.0
5978,1,0,3,0,3,1.0,0.0
5986,1,0,15,35,50,0.3,0.7
5959,1,0,183,176,359,0.5097493036211699,0.49025069637883006
6051,1,0,28,10,38,0.7368421052631579,0.2631578947368421
6029,1,0,3,0,3,1.0,0.0
6070,1,0,1,0,1,1.0,0.0
5942,1,0,0,145,145,0.0,1.0
5953,1,0,4,0,4,1.0,0.0
6076,1,0,7,0,7,1.0,0.0
5940,1,0,10,0,10,1.0,0.0
6109,1,0,66,27,93,0.7096774193548387,0.2903225806451613
6187,1,0,3,0,3,1.0,0.0
6053,1,0,0,17,17,0.0,1.0
6104,1,0,9,0,9,1.0,0.0
5943,1,0,2,0,2,1.0,0.0
6017,1,0,3,0,3,1.0,0.0
6168,1,0,14,2,16,0.875,0.125
5989,1,0,5,1,6,0.8333333333333334,0.16666666666666666
5963,1,0,6,0,6,1.0,0.0
6194,1,0,0,26,26,0.0,1.0
6167,1,0,18,1,19,0.9473684210526315,0.05263157894736842
6004,1,0,1,63,64,0.015625,0.984375
6030,1,0,6,1,7,0.8571428571428571,0.14285714285714285
6054,1,0,6,0,6,1.0,0.0
6032,1,0,12,0,12,1.0,0.0
6170,1,0,58,6,64,0.90625,0.09375
6063,1,0,3,0,3,1.0,0.0
5988,1,0,1,0,1,1.0,0.0
6075,1,0,3,0,3,1.0,0.0
6061,1,0,0,67,67,0.0,1.0
5965,1,0,40,9,49,0.8163265306122449,0.1836734693877551
6040,1,0,9,1,10,0.9,0.1
6059,1,0,0,85,85,0.0,1.0
6106,1,0,53,10,63,0.8412698412698413,0.15873015873015872
6031,1,0,6,8,14,0.42857142857142855,0.5714285714285714
6180,1,0,0,6,6,0.0,1.0
6039,1,0,24,39,63,0.38095238095238093,0.6190476190476191
6189,2,0,0,18,18,0.0,1.0
5936,2,0,6,0,6,1.0,0.0
6087,2,0,3,8,11,0.2727272727272727,0.7272727272727273
5973,2,0,1,847,848,0.0011792452830188679,0.9988207547169812
6085,2,0,12,0,12,1.0,0.0
6012,2,0,0,62,62,0.0,1.0
5982,2,0,1,5,6,0.16666666666666666,0.8333333333333334
5948,2,0,0,57,57,0.0,1.0
5974,2,0,6,0,6,1.0,0.0
6090,2,0,0,4,4,0.0,1.0
6068,2,0,3,0,3,1.0,0.0
5962,2,0,27,14,41,0.6585365853658537,0.34146341463414637
6033,2,0,0,1,1,0.0,1.0
6038,2,0,2,0,2,1.0,0.0
6042,2,0,43,54,97,0.44329896907216493,0.5567010309278351
5924,2,0,3,0,3,1.0,0.0
6083,2,0,0,27,27,0.0,1.0
6178,2,0,18,0,18,1.0,0.0
5958,2,0,4,0,4,1.0,0.0
6086,2,0,0,14,14,0.0,1.0
5945,2,0,14,5,19,0.7368421052631579,0.2631578947368421
5935,2,0,5,0,5,1.0,0.0
6073,2,0,12,3,15,0.8,0.2
5980,2,0,43,2,45,0.9555555555555556,0.044444444444444446
5993,2,0,46,437,483,0.09523809523809523,0.9047619047619048
6037,2,0,49,174,223,0.21973094170403587,0.7802690582959642
5979,2,0,5,0,5,1.0,0.0
5966,2,0,0,73,73,0.0,1.0
5985,2,0,3,0,3,1.0,0.0
5967,2,0,0,76,76,0.0,1.0
6188,2,0,17,5,22,0.7727272727272727,0.22727272727272727
6041,2,0,0,12,12,0.0,1.0
5972,2,0,13,0,13,1.0,0.0
6069,2,0,1,3,4,0.25,0.75
5937,2,0,1,0,1,1.0,0.0
6028,2,0,22,9,31,0.7096774193548387,0.2903225806451613
5990,2,0,0,130,130,0.0,1.0
5928,2,0,53,428,481,0.1101871101871102,0.8898128898128899
5992,2,0,4,0,4,1.0,0.0
6058,2,0,12,1,13,0.9230769230769231,0.07692307692307693
6001,2,0,22,7,29,0.7586206896551724,0.2413793103448276
5964,2,0,28,3,31,0.9032258064516129,0.0967741935483871
5950,2,0,4,0,4,1.0,0.0
5991,2,0,7,1,8,0.875,0.125
6177,2,0,67,242,309,0.2168284789644013,0.7831715210355987
5961,2,0,0,321,321,0.0,1.0
6176,2,0,0,93,93,0.0,1.0
5956,2,0,0,31,31,0.0,1.0
5938,2,0,29,610,639,0.04538341158059468,0.9546165884194053
6179,2,0,22,6,28,0.7857142857142857,0.21428571428571427
5947,2,0,37,23,60,0.6166666666666667,0.38333333333333336
5927,2,0,2,453,455,0.004395604395604396,0.9956043956043956
5977,2,0,3,303,306,0.00980392156862745,0.9901960784313726
6198,2,0,0,5,5,0.0,1.0
5957,2,0,0,45,45,0.0,1.0
6057,2,0,21,8,29,0.7241379310344828,0.27586206896551724
6043,2,0,8,0,8,1.0,0.0
6077,2,0,0,4,4,0.0,1.0
6014,2,0,12,2,14,0.8571428571428571,0.14285714285714285
6015,2,0,3,0,3,1.0,0.0
5978,2,0,3,0,3,1.0,0.0
5986,2,0,15,35,50,0.3,0.7
5959,2,0,74,285,359,0.20612813370473537,0.7938718662952646
6051,2,0,29,9,38,0.7631578947368421,0.23684210526315788
6029,2,0,3,0,3,1.0,0.0
6070,2,0,1,0,1,1.0,0.0
5942,2,0,0,145,145,0.0,1.0
5953,2,0,4,0,4,1.0,0.0
6076,2,0,7,0,7,1.0,0.0
5940,2,0,8,2,10,0.8,0.2
6109,2,0,36,57,93,0.3870967741935484,0.6129032258064516
6187,2,0,2,1,3,0.6666666666666666,0.3333333333333333
6053,2,0,0,17,17,0.0,1.0
6104,2,0,9,0,9,1.0,0.0
5943,2,0,2,0,2,1.0,0.0
6017,2,0,3,0,3,1.0,0.0
6168,2,0,9,7,16,0.5625,0.4375
5989,2,0,5,1,6,0.8333333333333334,0.16666666666666666
5963,2,0,6,0,6,1.0,0.0
6194,2,0,0,26,26,0.0,1.0
6167,2,0,18,1,19,0.9473684210526315,0.05263157894736842
6004,2,0,0,64,64,0.0,1.0
6030,2,0,6,1,7,0.8571428571428571,0.14285714285714285
6054,2,0,6,0,6,1.0,0.0
6032,2,0,12,0,12,1.0,0.0
6170,2,0,45,19,64,0.703125,0.296875
6063,2,0,3,0,3,1.0,0.0
5988,2,0,1,0,1,1.0,0.0
6075,2,0,3,0,3,1.0,0.0
6061,2,0,0,67,67,0.0,1.0
5965,2,0,19,30,49,0.3877551020408163,0.6122448979591837
6040,2,0,9,1,10,0.9,0.1
6059,2,0,0,85,85,0.0,1.0
6106,2,0,36,27,63,0.5714285714285714,0.42857142857142855
6031,2,0,6,8,14,0.42857142857142855,0.5714285714285714
6180,2,0,0,6,6,0.0,1.0
6039,2,0,22,41,63,0.3492063492063492,0.6507936507936508
6189,3,0,0,18,18,0.0,1.0
5936,3,0,6,0,6,1.0,0.0
6087,3,0,2,9,11,0.18181818181818182,0.8181818181818182
5973,3,0,2,846,848,0.0023584905660377358,0.9976415094339622
6085,3,0,12,0,12,1.0,0.0
6012,3,0,0,62,62,0.0,1.0
5982,3,0,0,6,6,0.0,1.0
5948,3,0,0,57,57,0.0,1.0
5974,3,0,5,1,6,0.8333333333333334,0.16666666666666666
6090,3,0,0,4,4,0.0,1.0
6068,3,0,3,0,3,1.0,0.0
5962,3,0,21,20,41,0.5121951219512195,0.4878048780487805
6033,3,0,0,1,1,0.0,1.0
6038,3,0,2,0,2,1.0,0.0
6042,3,0,35,62,97,0.36082474226804123,0.6391752577319587
5924,3,0,2,1,3,0.6666666666666666,0.3333333333333333
6083,3,0,0,27,27,0.0,1.0
6178,3,0,16,2,18,0.8888888888888888,0.1111111111111111
5958,3,0,3,1,4,0.75,0.25
6086,3,0,0,14,14,0.0,1.0
5945,3,0,10,9,19,0.5263157894736842,0.47368421052631576
5935,3,0,5,0,5,1.0,0.0
6073,3,0,11,4,15,0.7333333333333333,0.26666666666666666
5980,3,0,37,8,45,0.8222222222222222,0.17777777777777778
5993,3,0,33,450,483,0.06832298136645963,0.9316770186335404
6037,3,0,19,204,223,0.08520179372197309,0.9147982062780269
5979,3,0,5,0,5,1.0,0.0
5966,3,0,0,73,73,0.0,1.0
5985,3,0,3,0,3,1.0,0.0
5967,3,0,0,76,76,0.0,1.0
6188,3,0,18,4,22,0.8181818181818182,0.18181818181818182
6041,3,0,0,12,12,0.0,1.0
5972,3,0,12,1,13,0.9230769230769231,0.07692307692307693
6069,3,0,0,4,4,0.0,1.0
5937,3,0,1,0,1,1.0,0.0
6028,3,0,22,9,31,0.7096774193548387,0.2903225806451613
5990,3,0,0,130,130,0.0,1.0
5928,3,0,35,446,481,0.07276507276507277,0.9272349272349273
5992,3,0,4,0,4,1.0,0.0
6058,3,0,12,1,13,0.9230769230769231,0.07692307692307693
6001,3,0,18,11,29,0.6206896551724138,0.3793103448275862
5964,3,0,23,8,31,0.7419354838709677,0.25806451612903225
5950,3,0,3,1,4,0.75,0.25
5991,3,0,4,4,8,0.5,0.5
6177,3,0,30,279,309,0.0970873786407767,0.9029126213592233
5961,3,0,0,321,321,0.0,1.0
6176,3,0,0,93,93,0.0,1.0
5956,3,0,0,31,31,0.0,1.0
5938,3,0,15,624,639,0.023474178403755867,0.9765258215962441
6179,3,0,18,10,28,0.6428571428571429,0.35714285714285715
5947,3,0,39,21,60,0.65,0.35
5927,3,0,9,446,455,0.01978021978021978,0.9802197802197802
5977,3,0,6,300,306,0.0196078431372549,0.9803921568627451
6198,3,0,0,5,5,0.0,1.0
5957,3,0,0,45,45,0.0,1.0
6057,3,0,13,16,29,0.4482758620689655,0.5517241379310345
6043,3,0,8,0,8,1.0,0.0
6077,3,0,0,4,4,0.0,1.0
6014,3,0,11,3,14,0.7857142857142857,0.21428571428571427
6015,3,0,3,0,3,1.0,0.0
5978,3,0,3,0,3,1.0,0.0
5986,3,0,5,45,50,0.1,0.9
5959,3,0,49,310,359,0.13649025069637882,0.8635097493036211
6051,3,0,28,10,38,0.7368421052631579,0.2631578947368421
6029,3,0,2,1,3,0.6666666666666666,0.3333333333333333
6070,3,0,1,0,1,1.0,0.0
5942,3,0,0,145,145,0.0,1.0
5953,3,0,4,0,4,1.0,0.0
6076,3,0,6,1,7,0.8571428571428571,0.14285714285714285
5940,3,0,9,1,10,0.9,0.1
6109,3,0,27,66,93,0.2903225806451613,0.7096774193548387
6187,3,0,2,1,3,0.6666666666666666,0.3333333333333333
6053,3,0,0,17,17,0.0,1.0
6104,3,0,9,0,9,1.0,0.0
5943,3,0,2,0,2,1.0,0.0
6017,3,0,3,0,3,1.0,0.0
6168,3,0,11,5,16,0.6875,0.3125
5989,3,0,6,0,6,1.0,0.0
5963,3,0,6,0,6,1.0,0.0
6194,3,0,0,26,26,0.0,1.0
6167,3,0,15,4,19,0.7894736842105263,0.21052631578947367
6004,3,0,0,64,64,0.0,1.0
6030,3,0,6,1,7,0.8571428571428571,0.14285714285714285
6054,3,0,5,1,6,0.8333333333333334,0.16666666666666666
6032,3,0,11,1,12,0.9166666666666666,0.08333333333333333
6170,3,0,34,30,64,0.53125,0.46875
6063,3,0,3,0,3,1.0,0.0
5988,3,0,1,0,1,1.0,0.0
6075,3,0,3,0,3,1.0,0.0
6061,3,0,0,67,67,0.0,1.0
5965,3,0,19,30,49,0.3877551020408163,0.6122448979591837
6040,3,0,10,0,10,1.0,0.0
6059,3,0,0,85,85,0.0,1.0
6106,3,0,13,50,63,0.20634920634920634,0.7936507936507936
6031,3,0,8,6,14,0.5714285714285714,0.42857142857142855
6180,3,0,0,6,6,0.0,1.0
6039,3,0,23,40,63,0.36507936507936506,0.6349206349206349
6189,4,0,0,18,18,0.0,1.0
5936,4,0,6,0,6,1.0,0.0
6087,4,0,3,8,11,0.2727272727272727,0.7272727272727273
5973,4,0,1,847,848,0.0011792452830188679,0.9988207547169812
6085,4,0,11,1,12,0.9166666666666666,0.08333333333333333
6012,4,0,0,62,62,0.0,1.0
5982,4,0,0,6,6,0.0,1.0
5948,4,0,0,57,57,0.0,1.0
5974,4,0,6,0,6,1.0,0.0
6090,4,0,0,4,4,0.0,1.0
6068,4,0,3,0,3,1.0,0.0
5962,4,0,14,27,41,0.34146341463414637,0.6585365853658537
6033,4,0,0,1,1,0.0,1.0
6038,4,0,2,0,2,1.0,0.0
6042,4,0,26,71,97,0.26804123711340205,0.7319587628865979
5924,4,0,2,1,3,0.6666666666666666,0.3333333333333333
6083,4,0,0,27,27,0.0,1.0
6178,4,0,13,5,18,0.7222222222222222,0.2777777777777778
5958,4,0,3,1,4,0.75,0.25
6086,4,0,0,14,14,0.0,1.0
5945,4,0,5,14,19,0.2631578947368421,0.7368421052631579
5935,4,0,4,1,5,0.8,0.2
6073,4,0,12,3,15,0.8,0.2
5980,4,0,33,12,45,0.7333333333333333,0.26666666666666666
5993,4,0,14,469,483,0.028985507246376812,0.9710144927536232
6037,4,0,17,206,223,0.07623318385650224,0.9237668161434978
5979,4,0,5,0,5,1.0,0.0
5966,4,0,0,73,73,0.0,1.0
5985,4,0,3,0,3,1.0,0.0
5967,4,0,0,76,76,0.0,1.0
6188,4,0,10,12,22,0.45454545454545453,0.5454545454545454
6041,4,0,0,12,12,0.0,1.0
5972,4,0,13,0,13,1.0,0.0
6069,4,0,1,3,4,0.25,0.75
5937,4,0,1,0,1,1.0,0.0
6028,4,0,11,20,31,0.3548387096774194,0.6451612903225806
5990,4,0,0,130,130,0.0,1.0
5928,4,0,26,455,481,0.05405405405405406,0.9459459459459459
5992,4,0,4,0,4,1.0,0.0
6058,4,0,13,0,13,1.0,0.0
6001,4,0,14,15,29,0.4827586206896552,0.5172413793103449
5964,4,0,21,10,31,0.6774193548387096,0.3225806451612903
5950,4,0,3,1,4,0.75,0.25
5991,4,0,4,4,8,0.5,0.5
6177,4,0,21,288,309,0.06796116504854369,0.9320388349514563
5961,4,0,0,321,321,0.0,1.0
6176,4,0,0,93,93,0.0,1.0
5956,4,0,0,31,31,0.0,1.0
5938,4,0,16,623,639,0.025039123630672927,0.974960876369327
6179,4,0,12,16,28,0.42857142857142855,0.5714285714285714
5947,4,0,30,30,60,0.5,0.5
5927,4,0,3,452,455,0.006593406593406593,0.9934065934065934
5977,4,0,3,303,306,0.00980392156862745,0.9901960784313726
6198,4,0,0,5,5,0.0,1.0
5957,4,0,0,45,45,0.0,1.0
6057,4,0,11,18,29,0.3793103448275862,0.6206896551724138
6043,4,0,8,0,8,1.0,0.0
6077,4,0,0,4,4,0.0,1.0
6014,4,0,10,4,14,0.7142857142857143,0.2857142857142857
6015,4,0,3,0,3,1.0,0.0
5978,4,0,3,0,3,1.0,0.0
5986,4,0,6,44,50,0.12,0.88
5959,4,0,39,320,359,0.10863509749303621,0.8913649025069638
6051,4,0,21,17,38,0.5526315789473685,0.4473684210526316
6029,4,0,1,2,3,0.3333333333333333,0.6666666666666666
6070,4,0,1,0,1,1.0,0.0
5942,4,0,0,145,145,0.0,1.0
5953,4,0,4,0,4,1.0,0.0
6076,4,0,6,1,7,0.8571428571428571,0.14285714285714285
5940,4,0,5,5,10,0.5,0.5
6109,4,0,19,74,93,0.20430107526881722,0.7956989247311828
6187,4,0,2,1,3,0.6666666666666666,0.3333333333333333
6053,4,0,0,17,17,0.0,1.0
6104,4,0,9,0,9,1.0,0.0
5943,4,0,2,0,2,1.0,0.0
6017,4,0,2,1,3,0.6666666666666666,0.3333333333333333
6168,4,0,8,8,16,0.5,0.5
5989,4,0,5,1,6,0.8333333333333334,0.16666666666666666
5963,4,0,6,0,6,1.0,0.0
6194,4,0,0,26,26,0.0,1.0
6167,4,0,15,4,19,0.7894736842105263,0.21052631578947367
6004,4,0,0,64,64,0.0,1.0
6030,4,0,6,1,7,0.8571428571428571,0.14285714285714285
6054,4,0,5,1,6,0.8333333333333334,0.16666666666666666
6032,4,0,11,1,12,0.9166666666666666,0.08333333333333333
6170,4,0,23,41,64,0.359375,0.640625
6063,4,0,3,0,3,1.0,0.0
5988,4,0,1,0,1,1.0,0.0
6075,4,0,3,0,3,1.0,0.0
6061,4,0,0,67,67,0.0,1.0
5965,4,0,14,35,49,0.2857142857142857,0.7142857142857143
6040,4,0,10,0,10,1.0,0.0
6059,4,0,0,85,85,0.0,1.0
6106,4,0,12,51,63,0.19047619047619047,0.8095238095238095
6031,4,0,4,10,14,0.2857142857142857,0.7142857142857143
6180,4,0,0,6,6,0.0,1.0
6039,4,0,16,47,63,0.25396825396825395,0.746031746031746
6189,5,0,0,18,18,0.0,1.0
5936,5,0,5,1,6,0.8333333333333334,0.16666666666666666
6087,5,0,1,10,11,0.09090909090909091,0.9090909090909091
5973,5,0,1,847,848,0.0011792452830188679,0.9988207547169812
6085,5,0,8,4,12,0.6666666666666666,0.3333333333333333
6012,5,0,0,62,62,0.0,1.0
5982,5,0,0,6,6,0.0,1.0
5948,5,0,0,57,57,0.0,1.0
5974,5,0,2,4,6,0.3333333333333333,0.6666666666666666
6090,5,0,0,4,4,0.0,1.0
6068,5,0,3,0,3,1.0,0.0
5962,5,0,17,24,41,0.4146341463414634,0.5853658536585366
6033,5,0,0,1,1,0.0,1.0
6038,5,0,2,0,2,1.0,0.0
6042,5,0,15,82,97,0.15463917525773196,0.845360824742268
5924,5,0,2,1,3,0.6666666666666666,0.3333333333333333
6083,5,0,0,27,27,0.0,1.0
6178,5,0,12,6,18,0.6666666666666666,0.3333333333333333
5958,5,0,3,1,4,0.75,0.25
6086,5,0,0,14,14,0.0,1.0
5945,5,0,6,13,19,0.3157894736842105,0.6842105263157895
5935,5,0,4,1,5,0.8,0.2
6073,5,0,12,3,15,0.8,0.2
5980,5,0,26,19,45,0.5777777777777777,0.4222222222222222
5993,5,0,15,468,483,0.031055900621118012,0.968944099378882
6037,5,0,8,215,223,0.03587443946188341,0.9641255605381166
5979,5,0,5,0,5,1.0,0.0
5966,5,0,0,73,73,0.0,1.0
5985,5,0,3,0,3,1.0,0.0
5967,5,0,0,76,76,0.0,1.0
6188,5,0,5,17,22,0.22727272727272727,0.7727272727272727
6041,5,0,0,12,12,0.0,1.0
5972,5,0,11,2,13,0.8461538461538461,0.15384615384615385
6069,5,0,1,3,4,0.25,0.75
5937,5,0,1,0,1,1.0,0.0
6028,5,0,10,21,31,0.3225806451612903,0.6774193548387096
5990,5,0,0,130,130,0.0,1.0
5928,5,0,14,467,481,0.029106029106029108,0.9708939708939709
5992,5,0,4,0,4,1.0,0.0
6058,5,0,11,2,13,0.8461538461538461,0.15384615384615385
6001,5,0,10,19,29,0.3448275862068966,0.6551724137931034
5964,5,0,15,16,31,0.4838709677419355,0.5161290322580645
5950,5,0,4,0,4,1.0,0.0
5991,5,0,6,2,8,0.75,0.25
6177,5,0,22,287,309,0.07119741100323625,0.9288025889967637
5961,5,0,0,321,321,0.0,1.0
6176,5,0,0,93,93,0.0,1.0
5956,5,0,0,31,31,0.0,1.0
5938,5,0,12,627,639,0.018779342723004695,0.9812206572769953
6179,5,0,8,20,28,0.2857142857142857,0.7142857142857143
5947,5,0,16,44,60,0.26666666666666666,0.7333333333333333
5927,5,0,3,452,455,0.006593406593406593,0.9934065934065934
5977,5,0,3,303,306,0.00980392156862745,0.9901960784313726
6198,5,0,0,5,5,0.0,1.0
5957,5,0,0,45,45,0.0,1.0
6057,5,0,7,22,29,0.2413793103448276,0.7586206896551724
6043,5,0,8,0,8,1.0,0.0
6077,5,0,0,4,4,0.0,1.0
6014,5,0,9,5,14,0.6428571428571429,0.35714285714285715
6015,5,0,1,2,3,0.3333333333333333,0.6666666666666666
5978,5,0,3,0,3,1.0,0.0
5986,5,0,5,45,50,0.1,0.9
5959,5,0,19,340,359,0.052924791086350974,0.947075208913649
6051,5,0,13,25,38,0.34210526315789475,0.6578947368421053
6029,5,0,1,2,3,0.3333333333333333,0.6666666666666666
6070,5,0,1,0,1,1.0,0.0
5942,5,0,0,145,145,0.0,1.0
5953,5,0,4,0,4,1.0,0.0
6076,5,0,6,1,7,0.8571428571428571,0.14285714285714285
5940,5,0,5,5,10,0.5,0.5
6109,5,0,12,81,93,0.12903225806451613,0.8709677419354839
6187,5,0,2,1,3,0.6666666666666666,0.3333333333333333
6053,5,0,0,17,17,0.0,1.0
6104,5,0,7,2,9,0.7777777777777778,0.2222222222222222
5943,5,0,2,0,2,1.0,0.0
6017,5,0,2,1,3,0.6666666666666666,0.3333333333333333
6168,5,0,11,5,16,0.6875,0.3125
5989,5,0,5,1,6,0.8333333333333334,0.16666666666666666
5963,5,0,6,0,6,1.0,0.0
6194,5,0,0,26,26,0.0,1.0
6167,5,0,11,8,19,0.5789473684210527,0.42105263157894735
6004,5,0,1,63,64,0.015625,0.984375
6030,5,0,7,0,7,1.0,0.0
6054,5,0,6,0,6,1.0,0.0
6032,5,0,9,3,12,0.75,0.25
6170,5,0,16,48,64,0.25,0.75
6063,5,0,3,0,3,1.0,0.0
5988,5,0,1,0,1,1.0,0.0
6075,5,0,3,0,3,1.0,0.0
6061,5,0,0,67,67,0.0,1.0
5965,5,0,12,37,49,0.24489795918367346,0.7551020408163265
6040,5,0,10,0,10,1.0,0.0
6059,5,0,0,85,85,0.0,1.0
6106,5,0,9,54,63,0.14285714285714285,0.8571428571428571
6031,5,0,2,12,14,0.14285714285714285,0.8571428571428571
6180,5,0,0,6,6,0.0,1.0
6039,5,0,9,54,63,0.14285714285714285,0.8571428571428571
6189,6,0,0,18,18,0.0,1.0
5936,6,0,6,0,6,1.0,0.0
6087,6,0,3,8,11,0.2727272727272727,0.7272727272727273
5973,6,0,0,848,848,0.0,1.0
6085,6,0,10,2,12,0.8333333333333334,0.16666666666666666
6012,6,0,0,62,62,0.0,1.0
5982,6,0,1,5,6,0.16666666666666666,0.8333333333333334
5948,6,0,0,57,57,0.0,1.0
5974,6,0,2,4,6,0.3333333333333333,0.6666666666666666
6090,6,0,0,4,4,0.0,1.0
6068,6,0,3,0,3,1.0,0.0
5962,6,0,14,27,41,0.34146341463414637,0.6585365853658537
6033,6,0,0,1,1,0.0,1.0
6038,6,0,2,0,2,1.0,0.0
6042,6,0,14,83,97,0.14432989690721648,0.8556701030927835
5924,6,0,1,2,3,0.3333333333333333,0.6666666666666666
6083,6,0,0,27,27,0.0,1.0
6178,6,0,11,7,18,0.6111111111111112,0.3888888888888889
5958,6,0,3,1,4,0.75,0.25
6086,6,0,0,14,14,0.0,1.0
5945,6,0,5,14,19,0.2631578947368421,0.7368421052631579
5935,6,0,4,1,5,0.8,0.2
6073,6,0,6,9,15,0.4,0.6
5980,6,0,16,29,45,0.35555555555555557,0.6444444444444445
5993,6,0,10,473,483,0.020703933747412008,0.979296066252588
6037,6,0,2,221,223,0.008968609865470852,0.9910313901345291
5979,6,0,5,0,5,1.0,0.0
5966,6,0,0,73,73,0.0,1.0
5985,6,0,3,0,3,1.0,0.0
5967,6,0,0,76,76,0.0,1.0
6188,6,0,5,17,22,0.22727272727272727,0.7727272727272727
6041,6,0,0,12,12,0.0,1.0
5972,6,0,8,5,13,0.6153846153846154,0.38461538461538464
6069,6,0,1,3,4,0.25,0.75
5937,6,0,1,0,1,1.0,0.0
6028,6,0,11,20,31,0.3548387096774194,0.6451612903225806
5990,6,0,0,130,130,0.0,1.0
5928,6,0,18,463,481,0.037422037422037424,0.9625779625779626
5992,6,0,3,1,4,0.75,0.25
6058,6,0,9,4,13,0.6923076923076923,0.3076923076923077
6001,6,0,7,22,29,0.2413793103448276,0.7586206896551724
5964,6,0,10,21,31,0.3225806451612903,0.6774193548387096
5950,6,0,2,2,4,0.5,0.5
5991,6,0,3,5,8,0.375,0.625
6177,6,0,13,296,309,0.042071197411003236,0.9579288025889967
5961,6,0,0,321,321,0.0,1.0
6176,6,0,0,93,93,0.0,1.0
5956,6,0,0,31,31,0.0,1.0
5938,6,0,6,633,639,0.009389671361502348,0.9906103286384976
6179,6,0,8,20,28,0.2857142857142857,0.7142857142857143
5947,6,0,16,44,60,0.26666666666666666,0.7333333333333333
5927,6,0,1,454,455,0.002197802197802198,0.9978021978021978
5977,6,0,3,303,306,0.00980392156862745,0.9901960784313726
6198,6,0,0,5,5,0.0,1.0
5957,6,0,0,45,45,0.0,1.0
6057,6,0,4,25,29,0.13793103448275862,0.8620689655172413
6043,6,0,8,0,8,1.0,0.0
6077,6,0,0,4,4,0.0,1.0
6014,6,0,10,4,14,0.7142857142857143,0.2857142857142857
6015,6,0,1,2,3,0.3333333333333333,0.6666666666666666
5978,6,0,2,1,3,0.6666666666666666,0.3333333333333333
5986,6,0,7,43,50,0.14,0.86
5959,6,0,11,348,359,0.03064066852367688,0.9693593314763231
6051,6,0,7,31,38,0.18421052631578946,0.8157894736842105
6029,6,0,1,2,3,0.3333333333333333,0.6666666666666666
6070,6,0,1,0,1,1.0,0.0
5942,6,0,0,145,145,0.0,1.0
5953,6,0,4,0,4,1.0,0.0
6076,6,0,6,1,7,0.8571428571428571,0.14285714285714285
5940,6,0,3,7,10,0.3,0.7
6109,6,0,11,82,93,0.11827956989247312,0.8817204301075269
6187,6,0,3,0,3,1.0,0.0
6053,6,0,0,17,17,0.0,1.0
6104,6,0,7,2,9,0.7777777777777778,0.2222222222222222
5943,6,0,2,0,2,1.0,0.0
6017,6,0,2,1,3,0.6666666666666666,0.3333333333333333
6168,6,0,7,9,16,0.4375,0.5625
5989,6,0,4,2,6,0.6666666666666666,0.3333333333333333
5963,6,0,6,0,6,1.0,0.0
6194,6,0,0,26,26,0.0,1.0
6167,6,0,9,10,19,0.47368421052631576,0.5263157894736842
6004,6,0,0,64,64,0.0,1.0
6030,6,0,7,0,7,1.0,0.0
6054,6,0,5,1,6,0.8333333333333334,0.16666666666666666
6032,6,0,7,5,12,0.5833333333333334,0.4166666666666667
6170,6,0,14,50,64,0.21875,0.78125
6063,6,0,3,0,3,1.0,0.0
5988,6,0,1,0,1,1.0,0.0
6075,6,0,2,1,3,0.6666666666666666,0.3333333333333333
6061,6,0,0,67,67,0.0,1.0
5965,6,0,11,38,49,0.22448979591836735,0.7755102040816326
6040,6,0,8,2,10,0.8,0.2
6059,6,0,0,85,85,0.0,1.0
6106,6,0,5,58,63,0.07936507936507936,0.9206349206349206
6031,6,0,3,11,14,0.21428571428571427,0.7857142857142857
6180,6,0,0,6,6,0.0,1.0
6039,6,0,12,51,63,0.19047619047619047,0.8095238095238095
6189,7,0,0,18,18,0.0,1.0
5936,7,0,5,1,6,0.8333333333333334,0.16666666666666666
6087,7,0,3,8,11,0.2727272727272727,0.7272727272727273
5973,7,0,2,846,848,0.0023584905660377358,0.9976415094339622
6085,7,0,9,3,12,0.75,0.25
6012,7,0,0,62,62,0.0,1.0
5982,7,0,1,5,6,0.16666666666666666,0.8333333333333334
5948,7,0,0,57,57,0.0,1.0
5974,7,0,4,2,6,0.6666666666666666,0.3333333333333333
6090,7,0,0,4,4,0.0,1.0
6068,7,0,3,0,3,1.0,0.0
5962,7,0,9,32,41,0.21951219512195122,0.7804878048780488
6033,7,0,0,1,1,0.0,1.0
6038,7,0,2,0,2,1.0,0.0
6042,7,0,8,89,97,0.08247422680412371,0.9175257731958762
5924,7,0,0,3,3,0.0,1.0
6083,7,0,0,27,27,0.0,1.0
6178,7,0,11,7,18,0.6111111111111112,0.3888888888888889
5958,7,0,4,0,4,1.0,0.0
6086,7,0,0,14,14,0.0,1.0
5945,7,0,1,18,19,0.05263157894736842,0.9473684210526315
5935,7,0,4,1,5,0.8,0.2
6073,7,0,9,6,15,0.6,0.4
5980,7,0,11,34,45,0.24444444444444444,0.7555555555555555
5993,7,0,7,476,483,0.014492753623188406,0.9855072463768116
6037,7,0,5,218,223,0.02242152466367713,0.9775784753363229
5979,7,0,5,0,5,1.0,0.0
5966,7,0,0,73,73,0.0,1.0
5985,7,0,2,1,3,0.6666666666666666,0.3333333333333333
5967,7,0,0,76,76,0.0,1.0
6188,7,0,6,16,22,0.2727272727272727,0.7272727272727273
6041,7,0,0,12,12,0.0,1.0
5972,7,0,11,2,13,0.8461538461538461,0.15384615384615385
6069,7,0,2,2,4,0.5,0.5
5937,7,0,1,0,1,1.0,0.0
6028,7,0,6,25,31,0.1935483870967742,0.8064516129032258
5990,7,0,0,130,130,0.0,1.0
5928,7,0,10,471,481,0.02079002079002079,0.9792099792099792
5992,7,0,2,2,4,0.5,0.5
6058,7,0,7,6,13,0.5384615384615384,0.46153846153846156
6001,7,0,3,26,29,0.10344827586206896,0.896551724137931
5964,7,0,13,18,31,0.41935483870967744,0.5806451612903226
5950,7,0,2,2,4,0.5,0.5
5991,7,0,3,5,8,0.375,0.625
6177,7,0,13,296,309,0.042071197411003236,0.9579288025889967
5961,7,0,0,321,321,0.0,1.0
6176,7,0,0,93,93,0.0,1.0
5956,7,0,0,31,31,0.0,1.0
5938,7,0,5,634,639,0.00782472613458529,0.9921752738654147
6179,7,0,5,23,28,0.17857142857142858,0.8214285714285714
5947,7,0,15,45,60,0.25,0.75
5927,7,0,2,453,455,0.004395604395604396,0.9956043956043956
5977,7,0,2,304,306,0.006535947712418301,0.9934640522875817
6198,7,0,0,5,5,0.0,1.0
5957,7,0,0,45,45,0.0,1.0
6057,7,0,4,25,29,0.13793103448275862,0.8620689655172413
6043,7,0,8,0,8,1.0,0.0
6077,7,0,0,4,4,0.0,1.0
6014,7,0,10,4,14,0.7142857142857143,0.2857142857142857
6015,7,0,1,2,3,0.3333333333333333,0.6666666666666666
5978,7,0,2,1,3,0.6666666666666666,0.3333333333333333
5986,7,0,4,46,50,0.08,0.92
5959,7,0,12,347,359,0.033426183844011144,0.9665738161559888
6051,7,0,11,27,38,0.2894736842105263,0.7105263157894737
6029,7,0,1,2,3,0.3333333333333333,0.6666666666666666
6070,7,0,1,0,1,1.0,0.0
5942,7,0,0,145,145,0.0,1.0
5953,7,0,4,0,4,1.0,0.0
6076,7,0,3,4,7,0.42857142857142855,0.5714285714285714
5940,7,0,2,8,10,0.2,0.8
6109,7,0,7,86,93,0.07526881720430108,0.9247311827956989
6187,7,0,2,1,3,0.6666666666666666,0.3333333333333333
6053,7,0,0,17,17,0.0,1.0
6104,7,0,7,2,9,0.7777777777777778,0.2222222222222222
5943,7,0,2,0,2,1.0,0.0
6017,7,0,3,0,3,1.0,0.0
6168,7,0,7,9,16,0.4375,0.5625
5989,7,0,4,2,6,0.6666666666666666,0.3333333333333333
5963,7,0,6,0,6,1.0,0.0
6194,7,0,0,26,26,0.0,1.0
6167,7,0,8,11,19,0.42105263157894735,0.5789473684210527
6004,7,0,0,64,64,0.0,1.0
6030,7,0,6,1,7,0.8571428571428571,0.14285714285714285
6054,7,0,6,0,6,1.0,0.0
6032,7,0,6,6,12,0.5,0.5
6170,7,0,14,50,64,0.21875,0.78125
6063,7,0,3,0,3,1.0,0.0
5988,7,0,1,0,1,1.0,0.0
6075,7,0,2,1,3,0.6666666666666666,0.3333333333333333
6061,7,0,0,67,67,0.0,1.0
5965,7,0,10,39,49,0.20408163265306123,0.7959183673469388
6040,7,0,7,3,10,0.7,0.3
6059,7,0,0,85,85,0.0,1.0
6106,7,0,3,60,63,0.047619047619047616,0.9523809523809523
6031,7,0,5,9,14,0.35714285714285715,0.6428571428571429
6180,7,0,0,6,6,0.0,1.0
6039,7,0,4,59,63,0.06349206349206349,0.9365079365079365
6189,8,0,0,18,18,0.0,1.0
5936,8,0,5,1,6,0.8333333333333334,0.16666666666666666
6087,8,0,0,11,11,0.0,1.0
5973,8,0,1,847,848,0.0011792452830188679,0.9988207547169812
6085,8,0,6,6,12,0.5,0.5
6012,8,0,0,62,62,0.0,1.0
5982,8,0,1,5,6,0.16666666666666666,0.8333333333333334
5948,8,0,0,57,57,0.0,1.0
5974,8,0,3,3,6,0.5,0.5
6090,8,0,0,4,4,0.0,1.0
6068,8,0,3,0,3,1.0,0.0
5962,8,0,4,37,41,0.0975609756097561,0.9024390243902439
6033,8,0,0,1,1,0.0,1.0
6038,8,0,2,0,2,1.0,0.0
6042,8,0,7,90,97,0.07216494845360824,0.9278350515463918
5924,8,0,1,2,3,0.3333333333333333,0.6666666666666666
6083,8,0,0,27,27,0.0,1.0
6178,8,0,12,6,18,0.6666666666666666,0.3333333333333333
5958,8,0,3,1,4,0.75,0.25
6086,8,0,0,14,14,0.0,1.0
5945,8,0,2,17,19,0.10526315789473684,0.8947368421052632
5935,8,0,4,1,5,0.8,0.2
6073,8,0,6,9,15,0.4,0.6
5980,8,0,7,38,45,0.15555555555555556,0.8444444444444444
5993,8,0,7,476,483,0.014492753623188406,0.9855072463768116
6037,8,0,3,220,223,0.013452914798206279,0.9865470852017937
5979,8,0,5,0,5,1.0,0.0
5966,8,0,0,73,73,0.0,1.0
5985,8,0,2,1,3,0.6666666666666666,0.3333333333333333
5967,8,0,0,76,76,0.0,1.0
6188,8,0,4,18,22,0.18181818181818182,0.8181818181818182
6041,8,0,0,12,12,0.0,1.0
5972,8,0,8,5,13,0.6153846153846154,0.38461538461538464
6069,8,0,1,3,4,0.25,0.75
5937,8,0,1,0,1,1.0,0.0
6028,8,0,6,25,31,0.1935483870967742,0.8064516129032258
5990,8,0,0,130,130,0.0,1.0
5928,8,0,11,470,481,0.02286902286902287,0.9771309771309772
5992,8,0,2,2,4,0.5,0.5
6058,8,0,9,4,13,0.6923076923076923,0.3076923076923077
6001,8,0,2,27,29,0.06896551724137931,0.9310344827586207
5964,8,0,16,15,31,0.5161290322580645,0.4838709677419355
5950,8,0,2,2,4,0.5,0.5
5991,8,0,1,7,8,0.125,0.875
6177,8,0,3,306,309,0.009708737864077669,0.9902912621359223
5961,8,0,0,321,321,0.0,1.0
6176,8,0,0,93,93,0.0,1.0
5956,8,0,0,31,31,0.0,1.0
5938,8,0,5,634,639,0.00782472613458529,0.9921752738654147
6179,8,0,4,24,28,0.14285714285714285,0.8571428571428571
5947,8,0,10,50,60,0.16666666666666666,0.8333333333333334
5927,8,0,0,455,455,0.0,1.0
5977,8,0,0,306,306,0.0,1.0
6198,8,0,0,5,5,0.0,1.0
5957,8,0,0,45,45,0.0,1.0
6057,8,0,2,27,29,0.06896551724137931,0.9310344827586207
6043,8,0,8,0,8,1.0,0.0
6077,8,0,0,4,4,0.0,1.0
6014,8,0,6,8,14,0.42857142857142855,0.5714285714285714
6015,8,0,1,2,3,0.3333333333333333,0.6666666666666666
5978,8,0,3,0,3,1.0,0.0
5986,8,0,2,48,50,0.04,0.96
5959,8,0,11,348,359,0.03064066852367688,0.9693593314763231
6051,8,0,7,31,38,0.18421052631578946,0.8157894736842105
6029,8,0,1,2,3,0.3333333333333333,0.6666666666666666
6070,8,0,1,0,1,1.0,0.0
5942,8,0,0,145,145,0.0,1.0
5953,8,0,4,0,4,1.0,0.0
6076,8,0,1,6,7,0.14285714285714285,0.8571428571428571
5940,8,0,3,7,10,0.3,0.7
6109,8,0,12,81,93,0.12903225806451613,0.8709677419354839
6187,8,0,2,1,3,0.6666666666666666,0.3333333333333333
6053,8,0,0,17,17,0.0,1.0
6104,8,0,7,2,9,0.7777777777777778,0.2222222222222222
5943,8,0,2,0,2,1.0,0.0
6017,8,0,3,0,3,1.0,0.0
6168,8,0,6,10,16,0.375,0.625
5989,8,0,2,4,6,0.3333333333333333,0.6666666666666666
5963,8,0,6,0,6,1.0,0.0
6194,8,0,0,26,26,0.0,1.0
6167,8,0,8,11,19,0.42105263157894735,0.5789473684210527
6004,8,0,1,63,64,0.015625,0.984375
6030,8,0,7,0,7,1.0,0.0
6054,8,0,4,2,6,0.6666666666666666,0.3333333333333333
6032,8,0,7,5,12,0.5833333333333334,0.4166666666666667
6170,8,0,13,51,64,0.203125,0.796875
6063,8,0,3,0,3,1.0,0.0
5988,8,0,1,0,1,1.0,0.0
6075,8,0,1,2,3,0.3333333333333333,0.6666666666666666
6061,8,0,0,67,67,0.0,1.0
5965,8,0,7,42,49,0.14285714285714285,0.8571428571428571
6040,8,0,9,1,10,0.9,0.1
6059,8,0,0,85,85,0.0,1.0
6106,8,0,1,62,63,0.015873015873015872,0.9841269841269841
6031,8,0,3,11,14,0.21428571428571427,0.7857142857142857
6180,8,0,0,6,6,0.0,1.0
6039,8,0,7,56,63,0.1111111111111111,0.8888888888888888
6189,9,0,0,18,18,0.0,1.0
5936,9,0,3,3,6,0.5,0.5
6087,9,0,2,9,11,0.18181818181818182,0.8181818181818182
5973,9,0,0,848,848,0.0,1.0
6085,9,0,9,3,12,0.75,0.25
6012,9,0,0,62,62,0.0,1.0
5982,9,0,1,5,6,0.16666666666666666,0.8333333333333334
5948,9,0,0,57,57,0.0,1.0
5974,9,0,3,3,6,0.5,0.5
6090,9,0,0,4,4,0.0,1.0
6068,9,0,3,0,3,1.0,0.0
5962,9,0,4,37,41,0.0975609756097561,0.9024390243902439
6033,9,0,0,1,1,0.0,1.0
6038,9,0,2,0,2,1.0,0.0
6042,9,0,9,88,97,0.09278350515463918,0.9072164948453608
5924,9,0,2,1,3,0.6666666666666666,0.3333333333333333
6083,9,0,0,27,27,0.0,1.0
6178,9,0,5,13,18,0.2777777777777778,0.7222222222222222
5958,9,0,2,2,4,0.5,0.5
6086,9,0,0,14,14,0.0,1.0
5945,9,0,1,18,19,0.05263157894736842,0.9473684210526315
5935,9,0,5,0,5,1.0,0.0
6073,9,0,8,7,15,0.5333333333333333,0.4666666666666667
5980,9,0,3,42,45,0.06666666666666667,0.9333333333333333
5993,9,0,8,475,483,0.016563146997929608,0.9834368530020704
6037,9,0,3,220,223,0.013452914798206279,0.9865470852017937
5979,9,0,5,0,5,1.0,0.0
5966,9,0,0,73,73,0.0,1.0
5985,9,0,1,2,3,0.3333333333333333,0.6666666666666666
5967,9,0,0,76,76,0.0,1.0
6188,9,0,7,15,22,0.3181818181818182,0.6818181818181818
6041,9,0,0,12,12,0.0,1.0
5972,9,0,9,4,13,0.6923076923076923,0.3076923076923077
6069,9,0,1,3,4,0.25,0.75
5937,9,0,1,0,1,1.0,0.0
6028,9,0,7,24,31,0.22580645161290322,0.7741935483870968
5990,9,0,0,130,130,0.0,1.0
5928,9,0,9,472,481,0.018711018711018712,0.9812889812889813
5992,9,0,3,1,4,0.75,0.25
6058,9,0,6,7,13,0.46153846153846156,0.5384615384615384
6001,9,0,3,26,29,0.10344827586206896,0.896551724137931
5964,9,0,11,20,31,0.3548387096774194,0.6451612903225806
5950,9,0,3,1,4,0.75,0.25
5991,9,0,2,6,8,0.25,0.75
6177,9,0,6,303,309,0.019417475728155338,0.9805825242718447
5961,9,0,0,321,321,0.0,1.0
6176,9,0,0,93,93,0.0,1.0
5956,9,0,0,31,31,0.0,1.0
5938,9,0,5,634,639,0.00782472613458529,0.9921752738654147
6179,9,0,5,23,28,0.17857142857142858,0.8214285714285714
5947,9,0,10,50,60,0.16666666666666666,0.8333333333333334
5927,9,0,1,454,455,0.002197802197802198,0.9978021978021978
5977,9,0,2,304,306,0.006535947712418301,0.9934640522875817
6198,9,0,0,5,5,0.0,1.0
5957,9,0,0,45,45,0.0,1.0
6057,9,0,7,22,29,0.2413793103448276,0.7586206896551724
6043,9,0,8,0,8,1.0,0.0
6077,9,0,0,4,4,0.0,1.0
6014,9,0,4,10,14,0.2857142857142857,0.7142857142857143
6015,9,0,1,2,3,0.3333333333333333,0.6666666666666666
5978,9,0,3,0,3,1.0,0.0
5986,9,0,1,49,50,0.02,0.98
5959,9,0,5,354,359,0.013927576601671309,0.9860724233983287
6051,9,0,10,28,38,0.2631578947368421,0.7368421052631579
6029,9,0,1,2,3,0.3333333333333333,0.6666666666666666
6070,9,0,1,0,1,1.0,0.0
5942,9,0,0,145,145,0.0,1.0
5953,9,0,4,0,4,1.0,0.0
6076,9,0,3,4,7,0.42857142857142855,0.5714285714285714
5940,9,0,3,7,10,0.3,0.7
6109,9,0,6,87,93,0.06451612903225806,0.9354838709677419
6187,9,0,1,2,3,0.3333333333333333,0.6666666666666666
6053,9,0,0,17,17,0.0,1.0
6104,9,0,8,1,9,0.8888888888888888,0.1111111111111111
5943,9,0,2,0,2,1.0,0.0
6017,9,0,2,1,3,0.6666666666666666,0.3333333333333333
6168,9,0,3,13,16,0.1875,0.8125
5989,9,0,4,2,6,0.6666666666666666,0.3333333333333333
5963,9,0,6,0,6,1.0,0.0
6194,9,0,0,26,26,0.0,1.0
6167,9,0,8,11,19,0.42105263157894735,0.5789473684210527
6004,9,0,1,63,64,0.015625,0.984375
6030,9,0,7,0,7,1.0,0.0
6054,9,0,3,3,6,0.5,0.5
6032,9,0,7,5,12,0.5833333333333334,0.4166666666666667
6170,9,0,11,53,64,0.171875,0.828125
6063,9,0,3,0,3,1.0,0.0
5988,9,0,1,0,1,1.0,0.0
6075,9,0,1,2,3,0.3333333333333333,0.6666666666666666
6061,9,0,0,67,67,0.0,1.0
5965,9,0,7,42,49,0.14285714285714285,0.8571428571428571
6040,9,0,6,4,10,0.6,0.4
6059,9,0,0,85,85,0.0,1.0
6106,9,0,5,58,63,0.07936507936507936,0.9206349206349206
6031,9,0,5,9,14,0.35714285714285715,0.6428571428571429
6180,9,0,0,6,6,0.0,1.0
6039,9,0,7,56,63,0.1111111111111111,0.8888888888888888
6189,10,0,0,18,18,0.0,1.0
5936,10,0,3,3,6,0.5,0.5
6087,10,0,1,10,11,0.09090909090909091,0.9090909090909091
5973,10,0,3,845,848,0.003537735849056604,0.9964622641509434
6085,10,0,4,8,12,0.3333333333333333,0.6666666666666666
6012,10,0,0,62,62,0.0,1.0
5982,10,0,0,6,6,0.0,1.0
5948,10,0,0,57,57,0.0,1.0
5974,10,0,3,3,6,0.5,0.5
6090,10,0,0,4,4,0.0,1.0
6068,10,0,3,0,3,1.0,0.0
5962,10,0,3,38,41,0.07317073170731707,0.926829268292683
6033,10,0,0,1,1,0.0,1.0
6038,10,0,2,0,2,1.0,0.0
6042,10,0,10,87,97,0.10309278350515463,0.8969072164948454
5924,10,0,0,3,3,0.0,1.0
6083,10,0,0,27,27,0.0,1.0
6178,10,0,7,11,18,0.3888888888888889,0.6111111111111112
5958,10,0,2,2,4,0.5,0.5
6086,10,0,0,14,14,0.0,1.0
5945,10,0,5,14,19,0.2631578947368421,0.7368421052631579
5935,10,0,3,2,5,0.6,0.4
6073,10,0,8,7,15,0.5333333333333333,0.4666666666666667
5980,10,0,4,41,45,0.08888888888888889,0.9111111111111111
5993,10,0,5,478,483,0.010351966873706004,0.989648033126294
6037,10,0,3,220,223,0.013452914798206279,0.9865470852017937
5979,10,0,4,1,5,0.8,0.2
5966,10,0,0,73,73,0.0,1.0
5985,10,0,1,2,3,0.3333333333333333,0.6666666666666666
5967,10,0,0,76,76,0.0,1.0
6188,10,0,6,16,22,0.2727272727272727,0.7272727272727273
6041,10,0,0,12,12,0.0,1.0
5972,10,0,7,6,13,0.5384615384615384,0.46153846153846156
6069,10,0,1,3,4,0.25,0.75
5937,10,0,1,0,1,1.0,0.0
6028,10,0,5,26,31,0.16129032258064516,0.8387096774193549
5990,10,0,0,130,130,0.0,1.0
5928,10,0,4,477,481,0.008316008316008316,0.9916839916839917
5992,10,0,4,0,4,1.0,0.0
6058,10,0,6,7,13,0.46153846153846156,0.5384615384615384
6001,10,0,2,27,29,0.06896551724137931,0.9310344827586207
5964,10,0,11,20,31,0.3548387096774194,0.6451612903225806
5950,10,0,2,2,4,0.5,0.5
5991,10,0,1,7,8,0.125,0.875
6177,10,0,3,306,309,0.009708737864077669,0.9902912621359223
5961,10,0,0,321,321,0.0,1.0
6176,10,0,0,93,93,0.0,1.0
5956,10,0,0,31,31,0.0,1.0
5938,10,0,3,636,639,0.004694835680751174,0.9953051643192489
6179,10,0,8,20,28,0.2857142857142857,0.7142857142857143
5947,10,0,10,50,60,0.16666666666666666,0.8333333333333334
5927,10,0,2,453,455,0.004395604395604396,0.9956043956043956
5977,10,0,2,304,306,0.006535947712418301,0.9934640522875817
6198,10,0,0,5,5,0.0,1.0
5957,10,0,0,45,45,0.0,1.0
6057,10,0,2,27,29,0.06896551724137931,0.9310344827586207
6043,10,0,7,1,8,0.875,0.125
6077,10,0,0,4,4,0.0,1.0
6014,10,0,7,7,14,0.5,0.5
6015,10,0,1,2,3,0.3333333333333333,0.6666666666666666
5978,10,0,1,2,3,0.3333333333333333,0.6666666666666666
5986,10,0,1,49,50,0.02,0.98
5959,10,0,6,353,359,0.016713091922005572,0.9832869080779945
6051,10,0,8,30,38,0.21052631578947367,0.7894736842105263
6029,10,0,1,2,3,0.3333333333333333,0.6666666666666666
6070,10,0,1,0,1,1.0,0.0
5942,10,0,0,145,145,0.0,1.0
5953,10,0,4,0,4,1.0,0.0
6076,10,0,4,3,7,0.5714285714285714,0.42857142857142855
5940,10,0,2,8,10,0.2,0.8
6109,10,0,5,88,93,0.053763440860215055,0.946236559139785
6187,10,0,1,2,3,0.3333333333333333,0.6666666666666666
6053,10,0,0,17,17,0.0,1.0
6104,10,0,7,2,9,0.7777777777777778,0.2222222222222222
5943,10,0,2,0,2,1.0,0.0
6017,10,0,3,0,3,1.0,0.0
6168,10,0,3,13,16,0.1875,0.8125
5989,10,0,2,4,6,0.3333333333333333,0.6666666666666666
5963,10,0,6,0,6,1.0,0.0
6194,10,0,0,26,26,0.0,1.0
6167,10,0,9,10,19,0.47368421052631576,0.5263157894736842
6004,10,0,1,63,64,0.015625,0.984375
6030,10,0,5,2,7,0.7142857142857143,0.2857142857142857
6054,10,0,4,2,6,0.6666666666666666,0.3333333333333333
6032,10,0,3,9,12,0.25,0.75
6170,10,0,5,59,64,0.078125,0.921875
6063,10,0,3,0,3,1.0,0.0
5988,10,0,1,0,1,1.0,0.0
6075,10,0,1,2,3,0.3333333333333333,0.6666666666666666
6061,10,0,0,67,67,0.0,1.0
5965,10,0,5,44,49,0.10204081632653061,0.8979591836734694
6040,10,0,5,5,10,0.5,0.5
6059,10,0,0,85,85,0.0,1.0
6106,10,0,2,61,63,0.031746031746031744,0.9682539682539683
6031,10,0,3,11,14,0.21428571428571427,0.7857142857142857
6180,10,0,0,6,6,0.0,1.0
6039,10,0,6,57,63,0.09523809523809523,0.9047619047619048
6189,11,0,0,18,18,0.0,1.0
5936,11,0,3,3,6,0.5,0.5
6087,11,0,2,9,11,0.18181818181818182,0.8181818181818182
5973,11,0,3,845,848,0.003537735849056604,0.9964622641509434
6085,11,0,6,6,12,0.5,0.5
6012,11,0,0,62,62,0.0,1.0
5982,11,0,1,5,6,0.16666666666666666,0.8333333333333334
5948,11,0,0,57,57,0.0,1.0
5974,11,0,2,4,6,0.3333333333333333,0.6666666666666666
6090,11,0,0,4,4,0.0,1.0
6068,11,0,3,0,3,1.0,0.0
5962,11,0,5,36,41,0.12195121951219512,0.8780487804878049
6033,11,0,0,1,1,0.0,1.0
6038,11,0,2,0,2,1.0,0.0
6042,11,0,10,87,97,0.10309278350515463,0.8969072164948454
5924,11,0,1,2,3,0.3333333333333333,0.6666666666666666
6083,11,0,0,27,27,0.0,1.0
6178,11,0,6,12,18,0.3333333333333333,0.6666666666666666
5958,11,0,2,2,4,0.5,0.5
6086,11,0,0,14,14,0.0,1.0
5945,11,0,3,16,19,0.15789473684210525,0.8421052631578947
5935,11,0,3,2,5,0.6,0.4
6073,11,0,3,12,15,0.2,0.8
5980,11,0,9,36,45,0.2,0.8
5993,11,0,3,480,483,0.006211180124223602,0.9937888198757764
6037,11,0,0,223,223,0.0,1.0
5979,11,0,4,1,5,0.8,0.2
5966,11,0,0,73,73,0.0,1.0
5985,11,0,2,1,3,0.6666666666666666,0.3333333333333333
5967,11,0,0,76,76,0.0,1.0
6188,11,0,1,21,22,0.045454545454545456,0.9545454545454546
6041,11,0,0,12,12,0.0,1.0
5972,11,0,4,9,13,0.3076923076923077,0.6923076923076923
6069,11,0,2,2,4,0.5,0.5
5937,11,0,1,0,1,1.0,0.0
6028,11,0,4,27,31,0.12903225806451613,0.8709677419354839
5990,11,0,0,130,130,0.0,1.0
5928,11,0,9,472,481,0.018711018711018712,0.9812889812889813
5992,11,0,4,0,4,1.0,0.0
6058,11,0,7,6,13,0.5384615384615384,0.46153846153846156
6001,11,0,1,28,29,0.034482758620689655,0.9655172413793104
5964,11,0,7,24,31,0.22580645161290322,0.7741935483870968
5950,11,0,3,1,4,0.75,0.25
5991,11,0,1,7,8,0.125,0.875
6177,11,0,3,306,309,0.009708737864077669,0.9902912621359223
5961,11,0,0,321,321,0.0,1.0
6176,11,0,0,93,93,0.0,1.0
5956,11,0,0,31,31,0.0,1.0
5938,11,0,5,634,639,0.00782472613458529,0.9921752738654147
6179,11,0,3,25,28,0.10714285714285714,0.8928571428571429
5947,11,0,5,55,60,0.08333333333333333,0.9166666666666666
5927,11,0,0,455,455,0.0,1.0
5977,11,0,0,306,306,0.0,1.0
6198,11,0,0,5,5,0.0,1.0
5957,11,0,0,45,45,0.0,1.0
6057,11,0,4,25,29,0.13793103448275862,0.8620689655172413
6043,11,0,8,0,8,1.0,0.0
6077,11,0,0,4,4,0.0,1.0
6014,11,0,3,11,14,0.21428571428571427,0.7857142857142857
6015,11,0,1,2,3,0.3333333333333333,0.6666666666666666
5978,11,0,1,2,3,0.3333333333333333,0.6666666666666666
5986,11,0,3,47,50,0.06,0.94
5959,11,0,2,357,359,0.005571030640668524,0.9944289693593314
6051,11,0,7,31,38,0.18421052631578946,0.8157894736842105
6029,11,0,1,2,3,0.3333333333333333,0.6666666666666666
6070,11,0,1,0,1,1.0,0.0
5942,11,0,0,145,145,0.0,1.0
5953,11,0,3,1,4,0.75,0.25
6076,11,0,1,6,7,0.14285714285714285,0.8571428571428571
5940,11,0,3,7,10,0.3,0.7
6109,11,0,6,87,93,0.06451612903225806,0.9354838709677419
6187,11,0,1,2,3,0.3333333333333333,0.6666666666666666
6053,11,0,0,17,17,0.0,1.0
6104,11,0,5,4,9,0.5555555555555556,0.4444444444444444
5943,11,0,1,1,2,0.5,0.5
6017,11,0,2,1,3,0.6666666666666666,0.3333333333333333
6168,11,0,9,7,16,0.5625,0.4375
5989,11,0,1,5,6,0.16666666666666666,0.8333333333333334
5963,11,0,6,0,6,1.0,0.0
6194,11,0,0,26,26,0.0,1.0
6167,11,0,6,13,19,0.3157894736842105,0.6842105263157895
6004,11,0,1,63,64,0.015625,0.984375
6030,11,0,6,1,7,0.8571428571428571,0.14285714285714285
6054,11,0,5,1,6,0.8333333333333334,0.16666666666666666
6032,11,0,6,6,12,0.5,0.5
6170,11,0,9,55,64,0.140625,0.859375
6063,11,0,3,0,3,1.0,0.0
5988,11,0,1,0,1,1.0,0.0
6075,11,0,1,2,3,0.3333333333333333,0.6666666666666666
6061,11,0,0,67,67,0.0,1.0
5965,11,0,8,41,49,0.16326530612244897,0.8367346938775511
6040,11,0,7,3,10,0.7,0.3
6059,11,0,0,85,85,0.0,1.0
6106,11,0,2,61,63,0.031746031746031744,0.9682539682539683
6031,11,0,4,10,14,0.2857142857142857,0.7142857142857143
6180,11,0,0,6,6,0.0,1.0
6039,11,0,2,61,63,0.031746031746031744,0.9682539682539683
6189,12,0,0,18,18,0.0,1.0
5936,12,0,4,2,6,0.6666666666666666,0.3333333333333333
6087,12,0,4,7,11,0.36363636363636365,0.6363636363636364
5973,12,0,1,847,848,0.0011792452830188679,0.9988207547169812
6085,12,0,3,9,12,0.25,0.75
6012,12,0,0,62,62,0.0,1.0
5982,12,0,0,6,6,0.0,1.0
5948,12,0,0,57,57,0.0,1.0
5974,12,0,2,4,6,0.3333333333333333,0.6666666666666666
6090,12,0,0,4,4,0.0,1.0
6068,12,0,3,0,3,1.0,0.0
5962,12,0,5,36,41,0.12195121951219512,0.8780487804878049
6033,12,0,0,1,1,0.0,1.0
6038,12,0,2,0,2,1.0,0.0
6042,12,0,4,93,97,0.041237113402061855,0.9587628865979382
5924,12,0,0,3,3,0.0,1.0
6083,12,0,0,27,27,0.0,1.0
6178,12,0,9,9,18,0.5,0.5
5958,12,0,2,2,4,0.5,0.5
6086,12,0,0,14,14,0.0,1.0
5945,12,0,1,18,19,0.05263157894736842,0.9473684210526315
5935,12,0,3,2,5,0.6,0.4
6073,12,0,5,10,15,0.3333333333333333,0.6666666666666666
5980,12,0,6,39,45,0.13333333333333333,0.8666666666666667
5993,12,0,4,479,483,0.008281573498964804,0.9917184265010351
6037,12,0,1,222,223,0.004484304932735426,0.9955156950672646
5979,12,0,3,2,5,0.6,0.4
5966,12,0,0,73,73,0.0,1.0
5985,12,0,1,2,3,0.3333333333333333,0.6666666666666666
5967,12,0,0,76,76,0.0,1.0
6188,12,0,3,19,22,0.13636363636363635,0.8636363636363636
6041,12,0,0,12,12,0.0,1.0
5972,12,0,4,9,13,0.3076923076923077,0.6923076923076923
6069,12,0,1,3,4,0.25,0.75
5937,12,0,1,0,1,1.0,0.0
6028,12,0,6,25,31,0.1935483870967742,0.8064516129032258
5990,12,0,0,130,130,0.0,1.0
5928,12,0,4,477,481,0.008316008316008316,0.9916839916839917
5992,12,0,3,1,4,0.75,0.25
6058,12,0,5,8,13,0.38461538461538464,0.6153846153846154
6001,12,0,2,27,29,0.06896551724137931,0.9310344827586207
5964,12,0,6,25,31,0.1935483870967742,0.8064516129032258
5950,12,0,2,2,4,0.5,0.5
5991,12,0,2,6,8,0.25,0.75
6177,12,0,5,304,309,0.016181229773462782,0.9838187702265372
5961,12,0,0,321,321,0.0,1.0
6176,12,0,0,93,93,0.0,1.0
5956,12,0,0,31,31,0.0,1.0
5938,12,0,2,637,639,0.003129890453834116,0.9968701095461658
6179,12,0,3,25,28,0.10714285714285714,0.8928571428571429
5947,12,0,7,53,60,0.11666666666666667,0.8833333333333333
5927,12,0,0,455,455,0.0,1.0
5977,12,0,0,306,306,0.0,1.0
6198,12,0,0,5,5,0.0,1.0
5957,12,0,0,45,45,0.0,1.0
6057,12,0,1,28,29,0.034482758620689655,0.9655172413793104
6043,12,0,7,1,8,0.875,0.125
6077,12,0,0,4,4,0.0,1.0
6014,12,0,7,7,14,0.5,0.5
6015,12,0,3,0,3,1.0,0.0
5978,12,0,2,1,3,0.6666666666666666,0.3333333333333333
5986,12,0,1,49,50,0.02,0.98
5959,12,0,5,354,359,0.013927576601671309,0.9860724233983287
6051,12,0,4,34,38,0.10526315789473684,0.8947368421052632
6029,12,0,0,3,3,0.0,1.0
6070,12,0,1,0,1,1.0,0.0
5942,12,0,0,145,145,0.0,1.0
5953,12,0,4,0,4,1.0,0.0
6076,12,0,1,6,7,0.14285714285714285,0.8571428571428571
5940,12,0,2,8,10,0.2,0.8
6109,12,0,1,92,93,0.010752688172043012,0.989247311827957
6187,12,0,1,2,3,0.3333333333333333,0.6666666666666666
6053,12,0,0,17,17,0.0,1.0
6104,12,0,6,3,9,0.6666666666666666,0.3333333333333333
5943,12,0,1,1,2,0.5,0.5
6017,12,0,3,0,3,1.0,0.0
6168,12,0,3,13,16,0.1875,0.8125
5989,12,0,3,3,6,0.5,0.5
5963,12,0,5,1,6,0.8333333333333334,0.16666666666666666
6194,12,0,0,26,26,0.0,1.0
6167,12,0,4,15,19,0.21052631578947367,0.7894736842105263
6004,12,0,0,64,64,0.0,1.0
6030,12,0,5,2,7,0.7142857142857143,0.2857142857142857
6054,12,0,2,4,6,0.3333333333333333,0.6666666666666666
6032,12,0,4,8,12,0.3333333333333333,0.6666666666666666
6170,12,0,6,58,64,0.09375,0.90625
6063,12,0,3,0,3,1.0,0.0
5988,12,0,1,0,1,1.0,0.0
6075,12,0,0,3,3,0.0,1.0
6061,12,0,0,67,67,0.0,1.0
5965,12,0,8,41,49,0.16326530612244897,0.8367346938775511
6040,12,0,5,5,10,0.5,0.5
6059,12,0,0,85,85,0.0,1.0
6106,12,0,2,61,63,0.031746031746031744,0.9682539682539683
6031,12,0,4,10,14,0.2857142857142857,0.7142857142857143
6180,12,0,0,6,6,0.0,1.0
6039,12,0,4,59,63,0.06349206349206349,0.9365079365079365
6189,13,0,0,18,18,0.0,1.0
5936,13,0,4,2,6,0.6666666666666666,0.3333333333333333
6087,13,0,3,8,11,0.2727272727272727,0.7272727272727273
5973,13,0,3,845,848,0.003537735849056604,0.9964622641509434
6085,13,0,5,7,12,0.4166666666666667,0.5833333333333334
6012,13,0,0,62,62,0.0,1.0
5982,13,0,0,6,6,0.0,1.0
5948,13,0,0,57,57,0.0,1.0
5974,13,0,3,3,6,0.5,0.5
6090,13,0,0,4,4,0.0,1.0
6068,13,0,3,0,3,1.0,0.0
5962,13,0,3,38,41,0.07317073170731707,0.926829268292683
6033,13,0,0,1,1,0.0,1.0
6038,13,0,2,0,2,1.0,0.0
6042,13,0,3,94,97,0.030927835051546393,0.9690721649484536
5924,13,0,1,2,3,0.3333333333333333,0.6666666666666666
6083,13,0,0,27,27,0.0,1.0
6178,13,0,5,13,18,0.2777777777777778,0.7222222222222222
5958,13,0,2,2,4,0.5,0.5
6086,13,0,0,14,14,0.0,1.0
5945,13,0,1,18,19,0.05263157894736842,0.9473684210526315
5935,13,0,3,2,5,0.6,0.4
6073,13,0,5,10,15,0.3333333333333333,0.6666666666666666
5980,13,0,3,42,45,0.06666666666666667,0.9333333333333333
5993,13,0,2,481,483,0.004140786749482402,0.9958592132505176
6037,13,0,2,221,223,0.008968609865470852,0.9910313901345291
5979,13,0,4,1,5,0.8,0.2
5966,13,0,0,73,73,0.0,1.0
5985,13,0,0,3,3,0.0,1.0
5967,13,0,0,76,76,0.0,1.0
6188,13,0,5,17,22,0.22727272727272727,0.7727272727272727
6041,13,0,0,12,12,0.0,1.0
5972,13,0,5,8,13,0.38461538461538464,0.6153846153846154
6069,13,0,2,2,4,0.5,0.5
5937,13,0,1,0,1,1.0,0.0
6028,13,0,3,28,31,0.0967741935483871,0.9032258064516129
5990,13,0,0,130,130,0.0,1.0
5928,13,0,3,478,481,0.006237006237006237,0.9937629937629938
5992,13,0,2,2,4,0.5,0.5
6058,13,0,3,10,13,0.23076923076923078,0.7692307692307693
6001,13,0,2,27,29,0.06896551724137931,0.9310344827586207
5964,13,0,10,21,31,0.3225806451612903,0.6774193548387096
5950,13,0,2,2,4,0.5,0.5
5991,13,0,2,6,8,0.25,0.75
6177,13,0,1,308,309,0.003236245954692557,0.9967637540453075
5961,13,0,0,321,321,0.0,1.0
6176,13,0,0,93,93,0.0,1.0
5956,13,0,0,31,31,0.0,1.0
5938,13,0,2,637,639,0.003129890453834116,0.9968701095461658
6179,13,0,0,28,28,0.0,1.0
5947,13,0,2,58,60,0.03333333333333333,0.9666666666666667
5927,13,0,1,454,455,0.002197802197802198,0.9978021978021978
5977,13,0,0,306,306,0.0,1.0
6198,13,0,0,5,5,0.0,1.0
5957,13,0,0,45,45,0.0,1.0
6057,13,0,3,26,29,0.10344827586206896,0.896551724137931
6043,13,0,6,2,8,0.75,0.25
6077,13,0,0,4,4,0.0,1.0
6014,13,0,5,9,14,0.35714285714285715,0.6428571428571429
6015,13,0,2,1,3,0.6666666666666666,0.3333333333333333
5978,13,0,1,2,3,0.3333333333333333,0.6666666666666666
5986,13,0,2,48,50,0.04,0.96
5959,13,0,5,354,359,0.013927576601671309,0.9860724233983287
6051,13,0,2,36,38,0.05263157894736842,0.9473684210526315
6029,13,0,1,2,3,0.3333333333333333,0.6666666666666666
6070,13,0,1,0,1,1.0,0.0
5942,13,0,0,145,145,0.0,1.0
5953,13,0,4,0,4,1.0,0.0
6076,13,0,1,6,7,0.14285714285714285,0.8571428571428571
5940,13,0,2,8,10,0.2,0.8
6109,13,0,6,87,93,0.06451612903225806,0.9354838709677419
6187,13,0,1,2,3,0.3333333333333333,0.6666666666666666
6053,13,0,0,17,17,0.0,1.0
6104,13,0,4,5,9,0.4444444444444444,0.5555555555555556
5943,13,0,1,1,2,0.5,0.5
6017,13,0,3,0,3,1.0,0.0
6168,13,0,8,8,16,0.5,0.5
5989,13,0,0,6,6,0.0,1.0
5963,13,0,6,0,6,1.0,0.0
6194,13,0,0,26,26,0.0,1.0
6167,13,0,4,15,19,0.21052631578947367,0.7894736842105263
6004,13,0,1,63,64,0.015625,0.984375
6030,13,0,5,2,7,0.7142857142857143,0.2857142857142857
6054,13,0,2,4,6,0.3333333333333333,0.6666666666666666
6032,13,0,5,7,12,0.4166666666666667,0.5833333333333334
6170,13,0,5,59,64,0.078125,0.921875
6063,13,0,3,0,3,1.0,0.0
5988,13,0,1,0,1,1.0,0.0
6075,13,0,0,3,3,0.0,1.0
6061,13,0,0,67,67,0.0,1.0
5965,13,0,2,47,49,0.04081632653061224,0.9591836734693877
6040,13,0,3,7,10,0.3,0.7
6059,13,0,0,85,85,0.0,1.0
6106,13,0,2,61,63,0.031746031746031744,0.9682539682539683
6031,13,0,3,11,14,0.21428571428571427,0.7857142857142857
6180,13,0,0,6,6,0.0,1.0
6039,13,0,4,59,63,0.06349206349206349,0.9365079365079365
6189,14,0,0,18,18,0.0,1.0
5936,14,0,3,3,6,0.5,0.5
6087,14,0,3,8,11,0.2727272727272727,0.7272727272727273
5973,14,0,2,846,848,0.0023584905660377358,0.9976415094339622
6085,14,0,3,9,12,0.25,0.75
6012,14,0,0,62,62,0.0,1.0
5982,14,0,1,5,6,0.16666666666666666,0.8333333333333334
5948,14,0,0,57,57,0.0,1.0
5974,14,0,2,4,6,0.3333333333333333,0.6666666666666666
6090,14,0,0,4,4,0.0,1.0
6068,14,0,3,0,3,1.0,0.0
5962,14,0,2,39,41,0.04878048780487805,0.9512195121951219
6033,14,0,0,1,1,0.0,1.0
6038,14,0,2,0,2,1.0,0.0
6042,14,0,2,95,97,0.020618556701030927,0.979381443298969
5924,14,0,1,2,3,0.3333333333333333,0.6666666666666666
6083,14,0,0,27,27,0.0,1.0
6178,14,0,4,14,18,0.2222222222222222,0.7777777777777778
5958,14,0,3,1,4,0.75,0.25
6086,14,0,0,14,14,0.0,1.0
5945,14,0,1,18,19,0.05263157894736842,0.9473684210526315
5935,14,0,2,3,5,0.4,0.6
6073,14,0,4,11,15,0.26666666666666666,0.7333333333333333
5980,14,0,2,43,45,0.044444444444444446,0.9555555555555556
5993,14,0,3,480,483,0.006211180124223602,0.9937888198757764
6037,14,0,1,222,223,0.004484304932735426,0.9955156950672646
5979,14,0,3,2,5,0.6,0.4
5966,14,0,0,73,73,0.0,1.0
5985,14,0,0,3,3,0.0,1.0
5967,14,0,0,76,76,0.0,1.0
6188,14,0,1,21,22,0.045454545454545456,0.9545454545454546
6041,14,0,0,12,12,0.0,1.0
5972,14,0,10,3,13,0.7692307692307693,0.23076923076923078
6069,14,0,1,3,4,0.25,0.75
5937,14,0,1,0,1,1.0,0.0
6028,14,0,6,25,31,0.1935483870967742,0.8064516129032258
5990,14,0,0,130,130,0.0,1.0
5928,14,0,6,475,481,0.012474012474012475,0.9875259875259875
5992,14,0,2,2,4,0.5,0.5
6058,14,0,4,9,13,0.3076923076923077,0.6923076923076923
6001,14,0,3,26,29,0.10344827586206896,0.896551724137931
5964,14,0,2,29,31,0.06451612903225806,0.9354838709677419
5950,14,0,2,2,4,0.5,0.5
5991,14,0,3,5,8,0.375,0.625
6177,14,0,6,303,309,0.019417475728155338,0.9805825242718447
5961,14,0,0,321,321,0.0,1.0
6176,14,0,0,93,93,0.0,1.0
5956,14,0,0,31,31,0.0,1.0
5938,14,0,7,632,639,0.010954616588419406,0.9890453834115805
6179,14,0,1,27,28,0.03571428571428571,0.9642857142857143
5947,14,0,4,56,60,0.06666666666666667,0.9333333333333333
5927,14,0,0,455,455,0.0,1.0
5977,14,0,0,306,306,0.0,1.0
6198,14,0,0,5,5,0.0,1.0
5957,14,0,0,45,45,0.0,1.0
6057,14,0,1,28,29,0.034482758620689655,0.9655172413793104
6043,14,0,7,1,8,0.875,0.125
6077,14,0,0,4,4,0.0,1.0
6014,14,0,6,8,14,0.42857142857142855,0.5714285714285714
6015,14,0,2,1,3,0.6666666666666666,0.3333333333333333
5978,14,0,1,2,3,0.3333333333333333,0.6666666666666666
5986,14,0,4,46,50,0.08,0.92
5959,14,0,2,357,359,0.005571030640668524,0.9944289693593314
6051,14,0,3,35,38,0.07894736842105263,0.9210526315789473
6029,14,0,1,2,3,0.3333333333333333,0.6666666666666666
6070,14,0,1,0,1,1.0,0.0
5942,14,0,0,145,145,0.0,1.0
5953,14,0,3,1,4,0.75,0.25
6076,14,0,1,6,7,0.14285714285714285,0.8571428571428571
5940,14,0,1,9,10,0.1,0.9
6109,14,0,3,90,93,0.03225806451612903,0.967741935483871
6187,14,0,0,3,3,0.0,1.0
6053,14,0,0,17,17,0.0,1.0
6104,14,0,3,6,9,0.3333333333333333,0.6666666666666666
5943,14,0,1,1,2,0.5,0.5
6017,14,0,3,0,3,1.0,0.0
6168,14,0,2,14,16,0.125,0.875
5989,14,0,0,6,6,0.0,1.0
5963,14,0,6,0,6,1.0,0.0
6194,14,0,0,26,26,0.0,1.0
6167,14,0,3,16,19,0.15789473684210525,0.8421052631578947
6004,14,0,0,64,64,0.0,1.0
6030,14,0,6,1,7,0.8571428571428571,0.14285714285714285
6054,14,0,1,5,6,0.16666666666666666,0.8333333333333334
6032,14,0,4,8,12,0.3333333333333333,0.6666666666666666
6170,14,0,3,61,64,0.046875,0.953125
6063,14,0,3,0,3,1.0,0.0
5988,14,0,1,0,1,1.0,0.0
6075,14,0,0,3,3,0.0,1.0
6061,14,0,0,67,67,0.0,1.0
5965,14,0,3,46,49,0.061224489795918366,0.9387755102040817
6040,14,0,6,4,10,0.6,0.4
6059,14,0,0,85,85,0.0,1.0
6106,14,0,2,61,63,0.031746031746031744,0.9682539682539683
6031,14,0,4,10,14,0.2857142857142857,0.7142857142857143
6180,14,0,0,6,6,0.0,1.0
6039,14,0,3,60,63,0.047619047619047616,0.9523809523809523
6189,15,0,0,18,18,0.0,1.0
5936,15,0,1,5,6,0.16666666666666666,0.8333333333333334
6087,15,0,1,10,11,0.09090909090909091,0.9090909090909091
5973,15,0,1,847,848,0.0011792452830188679,0.9988207547169812
6085,15,0,4,8,12,0.3333333333333333,0.6666666666666666
6012,15,0,0,62,62,0.0,1.0
5982,15,0,0,6,6,0.0,1.0
5948,15,0,0,57,57,0.0,1.0
5974,15,0,2,4,6,0.3333333333333333,0.6666666666666666
6090,15,0,0,4,4,0.0,1.0
6068,15,0,3,0,3,1.0,0.0
5962,15,0,3,38,41,0.07317073170731707,0.926829268292683
6033,15,0,0,1,1,0.0,1.0
6038,15,0,1,1,2,0.5,0.5
6042,15,0,7,90,97,0.07216494845360824,0.9278350515463918
5924,15,0,0,3,3,0.0,1.0
6083,15,0,0,27,27,0.0,1.0
6178,15,0,9,9,18,0.5,0.5
5958,15,0,2,2,4,0.5,0.5
6086,15,0,0,14,14,0.0,1.0
5945,15,0,2,17,19,0.10526315789473684,0.8947368421052632
5935,15,0,1,4,5,0.2,0.8
6073,15,0,3,12,15,0.2,0.8
5980,15,0,2,43,45,0.044444444444444446,0.9555555555555556
5993,15,0,3,480,483,0.006211180124223602,0.9937888198757764
6037,15,0,0,223,223,0.0,1.0
5979,15,0,3,2,5,0.6,0.4
5966,15,0,0,73,73,0.0,1.0
5985,15,0,0,3,3,0.0,1.0
5967,15,0,0,76,76,0.0,1.0
6188,15,0,2,20,22,0.09090909090909091,0.9090909090909091
6041,15,0,0,12,12,0.0,1.0
5972,15,0,7,6,13,0.5384615384615384,0.46153846153846156
6069,15,0,2,2,4,0.5,0.5
5937,15,0,1,0,1,1.0,0.0
6028,15,0,5,26,31,0.16129032258064516,0.8387096774193549
5990,15,0,0,130,130,0.0,1.0
5928,15,0,4,477,481,0.008316008316008316,0.9916839916839917
5992,15,0,2,2,4,0.5,0.5
6058,15,0,1,12,13,0.07692307692307693,0.9230769230769231
6001,15,0,3,26,29,0.10344827586206896,0.896551724137931
5964,15,0,4,27,31,0.12903225806451613,0.8709677419354839
5950,15,0,0,4,4,0.0,1.0
5991,15,0,2,6,8,0.25,0.75
6177,15,0,1,308,309,0.003236245954692557,0.9967637540453075
5961,15,0,0,321,321,0.0,1.0
6176,15,0,0,93,93,0.0,1.0
5956,15,0,0,31,31,0.0,1.0
5938,15,0,1,638,639,0.001564945226917058,0.9984350547730829
6179,15,0,1,27,28,0.03571428571428571,0.9642857142857143
5947,15,0,7,53,60,0.11666666666666667,0.8833333333333333
5927,15,0,1,454,455,0.002197802197802198,0.9978021978021978
5977,15,0,0,306,306,0.0,1.0
6198,15,0,0,5,5,0.0,1.0
5957,15,0,0,45,45,0.0,1.0
6057,15,0,0,29,29,0.0,1.0
6043,15,0,6,2,8,0.75,0.25
6077,15,0,0,4,4,0.0,1.0
6014,15,0,3,11,14,0.21428571428571427,0.7857142857142857
6015,15,0,3,0,3,1.0,0.0
5978,15,0,1,2,3,0.3333333333333333,0.6666666666666666
5986,15,0,3,47,50,0.06,0.94
5959,15,0,4,355,359,0.011142061281337047,0.9888579387186629
6051,15,0,0,38,38,0.0,1.0
6029,15,0,1,2,3,0.3333333333333333,0.6666666666666666
6070,15,0,0,1,1,0.0,1.0
5942,15,0,0,145,145,0.0,1.0
5953,15,0,1,3,4,0.25,0.75
6076,15,0,3,4,7,0.42857142857142855,0.5714285714285714
5940,15,0,1,9,10,0.1,0.9
6109,15,0,4,89,93,0.043010752688172046,0.956989247311828
6187,15,0,1,2,3,0.3333333333333333,0.6666666666666666
6053,15,0,0,17,17,0.0,1.0
6104,15,0,1,8,9,0.1111111111111111,0.8888888888888888
5943,15,0,1,1,2,0.5,0.5
6017,15,0,2,1,3,0.6666666666666666,0.3333333333333333
6168,15,0,3,13,16,0.1875,0.8125
5989,15,0,0,6,6,0.0,1.0
5963,15,0,5,1,6,0.8333333333333334,0.16666666666666666
6194,15,0,0,26,26,0.0,1.0
6167,15,0,2,17,19,0.10526315789473684,0.8947368421052632
6004,15,0,0,64,64,0.0,1.0
6030,15,0,6,1,7,0.8571428571428571,0.14285714285714285
6054,15,0,2,4,6,0.3333333333333333,0.6666666666666666
6032,15,0,5,7,12,0.4166666666666667,0.5833333333333334
6170,15,0,4,60,64,0.0625,0.9375
6063,15,0,3,0,3,1.0,0.0
5988,15,0,1,0,1,1.0,0.0
6075,15,0,0,3,3,0.0,1.0
6061,15,0,0,67,67,0.0,1.0
5965,15,0,1,48,49,0.02040816326530612,0.9795918367346939
6040,15,0,3,7,10,0.3,0.7
6059,15,0,0,85,85,0.0,1.0
6106,15,0,2,61,63,0.031746031746031744,0.9682539682539683
6031,15,0,3,11,14,0.21428571428571427,0.7857142857142857
6180,15,0,0,6,6,0.0,1.0
6039,15,0,3,60,63,0.047619047619047616,0.9523809523809523
6189,16,0,0,18,18,0.0,1.0
5936,16,0,1,5,6,0.16666666666666666,0.8333333333333334
6087,16,0,2,9,11,0.18181818181818182,0.8181818181818182
5973,16,0,0,848,848,0.0,1.0
6085,16,0,2,10,12,0.16666666666666666,0.8333333333333334
6012,16,0,0,62,62,0.0,1.0
5982,16,0,1,5,6,0.16666666666666666,0.8333333333333334
5948,16,0,0,57,57,0.0,1.0
5974,16,0,1,5,6,0.16666666666666666,0.8333333333333334
6090,16,0,0,4,4,0.0,1.0
6068,16,0,2,1,3,0.6666666666666666,0.3333333333333333
5962,16,0,2,39,41,0.04878048780487805,0.9512195121951219
6033,16,0,0,1,1,0.0,1.0
6038,16,0,1,1,2,0.5,0.5
6042,16,0,1,96,97,0.010309278350515464,0.9896907216494846
5924,16,0,0,3,3,0.0,1.0
6083,16,0,0,27,27,0.0,1.0
6178,16,0,4,14,18,0.2222222222222222,0.7777777777777778
5958,16,0,3,1,4,0.75,0.25
6086,16,0,0,14,14,0.0,1.0
5945,16,0,1,18,19,0.05263157894736842,0.9473684210526315
5935,16,0,1,4,5,0.2,0.8
6073,16,0,3,12,15,0.2,0.8
5980,16,0,7,38,45,0.15555555555555556,0.8444444444444444
5993,16,0,3,480,483,0.006211180124223602,0.9937888198757764
6037,16,0,0,223,223,0.0,1.0
5979,16,0,3,2,5,0.6,0.4
5966,16,0,0,73,73,0.0,1.0
5985,16,0,1,2,3,0.3333333333333333,0.6666666666666666
5967,16,0,0,76,76,0.0,1.0
6188,16,0,1,21,22,0.045454545454545456,0.9545454545454546
6041,16,0,0,12,12,0.0,1.0
5972,16,0,2,11,13,0.15384615384615385,0.8461538461538461
6069,16,0,1,3,4,0.25,0.75
5937,16,0,1,0,1,1.0,0.0
6028,16,0,4,27,31,0.12903225806451613,0.8709677419354839
5990,16,0,0,130,130,0.0,1.0
5928,16,0,2,479,481,0.004158004158004158,0.9958419958419958
5992,16,0,4,0,4,1.0,0.0
6058,16,0,1,12,13,0.07692307692307693,0.9230769230769231
6001,16,0,1,28,29,0.034482758620689655,0.9655172413793104
5964,16,0,5,26,31,0.16129032258064516,0.8387096774193549
5950,16,0,1,3,4,0.25,0.75
5991,16,0,1,7,8,0.125,0.875
6177,16,0,2,307,309,0.006472491909385114,0.9935275080906149
5961,16,0,0,321,321,0.0,1.0
6176,16,0,0,93,93,0.0,1.0
5956,16,0,0,31,31,0.0,1.0
5938,16,0,0,639,639,0.0,1.0
6179,16,0,1,27,28,0.03571428571428571,0.9642857142857143
5947,16,0,5,55,60,0.08333333333333333,0.9166666666666666
5927,16,0,1,454,455,0.002197802197802198,0.9978021978021978
5977,16,0,0,306,306,0.0,1.0
6198,16,0,0,5,5,0.0,1.0
5957,16,0,0,45,45,0.0,1.0
6057,16,0,1,28,29,0.034482758620689655,0.9655172413793104
6043,16,0,6,2,8,0.75,0.25
6077,16,0,0,4,4,0.0,1.0
6014,16,0,5,9,14,0.35714285714285715,0.6428571428571429
6015,16,0,0,3,3,0.0,1.0
5978,16,0,0,3,3,0.0,1.0
5986,16,0,2,48,50,0.04,0.96
5959,16,0,2,357,359,0.005571030640668524,0.9944289693593314
6051,16,0,2,36,38,0.05263157894736842,0.9473684210526315
6029,16,0,1,2,3,0.3333333333333333,0.6666666666666666
6070,16,0,0,1,1,0.0,1.0
5942,16,0,0,145,145,0.0,1.0
5953,16,0,2,2,4,0.5,0.5
6076,16,0,3,4,7,0.42857142857142855,0.5714285714285714
5940,16,0,3,7,10,0.3,0.7
6109,16,0,2,91,93,0.021505376344086023,0.978494623655914
6187,16,0,0,3,3,0.0,1.0
6053,16,0,0,17,17,0.0,1.0
6104,16,0,1,8,9,0.1111111111111111,0.8888888888888888
5943,16,0,1,1,2,0.5,0.5
6017,16,0,2,1,3,0.6666666666666666,0.3333333333333333
6168,16,0,3,13,16,0.1875,0.8125
5989,16,0,0,6,6,0.0,1.0
5963,16,0,6,0,6,1.0,0.0
6194,16,0,0,26,26,0.0,1.0
6167,16,0,4,15,19,0.21052631578947367,0.7894736842105263
6004,16,0,0,64,64,0.0,1.0
6030,16,0,6,1,7,0.8571428571428571,0.14285714285714285
6054,16,0,2,4,6,0.3333333333333333,0.6666666666666666
6032,16,0,3,9,12,0.25,0.75
6170,16,0,0,64,64,0.0,1.0
6063,16,0,3,0,3,1.0,0.0
5988,16,0,1,0,1,1.0,0.0
6075,16,0,0,3,3,0.0,1.0
6061,16,0,0,67,67,0.0,1.0
5965,16,0,1,48,49,0.02040816326530612,0.9795918367346939
6040,16,0,5,5,10,0.5,0.5
6059,16,0,0,85,85,0.0,1.0
6106,16,0,0,63,63,0.0,1.0
6031,16,0,4,10,14,0.2857142857142857,0.7142857142857143
6180,16,0,0,6,6,0.0,1.0
6039,16,0,6,57,63,0.09523809523809523,0.9047619047619048
6189,17,0,0,18,18,0.0,1.0
5936,17,0,1,5,6,0.16666666666666666,0.8333333333333334
6087,17,0,2,9,11,0.18181818181818182,0.8181818181818182
5973,17,0,1,847,848,0.0011792452830188679,0.9988207547169812
6085,17,0,0,12,12,0.0,1.0
6012,17,0,0,62,62,0.0,1.0
5982,17,0,0,6,6,0.0,1.0
5948,17,0,0,57,57,0.0,1.0
5974,17,0,1,5,6,0.16666666666666666,0.8333333333333334
6090,17,0,0,4,4,0.0,1.0
6068,17,0,3,0,3,1.0,0.0
5962,17,0,1,40,41,0.024390243902439025,0.975609756097561
6033,17,0,0,1,1,0.0,1.0
6038,17,0,1,1,2,0.5,0.5
6042,17,0,3,94,97,0.030927835051546393,0.9690721649484536
5924,17,0,0,3,3,0.0,1.0
6083,17,0,0,27,27,0.0,1.0
6178,17,0,3,15,18,0.16666666666666666,0.8333333333333334
5958,17,0,3,1,4,0.75,0.25
6086,17,0,0,14,14,0.0,1.0
5945,17,0,1,18,19,0.05263157894736842,0.9473684210526315
5935,17,0,4,1,5,0.8,0.2
6073,17,0,2,13,15,0.13333333333333333,0.8666666666666667
5980,17,0,0,45,45,0.0,1.0
5993,17,0,1,482,483,0.002070393374741201,0.9979296066252588
6037,17,0,0,223,223,0.0,1.0
5979,17,0,3,2,5,0.6,0.4
5966,17,0,0,73,73,0.0,1.0
5985,17,0,0,3,3,0.0,1.0
5967,17,0,0,76,76,0.0,1.0
6188,17,0,1,21,22,0.045454545454545456,0.9545454545454546
6041,17,0,0,12,12,0.0,1.0
5972,17,0,4,9,13,0.3076923076923077,0.6923076923076923
6069,17,0,1,3,4,0.25,0.75
5937,17,0,1,0,1,1.0,0.0
6028,17,0,5,26,31,0.16129032258064516,0.8387096774193549
5990,17,0,0,130,130,0.0,1.0
5928,17,0,0,481,481,0.0,1.0
5992,17,0,4,0,4,1.0,0.0
6058,17,0,4,9,13,0.3076923076923077,0.6923076923076923
6001,17,0,2,27,29,0.06896551724137931,0.9310344827586207
5964,17,0,4,27,31,0.12903225806451613,0.8709677419354839
5950,17,0,2,2,4,0.5,0.5
5991,17,0,2,6,8,0.25,0.75
6177,17,0,1,308,309,0.003236245954692557,0.9967637540453075
5961,17,0,0,321,321,0.0,1.0
6176,17,0,0,93,93,0.0,1.0
5956,17,0,0,31,31,0.0,1.0
5938,17,0,1,638,639,0.001564945226917058,0.9984350547730829
6179,17,0,0,28,28,0.0,1.0
5947,17,0,1,59,60,0.016666666666666666,0.9833333333333333
5927,17,0,1,454,455,0.002197802197802198,0.9978021978021978
5977,17,0,0,306,306,0.0,1.0
6198,17,0,0,5,5,0.0,1.0
5957,17,0,0,45,45,0.0,1.0
6057,17,0,0,29,29,0.0,1.0
6043,17,0,5,3,8,0.625,0.375
6077,17,0,0,4,4,0.0,1.0
6014,17,0,2,12,14,0.14285714285714285,0.8571428571428571
6015,17,0,2,1,3,0.6666666666666666,0.3333333333333333
5978,17,0,1,2,3,0.3333333333333333,0.6666666666666666
5986,17,0,2,48,50,0.04,0.96
5959,17,0,2,357,359,0.005571030640668524,0.9944289693593314
6051,17,0,5,33,38,0.13157894736842105,0.868421052631579
6029,17,0,1,2,3,0.3333333333333333,0.6666666666666666
6070,17,0,0,1,1,0.0,1.0
5942,17,0,0,145,145,0.0,1.0
5953,17,0,1,3,4,0.25,0.75
6076,17,0,0,7,7,0.0,1.0
5940,17,0,1,9,10,0.1,0.9
6109,17,0,2,91,93,0.021505376344086023,0.978494623655914
6187,17,0,0,3,3,0.0,1.0
6053,17,0,0,17,17,0.0,1.0
6104,17,0,0,9,9,0.0,1.0
5943,17,0,0,2,2,0.0,1.0
6017,17,0,3,0,3,1.0,0.0
6168,17,0,5,11,16,0.3125,0.6875
5989,17,0,0,6,6,0.0,1.0
5963,17,0,5,1,6,0.8333333333333334,0.16666666666666666
6194,17,0,0,26,26,0.0,1.0
6167,17,0,1,18,19,0.05263157894736842,0.9473684210526315
6004,17,0,1,63,64,0.015625,0.984375
6030,17,0,5,2,7,0.7142857142857143,0.2857142857142857
6054,17,0,2,4,6,0.3333333333333333,0.6666666666666666
6032,17,0,3,9,12,0.25,0.75
6170,17,0,1,63,64,0.015625,0.984375
6063,17,0,3,0,3,1.0,0.0
5988,17,0,1,0,1,1.0,0.0
6075,17,0,0,3,3,0.0,1.0
6061,17,0,0,67,67,0.0,1.0
5965,17,0,0,49,49,0.0,1.0
6040,17,0,2,8,10,0.2,0.8
6059,17,0,0,85,85,0.0,1.0
6106,17,0,0,63,63,0.0,1.0
6031,17,0,2,12,14,0.14285714285714285,0.8571428571428571
6180,17,0,0,6,6,0.0,1.0
6039,17,0,3,60,63,0.047619047619047616,0.9523809523809523
6189,18,0,0,18,18,0.0,1.0
5936,18,0,4,2,6,0.6666666666666666,0.3333333333333333
6087,18,0,2,9,11,0.18181818181818182,0.8181818181818182
5973,18,0,0,848,848,0.0,1.0
6085,18,0,2,10,12,0.16666666666666666,0.8333333333333334
6012,18,0,0,62,62,0.0,1.0
5982,18,0,0,6,6,0.0,1.0
5948,18,0,0,57,57,0.0,1.0
5974,18,0,2,4,6,0.3333333333333333,0.6666666666666666
6090,18,0,0,4,4,0.0,1.0
6068,18,0,2,1,3,0.6666666666666666,0.3333333333333333
5962,18,0,2,39,41,0.04878048780487805,0.9512195121951219
6033,18,0,0,1,1,0.0,1.0
6038,18,0,2,0,2,1.0,0.0
6042,18,0,3,94,97,0.030927835051546393,0.9690721649484536
5924,18,0,1,2,3,0.3333333333333333,0.6666666666666666
6083,18,0,0,27,27,0.0,1.0
6178,18,0,7,11,18,0.3888888888888889,0.6111111111111112
5958,18,0,2,2,4,0.5,0.5
6086,18,0,0,14,14,0.0,1.0
5945,18,0,0,19,19,0.0,1.0
5935,18,0,1,4,5,0.2,0.8
6073,18,0,1,14,15,0.06666666666666667,0.9333333333333333
5980,18,0,0,45,45,0.0,1.0
5993,18,0,1,482,483,0.002070393374741201,0.9979296066252588
6037,18,0,1,222,223,0.004484304932735426,0.9955156950672646
5979,18,0,2,3,5,0.4,0.6
5966,18,0,0,73,73,0.0,1.0
5985,18,0,1,2,3,0.3333333333333333,0.6666666666666666
5967,18,0,0,76,76,0.0,1.0
6188,18,0,1,21,22,0.045454545454545456,0.9545454545454546
6041,18,0,0,12,12,0.0,1.0
5972,18,0,4,9,13,0.3076923076923077,0.6923076923076923
6069,18,0,1,3,4,0.25,0.75
5937,18,0,1,0,1,1.0,0.0
6028,18,0,4,27,31,0.12903225806451613,0.8709677419354839
5990,18,0,0,130,130,0.0,1.0
5928,18,0,0,481,481,0.0,1.0
5992,18,0,3,1,4,0.75,0.25
6058,18,0,4,9,13,0.3076923076923077,0.6923076923076923
6001,18,0,2,27,29,0.06896551724137931,0.9310344827586207
5964,18,0,3,28,31,0.0967741935483871,0.9032258064516129
5950,18,0,3,1,4,0.75,0.25
5991,18,0,1,7,8,0.125,0.875
6177,18,0,0,309,309,0.0,1.0
5961,18,0,0,321,321,0.0,1.0
6176,18,0,0,93,93,0.0,1.0
5956,18,0,0,31,31,0.0,1.0
5938,18,0,2,637,639,0.003129890453834116,0.9968701095461658
6179,18,0,1,27,28,0.03571428571428571,0.9642857142857143
5947,18,0,3,57,60,0.05,0.95
5927,18,0,0,455,455,0.0,1.0
5977,18,0,0,306,306,0.0,1.0
6198,18,0,0,5,5,0.0,1.0
5957,18,0,0,45,45,0.0,1.0
6057,18,0,1,28,29,0.034482758620689655,0.9655172413793104
6043,18,0,5,3,8,0.625,0.375
6077,18,0,0,4,4,0.0,1.0
6014,18,0,2,12,14,0.14285714285714285,0.8571428571428571
6015,18,0,0,3,3,0.0,1.0
5978,18,0,1,2,3,0.3333333333333333,0.6666666666666666
5986,18,0,4,46,50,0.08,0.92
5959,18,0,1,358,359,0.002785515320334262,0.9972144846796658
6051,18,0,5,33,38,0.13157894736842105,0.868421052631579
6029,18,0,0,3,3,0.0,1.0
6070,18,0,0,1,1,0.0,1.0
5942,18,0,0,145,145,0.0,1.0
5953,18,0,2,2,4,0.5,0.5
6076,18,0,0,7,7,0.0,1.0
5940,18,0,1,9,10,0.1,0.9
6109,18,0,2,91,93,0.021505376344086023,0.978494623655914
6187,18,0,0,3,3,0.0,1.0
6053,18,0,0,17,17,0.0,1.0
6104,18,0,2,7,9,0.2222222222222222,0.7777777777777778
5943,18,0,1,1,2,0.5,0.5
6017,18,0,2,1,3,0.6666666666666666,0.3333333333333333
6168,18,0,1,15,16,0.0625,0.9375
5989,18,0,0,6,6,0.0,1.0
5963,18,0,6,0,6,1.0,0.0
6194,18,0,0,26,26,0.0,1.0
6167,18,0,4,15,19,0.21052631578947367,0.7894736842105263
6004,18,0,1,63,64,0.015625,0.984375
6030,18,0,5,2,7,0.7142857142857143,0.2857142857142857
6054,18,0,1,5,6,0.16666666666666666,0.8333333333333334
6032,18,0,1,11,12,0.08333333333333333,0.9166666666666666
6170,18,0,2,62,64,0.03125,0.96875
6063,18,0,3,0,3,1.0,0.0
5988,18,0,1,0,1,1.0,0.0
6075,18,0,0,3,3,0.0,1.0
6061,18,0,0,67,67,0.0,1.0
5965,18,0,1,48,49,0.02040816326530612,0.9795918367346939
6040,18,0,1,9,10,0.1,0.9
6059,18,0,0,85,85,0.0,1.0
6106,18,0,1,62,63,0.015873015873015872,0.9841269841269841
6031,18,0,4,10,14,0.2857142857142857,0.7142857142857143
6180,18,0,0,6,6,0.0,1.0
6039,18,0,3,60,63,0.047619047619047616,0.9523809523809523
6189,19,0,0,18,18,0.0,1.0
5936,19,0,3,3,6,0.5,0.5
6087,19,0,1,10,11,0.09090909090909091,0.9090909090909091
5973,19,0,0,848,848,0.0,1.0
6085,19,0,0,12,12,0.0,1.0
6012,19,0,0,62,62,0.0,1.0
5982,19,0,1,5,6,0.16666666666666666,0.8333333333333334
5948,19,0,0,57,57,0.0,1.0
5974,19,0,2,4,6,0.3333333333333333,0.6666666666666666
6090,19,0,0,4,4,0.0,1.0
6068,19,0,3,0,3,1.0,0.0
5962,19,0,1,40,41,0.024390243902439025,0.975609756097561
6033,19,0,0,1,1,0.0,1.0
6038,19,0,1,1,2,0.5,0.5
6042,19,0,4,93,97,0.041237113402061855,0.9587628865979382
5924,19,0,0,3,3,0.0,1.0
6083,19,0,0,27,27,0.0,1.0
6178,19,0,7,11,18,0.3888888888888889,0.6111111111111112
5958,19,0,3,1,4,0.75,0.25
6086,19,0,0,14,14,0.0,1.0
5945,19,0,1,18,19,0.05263157894736842,0.9473684210526315
5935,19,0,2,3,5,0.4,0.6
6073,19,0,1,14,15,0.06666666666666667,0.9333333333333333
5980,19,0,0,45,45,0.0,1.0
5993,19,0,3,480,483,0.006211180124223602,0.9937888198757764
6037,19,0,1,222,223,0.004484304932735426,0.9955156950672646
5979,19,0,2,3,5,0.4,0.6
5966,19,0,0,73,73,0.0,1.0
5985,19,0,0,3,3,0.0,1.0
5967,19,0,0,76,76,0.0,1.0
6188,19,0,0,22,22,0.0,1.0
6041,19,0,0,12,12,0.0,1.0
5972,19,0,6,7,13,0.46153846153846156,0.5384615384615384
6069,19,0,2,2,4,0.5,0.5
5937,19,0,1,0,1,1.0,0.0
6028,19,0,5,26,31,0.16129032258064516,0.8387096774193549
5990,19,0,0,130,130,0.0,1.0
5928,19,0,2,479,481,0.004158004158004158,0.9958419958419958
5992,19,0,3,1,4,0.75,0.25
6058,19,0,4,9,13,0.3076923076923077,0.6923076923076923
6001,19,0,2,27,29,0.06896551724137931,0.9310344827586207
5964,19,0,7,24,31,0.22580645161290322,0.7741935483870968
5950,19,0,0,4,4,0.0,1.0
5991,19,0,1,7,8,0.125,0.875
6177,19,0,0,309,309,0.0,1.0
5961,19,0,0,321,321,0.0,1.0
6176,19,0,0,93,93,0.0,1.0
5956,19,0,0,31,31,0.0,1.0
5938,19,0,1,638,639,0.001564945226917058,0.9984350547730829
6179,19,0,2,26,28,0.07142857142857142,0.9285714285714286
5947,19,0,2,58,60,0.03333333333333333,0.9666666666666667
5927,19,0,2,453,455,0.004395604395604396,0.9956043956043956
5977,19,0,0,306,306,0.0,1.0
6198,19,0,0,5,5,0.0,1.0
5957,19,0,0,45,45,0.0,1.0
6057,19,0,0,29,29,0.0,1.0
6043,19,0,5,3,8,0.625,0.375
6077,19,0,0,4,4,0.0,1.0
6014,19,0,3,11,14,0.21428571428571427,0.7857142857142857
6015,19,0,2,1,3,0.6666666666666666,0.3333333333333333
5978,19,0,1,2,3,0.3333333333333333,0.6666666666666666
5986,19,0,0,50,50,0.0,1.0
5959,19,0,0,359,359,0.0,1.0
6051,19,0,0,38,38,0.0,1.0
6029,19,0,0,3,3,0.0,1.0
6070,19,0,0,1,1,0.0,1.0
5942,19,0,0,145,145,0.0,1.0
5953,19,0,1,3,4,0.25,0.75
6076,19,0,0,7,7,0.0,1.0
5940,19,0,2,8,10,0.2,0.8
6109,19,0,1,92,93,0.010752688172043012,0.989247311827957
6187,19,0,1,2,3,0.3333333333333333,0.6666666666666666
6053,19,0,0,17,17,0.0,1.0
6104,19,0,2,7,9,0.2222222222222222,0.7777777777777778
5943,19,0,0,2,2,0.0,1.0
6017,19,0,2,1,3,0.6666666666666666,0.3333333333333333
6168,19,0,1,15,16,0.0625,0.9375
5989,19,0,0,6,6,0.0,1.0
5963,19,0,6,0,6,1.0,0.0
6194,19,0,0,26,26,0.0,1.0
6167,19,0,0,19,19,0.0,1.0
6004,19,0,0,64,64,0.0,1.0
6030,19,0,3,4,7,0.42857142857142855,0.5714285714285714
6054,19,0,1,5,6,0.16666666666666666,0.8333333333333334
6032,19,0,2,10,12,0.16666666666666666,0.8333333333333334
6170,19,0,0,64,64,0.0,1.0
6063,19,0,3,0,3,1.0,0.0
5988,19,0,1,0,1,1.0,0.0
6075,19,0,0,3,3,0.0,1.0
6061,19,0,0,67,67,0.0,1.0
5965,19,0,1,48,49,0.02040816326530612,0.9795918367346939
6040,19,0,1,9,10,0.1,0.9
6059,19,0,0,85,85,0.0,1.0
6106,19,0,1,62,63,0.015873015873015872,0.9841269841269841
6031,19,0,4,10,14,0.2857142857142857,0.7142857142857143
6180,19,0,0,6,6,0.0,1.0
6039,19,0,7,56,63,0.1111111111111111,0.8888888888888888
6189,20,0,0,18,18,0.0,1.0
5936,20,0,3,3,6,0.5,0.5
6087,20,0,4,7,11,0.36363636363636365,0.6363636363636364
5973,20,0,0,848,848,0.0,1.0
6085,20,0,0,12,12,0.0,1.0
6012,20,0,0,62,62,0.0,1.0
5982,20,0,1,5,6,0.16666666666666666,0.8333333333333334
5948,20,0,0,57,57,0.0,1.0
5974,20,0,2,4,6,0.3333333333333333,0.6666666666666666
6090,20,0,0,4,4,0.0,1.0
6068,20,0,2,1,3,0.6666666666666666,0.3333333333333333
5962,20,0,2,39,41,0.04878048780487805,0.9512195121951219
6033,20,0,0,1,1,0.0,1.0
6038,20,0,1,1,2,0.5,0.5
6042,20,0,5,92,97,0.05154639175257732,0.9484536082474226
5924,20,0,0,3,3,0.0,1.0
6083,20,0,0,27,27,0.0,1.0
6178,20,0,0,18,18,0.0,1.0
5958,20,0,2,2,4,0.5,0.5
6086,20,0,0,14,14,0.0,1.0
5945,20,0,1,18,19,0.05263157894736842,0.9473684210526315
5935,20,0,1,4,5,0.2,0.8
6073,20,0,2,13,15,0.13333333333333333,0.8666666666666667
5980,20,0,1,44,45,0.022222222222222223,0.9777777777777777
5993,20,0,3,480,483,0.006211180124223602,0.9937888198757764
6037,20,0,0,223,223,0.0,1.0
5979,20,0,1,4,5,0.2,0.8
5966,20,0,0,73,73,0.0,1.0
5985,20,0,0,3,3,0.0,1.0
5967,20,0,0,76,76,0.0,1.0
6188,20,0,2,20,22,0.09090909090909091,0.9090909090909091
6041,20,0,0,12,12,0.0,1.0
5972,20,0,8,5,13,0.6153846153846154,0.38461538461538464
6069,20,0,2,2,4,0.5,0.5
5937,20,0,1,0,1,1.0,0.0
6028,20,0,4,27,31,0.12903225806451613,0.8709677419354839
5990,20,0,0,130,130,0.0,1.0
5928,20,0,3,478,481,0.006237006237006237,0.9937629937629938
5992,20,0,2,2,4,0.5,0.5
6058,20,0,1,12,13,0.07692307692307693,0.9230769230769231
6001,20,0,2,27,29,0.06896551724137931,0.9310344827586207
5964,20,0,4,27,31,0.12903225806451613,0.8709677419354839
5950,20,0,2,2,4,0.5,0.5
5991,20,0,0,8,8,0.0,1.0
6177,20,0,1,308,309,0.003236245954692557,0.9967637540453075
5961,20,0,0,321,321,0.0,1.0
6176,20,0,0,93,93,0.0,1.0
5956,20,0,0,31,31,0.0,1.0
5938,20,0,0,639,639,0.0,1.0
6179,20,0,2,26,28,0.07142857142857142,0.9285714285714286
5947,20,0,7,53,60,0.11666666666666667,0.8833333333333333
5927,20,0,0,455,455,0.0,1.0
5977,20,0,0,306,306,0.0,1.0
6198,20,0,0,5,5,0.0,1.0
5957,20,0,0,45,45,0.0,1.0
6057,20,0,0,29,29,0.0,1.0
6043,20,0,4,4,8,0.5,0.5
6077,20,0,0,4,4,0.0,1.0
6014,20,0,2,12,14,0.14285714285714285,0.8571428571428571
6015,20,0,0,3,3,0.0,1.0
5978,20,0,1,2,3,0.3333333333333333,0.6666666666666666
5986,20,0,3,47,50,0.06,0.94
5959,20,0,1,358,359,0.002785515320334262,0.9972144846796658
6051,20,0,0,38,38,0.0,1.0
6029,20,0,1,2,3,0.3333333333333333,0.6666666666666666
6070,20,0,0,1,1,0.0,1.0
5942,20,0,0,145,145,0.0,1.0
5953,20,0,0,4,4,0.0,1.0
6076,20,0,3,4,7,0.42857142857142855,0.5714285714285714
5940,20,0,1,9,10,0.1,0.9
6109,20,0,1,92,93,0.010752688172043012,0.989247311827957
6187,20,0,1,2,3,0.3333333333333333,0.6666666666666666
6053,20,0,0,17,17,0.0,1.0
6104,20,0,2,7,9,0.2222222222222222,0.7777777777777778
5943,20,0,0,2,2,0.0,1.0
6017,20,0,3,0,3,1.0,0.0
6168,20,0,2,14,16,0.125,0.875
5989,20,0,2,4,6,0.3333333333333333,0.6666666666666666
5963,20,0,6,0,6,1.0,0.0
6194,20,0,0,26,26,0.0,1.0
6167,20,0,1,18,19,0.05263157894736842,0.9473684210526315
6004,20,0,1,63,64,0.015625,0.984375
6030,20,0,5,2,7,0.7142857142857143,0.2857142857142857
6054,20,0,2,4,6,0.3333333333333333,0.6666666666666666
6032,20,0,3,9,12,0.25,0.75
6170,20,0,1,63,64,0.015625,0.984375
6063,20,0,3,0,3,1.0,0.0
5988,20,0,1,0,1,1.0,0.0
6075,20,0,0,3,3,0.0,1.0
6061,20,0,0,67,67,0.0,1.0
5965,20,0,1,48,49,0.02040816326530612,0.9795918367346939
6040,20,0,2,8,10,0.2,0.8
6059,20,0,0,85,85,0.0,1.0
6106,20,0,1,62,63,0.015873015873015872,0.9841269841269841
6031,20,0,3,11,14,0.21428571428571427,0.7857142857142857
6180,20,0,0,6,6,0.0,1.0
6039,20,0,1,62,63,0.015873015873015872,0.9841269841269841
6189,21,0,0,18,18,0.0,1.0
5936,21,0,2,4,6,0.3333333333333333,0.6666666666666666
6087,21,0,2,9,11,0.18181818181818182,0.8181818181818182
5973,21,0,0,848,848,0.0,1.0
6085,21,0,0,12,12,0.0,1.0
6012,21,0,0,62,62,0.0,1.0
5982,21,0,0,6,6,0.0,1.0
5948,21,0,0,57,57,0.0,1.0
5974,21,0,3,3,6,0.5,0.5
6090,21,0,0,4,4,0.0,1.0
6068,21,0,3,0,3,1.0,0.0
5962,21,0,0,41,41,0.0,1.0
6033,21,0,0,1,1,0.0,1.0
6038,21,0,2,0,2,1.0,0.0
6042,21,0,3,94,97,0.030927835051546393,0.9690721649484536
5924,21,0,1,2,3,0.3333333333333333,0.6666666666666666
6083,21,0,0,27,27,0.0,1.0
6178,21,0,2,16,18,0.1111111111111111,0.8888888888888888
5958,21,0,2,2,4,0.5,0.5
6086,21,0,0,14,14,0.0,1.0
5945,21,0,0,19,19,0.0,1.0
5935,21,0,0,5,5,0.0,1.0
6073,21,0,4,11,15,0.26666666666666666,0.7333333333333333
5980,21,0,1,44,45,0.022222222222222223,0.9777777777777777
5993,21,0,0,483,483,0.0,1.0
6037,21,0,0,223,223,0.0,1.0
5979,21,0,2,3,5,0.4,0.6
5966,21,0,0,73,73,0.0,1.0
5985,21,0,0,3,3,0.0,1.0
5967,21,0,0,76,76,0.0,1.0
6188,21,0,2,20,22,0.09090909090909091,0.9090909090909091
6041,21,0,0,12,12,0.0,1.0
5972,21,0,4,9,13,0.3076923076923077,0.6923076923076923
6069,21,0,1,3,4,0.25,0.75
5937,21,0,1,0,1,1.0,0.0
6028,21,0,5,26,31,0.16129032258064516,0.8387096774193549
5990,21,0,0,130,130,0.0,1.0
5928,21,0,2,479,481,0.004158004158004158,0.9958419958419958
5992,21,0,2,2,4,0.5,0.5
6058,21,0,2,11,13,0.15384615384615385,0.8461538461538461
6001,21,0,2,27,29,0.06896551724137931,0.9310344827586207
5964,21,0,4,27,31,0.12903225806451613,0.8709677419354839
5950,21,0,0,4,4,0.0,1.0
5991,21,0,1,7,8,0.125,0.875
6177,21,0,1,308,309,0.003236245954692557,0.9967637540453075
5961,21,0,0,321,321,0.0,1.0
6176,21,0,0,93,93,0.0,1.0
5956,21,0,0,31,31,0.0,1.0
5938,21,0,0,639,639,0.0,1.0
6179,21,0,1,27,28,0.03571428571428571,0.9642857142857143
5947,21,0,1,59,60,0.016666666666666666,0.9833333333333333
5927,21,0,1,454,455,0.002197802197802198,0.9978021978021978
5977,21,0,0,306,306,0.0,1.0
6198,21,0,0,5,5,0.0,1.0
5957,21,0,0,45,45,0.0,1.0
6057,21,0,0,29,29,0.0,1.0
6043,21,0,3,5,8,0.375,0.625
6077,21,0,0,4,4,0.0,1.0
6014,21,0,2,12,14,0.14285714285714285,0.8571428571428571
6015,21,0,2,1,3,0.6666666666666666,0.3333333333333333
5978,21,0,2,1,3,0.6666666666666666,0.3333333333333333
5986,21,0,1,49,50,0.02,0.98
5959,21,0,1,358,359,0.002785515320334262,0.9972144846796658
6051,21,0,3,35,38,0.07894736842105263,0.9210526315789473
6029,21,0,0,3,3,0.0,1.0
6070,21,0,0,1,1,0.0,1.0
5942,21,0,0,145,145,0.0,1.0
5953,21,0,2,2,4,0.5,0.5
6076,21,0,0,7,7,0.0,1.0
5940,21,0,1,9,10,0.1,0.9
6109,21,0,1,92,93,0.010752688172043012,0.989247311827957
6187,21,0,0,3,3,0.0,1.0
6053,21,0,0,17,17,0.0,1.0
6104,21,0,0,9,9,0.0,1.0
5943,21,0,1,1,2,0.5,0.5
6017,21,0,3,0,3,1.0,0.0
6168,21,0,1,15,16,0.0625,0.9375
5989,21,0,2,4,6,0.3333333333333333,0.6666666666666666
5963,21,0,6,0,6,1.0,0.0
6194,21,0,0,26,26,0.0,1.0
6167,21,0,3,16,19,0.15789473684210525,0.8421052631578947
6004,21,0,0,64,64,0.0,1.0
6030,21,0,5,2,7,0.7142857142857143,0.2857142857142857
6054,21,0,1,5,6,0.16666666666666666,0.8333333333333334
6032,21,0,2,10,12,0.16666666666666666,0.8333333333333334
6170,21,0,3,61,64,0.046875,0.953125
6063,21,0,3,0,3,1.0,0.0
5988,21,0,1,0,1,1.0,0.0
6075,21,0,0,3,3,0.0,1.0
6061,21,0,0,67,67,0.0,1.0
5965,21,0,0,49,49,0.0,1.0
6040,21,0,0,10,10,0.0,1.0
6059,21,0,0,85,85,0.0,1.0
6106,21,0,1,62,63,0.015873015873015872,0.9841269841269841
6031,21,0,6,8,14,0.42857142857142855,0.5714285714285714
6180,21,0,0,6,6,0.0,1.0
6039,21,0,1,62,63,0.015873015873015872,0.9841269841269841
6189,22,0,0,18,18,0.0,1.0
5936,22,0,2,4,6,0.3333333333333333,0.6666666666666666
6087,22,0,2,9,11,0.18181818181818182,0.8181818181818182
5973,22,0,0,848,848,0.0,1.0
6085,22,0,6,6,12,0.5,0.5
6012,22,0,0,62,62,0.0,1.0
5982,22,0,1,5,6,0.16666666666666666,0.8333333333333334
5948,22,0,0,57,57,0.0,1.0
5974,22,0,2,4,6,0.3333333333333333,0.6666666666666666
6090,22,0,0,4,4,0.0,1.0
6068,22,0,2,1,3,0.6666666666666666,0.3333333333333333
5962,22,0,1,40,41,0.024390243902439025,0.975609756097561
6033,22,0,0,1,1,0.0,1.0
6038,22,0,1,1,2,0.5,0.5
6042,22,0,2,95,97,0.020618556701030927,0.979381443298969
5924,22,0,0,3,3,0.0,1.0
6083,22,0,0,27,27,0.0,1.0
6178,22,0,3,15,18,0.16666666666666666,0.8333333333333334
5958,22,0,3,1,4,0.75,0.25
6086,22,0,0,14,14,0.0,1.0
5945,22,0,1,18,19,0.05263157894736842,0.9473684210526315
5935,22,0,0,5,5,0.0,1.0
6073,22,0,1,14,15,0.06666666666666667,0.9333333333333333
5980,22,0,0,45,45,0.0,1.0
5993,22,0,1,482,483,0.002070393374741201,0.9979296066252588
6037,22,0,0,223,223,0.0,1.0
5979,22,0,2,3,5,0.4,0.6
5966,22,0,0,73,73,0.0,1.0
5985,22,0,0,3,3,0.0,1.0
5967,22,0,0,76,76,0.0,1.0
6188,22,0,1,21,22,0.045454545454545456,0.9545454545454546
6041,22,0,0,12,12,0.0,1.0
5972,22,0,4,9,13,0.3076923076923077,0.6923076923076923
6069,22,0,0,4,4,0.0,1.0
5937,22,0,1,0,1,1.0,0.0
6028,22,0,3,28,31,0.0967741935483871,0.9032258064516129
5990,22,0,0,130,130,0.0,1.0
5928,22,0,1,480,481,0.002079002079002079,0.997920997920998
5992,22,0,4,0,4,1.0,0.0
6058,22,0,2,11,13,0.15384615384615385,0.8461538461538461
6001,22,0,1,28,29,0.034482758620689655,0.9655172413793104
5964,22,0,3,28,31,0.0967741935483871,0.9032258064516129
5950,22,0,3,1,4,0.75,0.25
5991,22,0,1,7,8,0.125,0.875
6177,22,0,1,308,309,0.003236245954692557,0.9967637540453075
5961,22,0,0,321,321,0.0,1.0
6176,22,0,0,93,93,0.0,1.0
5956,22,0,0,31,31,0.0,1.0
5938,22,0,0,639,639,0.0,1.0
6179,22,0,1,27,28,0.03571428571428571,0.9642857142857143
5947,22,0,3,57,60,0.05,0.95
5927,22,0,1,454,455,0.002197802197802198,0.9978021978021978
5977,22,0,0,306,306,0.0,1.0
6198,22,0,0,5,5,0.0,1.0
5957,22,0,0,45,45,0.0,1.0
6057,22,0,1,28,29,0.034482758620689655,0.9655172413793104
6043,22,0,3,5,8,0.375,0.625
6077,22,0,0,4,4,0.0,1.0
6014,22,0,2,12,14,0.14285714285714285,0.8571428571428571
6015,22,0,0,3,3,0.0,1.0
5978,22,0,2,1,3,0.6666666666666666,0.3333333333333333
5986,22,0,0,50,50,0.0,1.0
5959,22,0,0,359,359,0.0,1.0
6051,22,0,0,38,38,0.0,1.0
6029,22,0,1,2,3,0.3333333333333333,0.6666666666666666
6070,22,0,0,1,1,0.0,1.0
5942,22,0,0,145,145,0.0,1.0
5953,22,0,0,4,4,0.0,1.0
6076,22,0,0,7,7,0.0,1.0
5940,22,0,0,10,10,0.0,1.0
6109,22,0,2,91,93,0.021505376344086023,0.978494623655914
6187,22,0,0,3,3,0.0,1.0
6053,22,0,0,17,17,0.0,1.0
6104,22,0,0,9,9,0.0,1.0
5943,22,0,0,2,2,0.0,1.0
6017,22,0,2,1,3,0.6666666666666666,0.3333333333333333
6168,22,0,1,15,16,0.0625,0.9375
5989,22,0,0,6,6,0.0,1.0
5963,22,0,5,1,6,0.8333333333333334,0.16666666666666666
6194,22,0,0,26,26,0.0,1.0
6167,22,0,2,17,19,0.10526315789473684,0.8947368421052632
6004,22,0,0,64,64,0.0,1.0
6030,22,0,4,3,7,0.5714285714285714,0.42857142857142855
6054,22,0,1,5,6,0.16666666666666666,0.8333333333333334
6032,22,0,1,11,12,0.08333333333333333,0.9166666666666666
6170,22,0,2,62,64,0.03125,0.96875
6063,22,0,3,0,3,1.0,0.0
5988,22,0,1,0,1,1.0,0.0
6075,22,0,0,3,3,0.0,1.0
6061,22,0,0,67,67,0.0,1.0
5965,22,0,3,46,49,0.061224489795918366,0.9387755102040817
6040,22,0,1,9,10,0.1,0.9
6059,22,0,0,85,85,0.0,1.0
6106,22,0,3,60,63,0.047619047619047616,0.9523809523809523
6031,22,0,1,13,14,0.07142857142857142,0.9285714285714286
6180,22,0,0,6,6,0.0,1.0
6039,22,0,3,60,63,0.047619047619047616,0.9523809523809523
6189,23,0,0,18,18,0.0,1.0
5936,23,0,0,6,6,0.0,1.0
6087,23,0,3,8,11,0.2727272727272727,0.7272727272727273
5973,23,0,0,848,848,0.0,1.0
6085,23,0,3,9,12,0.25,0.75
6012,23,0,0,62,62,0.0,1.0
5982,23,0,1,5,6,0.16666666666666666,0.8333333333333334
5948,23,0,0,57,57,0.0,1.0
5974,23,0,3,3,6,0.5,0.5
6090,23,0,0,4,4,0.0,1.0
6068,23,0,2,1,3,0.6666666666666666,0.3333333333333333
5962,23,0,0,41,41,0.0,1.0
6033,23,0,0,1,1,0.0,1.0
6038,23,0,1,1,2,0.5,0.5
6042,23,0,1,96,97,0.010309278350515464,0.9896907216494846
5924,23,0,0,3,3,0.0,1.0
6083,23,0,0,27,27,0.0,1.0
6178,23,0,4,14,18,0.2222222222222222,0.7777777777777778
5958,23,0,3,1,4,0.75,0.25
6086,23,0,0,14,14,0.0,1.0
5945,23,0,0,19,19,0.0,1.0
5935,23,0,1,4,5,0.2,0.8
6073,23,0,0,15,15,0.0,1.0
5980,23,0,1,44,45,0.022222222222222223,0.9777777777777777
5993,23,0,2,481,483,0.004140786749482402,0.9958592132505176
6037,23,0,0,223,223,0.0,1.0
5979,23,0,2,3,5,0.4,0.6
5966,23,0,0,73,73,0.0,1.0
5985,23,0,0,3,3,0.0,1.0
5967,23,0,0,76,76,0.0,1.0
6188,23,0,0,22,22,0.0,1.0
6041,23,0,0,12,12,0.0,1.0
5972,23,0,3,10,13,0.23076923076923078,0.7692307692307693
6069,23,0,1,3,4,0.25,0.75
5937,23,0,1,0,1,1.0,0.0
6028,23,0,3,28,31,0.0967741935483871,0.9032258064516129
5990,23,0,0,130,130,0.0,1.0
5928,23,0,3,478,481,0.006237006237006237,0.9937629937629938
5992,23,0,2,2,4,0.5,0.5
6058,23,0,1,12,13,0.07692307692307693,0.9230769230769231
6001,23,0,2,27,29,0.06896551724137931,0.9310344827586207
5964,23,0,2,29,31,0.06451612903225806,0.9354838709677419
5950,23,0,3,1,4,0.75,0.25
5991,23,0,0,8,8,0.0,1.0
6177,23,0,0,309,309,0.0,1.0
5961,23,0,0,321,321,0.0,1.0
6176,23,0,0,93,93,0.0,1.0
5956,23,0,0,31,31,0.0,1.0
5938,23,0,0,639,639,0.0,1.0
6179,23,0,0,28,28,0.0,1.0
5947,23,0,1,59,60,0.016666666666666666,0.9833333333333333
5927,23,0,1,454,455,0.002197802197802198,0.9978021978021978
5977,23,0,0,306,306,0.0,1.0
6198,23,0,0,5,5,0.0,1.0
5957,23,0,0,45,45,0.0,1.0
6057,23,0,0,29,29,0.0,1.0
6043,23,0,1,7,8,0.125,0.875
6077,23,0,0,4,4,0.0,1.0
6014,23,0,0,14,14,0.0,1.0
6015,23,0,0,3,3,0.0,1.0
5978,23,0,1,2,3,0.3333333333333333,0.6666666666666666
5986,23,0,1,49,50,0.02,0.98
5959,23,0,3,356,359,0.008356545961002786,0.9916434540389972
6051,23,0,0,38,38,0.0,1.0
6029,23,0,1,2,3,0.3333333333333333,0.6666666666666666
6070,23,0,0,1,1,0.0,1.0
5942,23,0,0,145,145,0.0,1.0
5953,23,0,4,0,4,1.0,0.0
6076,23,0,2,5,7,0.2857142857142857,0.7142857142857143
5940,23,0,2,8,10,0.2,0.8
6109,23,0,1,92,93,0.010752688172043012,0.989247311827957
6187,23,0,0,3,3,0.0,1.0
6053,23,0,0,17,17,0.0,1.0
6104,23,0,0,9,9,0.0,1.0
5943,23,0,0,2,2,0.0,1.0
6017,23,0,2,1,3,0.6666666666666666,0.3333333333333333
6168,23,0,1,15,16,0.0625,0.9375
5989,23,0,2,4,6,0.3333333333333333,0.6666666666666666
5963,23,0,6,0,6,1.0,0.0
6194,23,0,0,26,26,0.0,1.0
6167,23,0,0,19,19,0.0,1.0
6004,23,0,0,64,64,0.0,1.0
6030,23,0,7,0,7,1.0,0.0
6054,23,0,2,4,6,0.3333333333333333,0.6666666666666666
6032,23,0,2,10,12,0.16666666666666666,0.8333333333333334
6170,23,0,0,64,64,0.0,1.0
6063,23,0,3,0,3,1.0,0.0
5988,23,0,1,0,1,1.0,0.0
6075,23,0,0,3,3,0.0,1.0
6061,23,0,0,67,67,0.0,1.0
5965,23,0,1,48,49,0.02040816326530612,0.9795918367346939
6040,23,0,3,7,10,0.3,0.7
6059,23,0,0,85,85,0.0,1.0
6106,23,0,1,62,63,0.015873015873015872,0.9841269841269841
6031,23,0,1,13,14,0.07142857142857142,0.9285714285714286
6180,23,0,0,6,6,0.0,1.0
6039,23,0,3,60,63,0.047619047619047616,0.9523809523809523
6189,24,0,0,18,18,0.0,1.0
5936,24,0,0,6,6,0.0,1.0
6087,24,0,2,9,11,0.18181818181818182,0.8181818181818182
5973,24,0,0,848,848,0.0,1.0
6085,24,0,1,11,12,0.08333333333333333,0.9166666666666666
6012,24,0,0,62,62,0.0,1.0
5982,24,0,0,6,6,0.0,1.0
5948,24,0,0,57,57,0.0,1.0
5974,24,0,2,4,6,0.3333333333333333,0.6666666666666666
6090,24,0,0,4,4,0.0,1.0
6068,24,0,1,2,3,0.3333333333333333,0.6666666666666666
5962,24,0,1,40,41,0.024390243902439025,0.975609756097561
6033,24,0,0,1,1,0.0,1.0
6038,24,0,2,0,2,1.0,0.0
6042,24,0,2,95,97,0.020618556701030927,0.979381443298969
5924,24,0,0,3,3,0.0,1.0
6083,24,0,0,27,27,0.0,1.0
6178,24,0,6,12,18,0.3333333333333333,0.6666666666666666
5958,24,0,2,2,4,0.5,0.5
6086,24,0,0,14,14,0.0,1.0
5945,24,0,0,19,19,0.0,1.0
5935,24,0,0,5,5,0.0,1.0
6073,24,0,1,14,15,0.06666666666666667,0.9333333333333333
5980,24,0,0,45,45,0.0,1.0
5993,24,0,1,482,483,0.002070393374741201,0.9979296066252588
6037,24,0,0,223,223,0.0,1.0
5979,24,0,3,2,5,0.6,0.4
5966,24,0,0,73,73,0.0,1.0
5985,24,0,0,3,3,0.0,1.0
5967,24,0,0,76,76,0.0,1.0
6188,24,0,1,21,22,0.045454545454545456,0.9545454545454546
6041,24,0,0,12,12,0.0,1.0
5972,24,0,2,11,13,0.15384615384615385,0.8461538461538461
6069,24,0,1,3,4,0.25,0.75
5937,24,0,1,0,1,1.0,0.0
6028,24,0,2,29,31,0.06451612903225806,0.9354838709677419
5990,24,0,0,130,130,0.0,1.0
5928,24,0,0,481,481,0.0,1.0
5992,24,0,3,1,4,0.75,0.25
6058,24,0,0,13,13,0.0,1.0
6001,24,0,1,28,29,0.034482758620689655,0.9655172413793104
5964,24,0,3,28,31,0.0967741935483871,0.9032258064516129
5950,24,0,0,4,4,0.0,1.0
5991,24,0,1,7,8,0.125,0.875
6177,24,0,1,308,309,0.003236245954692557,0.9967637540453075
5961,24,0,0,321,321,0.0,1.0
6176,24,0,0,93,93,0.0,1.0
5956,24,0,0,31,31,0.0,1.0
5938,24,0,0,639,639,0.0,1.0
6179,24,0,0,28,28,0.0,1.0
5947,24,0,1,59,60,0.016666666666666666,0.9833333333333333
5927,24,0,1,454,455,0.002197802197802198,0.9978021978021978
5977,24,0,0,306,306,0.0,1.0
6198,24,0,0,5,5,0.0,1.0
5957,24,0,0,45,45,0.0,1.0
6057,24,0,1,28,29,0.034482758620689655,0.9655172413793104
6043,24,0,2,6,8,0.25,0.75
6077,24,0,0,4,4,0.0,1.0
6014,24,0,2,12,14,0.14285714285714285,0.8571428571428571
6015,24,0,0,3,3,0.0,1.0
5978,24,0,1,2,3,0.3333333333333333,0.6666666666666666
5986,24,0,1,49,50,0.02,0.98
5959,24,0,0,359,359,0.0,1.0
6051,24,0,2,36,38,0.05263157894736842,0.9473684210526315
6029,24,0,0,3,3,0.0,1.0
6070,24,0,0,1,1,0.0,1.0
5942,24,0,0,145,145,0.0,1.0
5953,24,0,1,3,4,0.25,0.75
6076,24,0,0,7,7,0.0,1.0
5940,24,0,0,10,10,0.0,1.0
6109,24,0,1,92,93,0.010752688172043012,0.989247311827957
6187,24,0,0,3,3,0.0,1.0
6053,24,0,0,17,17,0.0,1.0
6104,24,0,0,9,9,0.0,1.0
5943,24,0,1,1,2,0.5,0.5
6017,24,0,2,1,3,0.6666666666666666,0.3333333333333333
6168,24,0,3,13,16,0.1875,0.8125
5989,24,0,0,6,6,0.0,1.0
5963,24,0,6,0,6,1.0,0.0
6194,24,0,0,26,26,0.0,1.0
6167,24,0,0,19,19,0.0,1.0
6004,24,0,1,63,64,0.015625,0.984375
6030,24,0,3,4,7,0.42857142857142855,0.5714285714285714
6054,24,0,1,5,6,0.16666666666666666,0.8333333333333334
6032,24,0,2,10,12,0.16666666666666666,0.8333333333333334
6170,24,0,1,63,64,0.015625,0.984375
6063,24,0,1,2,3,0.3333333333333333,0.6666666666666666
5988,24,0,1,0,1,1.0,0.0
6075,24,0,0,3,3,0.0,1.0
6061,24,0,0,67,67,0.0,1.0
5965,24,0,0,49,49,0.0,1.0
6040,24,0,1,9,10,0.1,0.9
6059,24,0,0,85,85,0.0,1.0
6106,24,0,0,63,63,0.0,1.0
6031,24,0,3,11,14,0.21428571428571427,0.7857142857142857
6180,24,0,0,6,6,0.0,1.0
6039,24,0,0,63,63,0.0,1.0
6189,25,0,0,18,18,0.0,1.0
5936,25,0,1,5,6,0.16666666666666666,0.8333333333333334
6087,25,0,0,11,11,0.0,1.0
5973,25,0,0,848,848,0.0,1.0
6085,25,0,1,11,12,0.08333333333333333,0.9166666666666666
6012,25,0,0,62,62,0.0,1.0
5982,25,0,0,6,6,0.0,1.0
5948,25,0,0,57,57,0.0,1.0
5974,25,0,1,5,6,0.16666666666666666,0.8333333333333334
6090,25,0,0,4,4,0.0,1.0
6068,25,0,1,2,3,0.3333333333333333,0.6666666666666666
5962,25,0,1,40,41,0.024390243902439025,0.975609756097561
6033,25,0,0,1,1,0.0,1.0
6038,25,0,2,0,2,1.0,0.0
6042,25,0,1,96,97,0.010309278350515464,0.9896907216494846
5924,25,0,1,2,3,0.3333333333333333,0.6666666666666666
6083,25,0,0,27,27,0.0,1.0
6178,25,0,5,13,18,0.2777777777777778,0.7222222222222222
5958,25,0,2,2,4,0.5,0.5
6086,25,0,0,14,14,0.0,1.0
5945,25,0,1,18,19,0.05263157894736842,0.9473684210526315
5935,25,0,0,5,5,0.0,1.0
6073,25,0,0,15,15,0.0,1.0
5980,25,0,1,44,45,0.022222222222222223,0.9777777777777777
5993,25,0,2,481,483,0.004140786749482402,0.9958592132505176
6037,25,0,0,223,223,0.0,1.0
5979,25,0,2,3,5,0.4,0.6
5966,25,0,0,73,73,0.0,1.0
5985,25,0,0,3,3,0.0,1.0
5967,25,0,0,76,76,0.0,1.0
6188,25,0,1,21,22,0.045454545454545456,0.9545454545454546
6041,25,0,0,12,12,0.0,1.0
5972,25,0,1,12,13,0.07692307692307693,0.9230769230769231
6069,25,0,0,4,4,0.0,1.0
5937,25,0,1,0,1,1.0,0.0
6028,25,0,2,29,31,0.06451612903225806,0.9354838709677419
5990,25,0,0,130,130,0.0,1.0
5928,25,0,0,481,481,0.0,1.0
5992,25,0,2,2,4,0.5,0.5
6058,25,0,2,11,13,0.15384615384615385,0.8461538461538461
6001,25,0,2,27,29,0.06896551724137931,0.9310344827586207
5964,25,0,1,30,31,0.03225806451612903,0.967741935483871
5950,25,0,0,4,4,0.0,1.0
5991,25,0,0,8,8,0.0,1.0
6177,25,0,1,308,309,0.003236245954692557,0.9967637540453075
5961,25,0,0,321,321,0.0,1.0
6176,25,0,0,93,93,0.0,1.0
5956,25,0,0,31,31,0.0,1.0
5938,25,0,0,639,639,0.0,1.0
6179,25,0,1,27,28,0.03571428571428571,0.9642857142857143
5947,25,0,2,58,60,0.03333333333333333,0.9666666666666667
5927,25,0,1,454,455,0.002197802197802198,0.9978021978021978
5977,25,0,0,306,306,0.0,1.0
6198,25,0,0,5,5,0.0,1.0
5957,25,0,0,45,45,0.0,1.0
6057,25,0,0,29,29,0.0,1.0
6043,25,0,1,7,8,0.125,0.875
6077,25,0,0,4,4,0.0,1.0
6014,25,0,1,13,14,0.07142857142857142,0.9285714285714286
6015,25,0,1,2,3,0.3333333333333333,0.6666666666666666
5978,25,0,1,2,3,0.3333333333333333,0.6666666666666666
5986,25,0,0,50,50,0.0,1.0
5959,25,0,1,358,359,0.002785515320334262,0.9972144846796658
6051,25,0,0,38,38,0.0,1.0
6029,25,0,0,3,3,0.0,1.0
6070,25,0,0,1,1,0.0,1.0
5942,25,0,0,145,145,0.0,1.0
5953,25,0,0,4,4,0.0,1.0
6076,25,0,0,7,7,0.0,1.0
5940,25,0,3,7,10,0.3,0.7
6109,25,0,0,93,93,0.0,1.0
6187,25,0,0,3,3,0.0,1.0
6053,25,0,0,17,17,0.0,1.0
6104,25,0,0,9,9,0.0,1.0
5943,25,0,0,2,2,0.0,1.0
6017,25,0,3,0,3,1.0,0.0
6168,25,0,2,14,16,0.125,0.875
5989,25,0,0,6,6,0.0,1.0
5963,25,0,6,0,6,1.0,0.0
6194,25,0,0,26,26,0.0,1.0
6167,25,0,0,19,19,0.0,1.0
6004,25,0,0,64,64,0.0,1.0
6030,25,0,3,4,7,0.42857142857142855,0.5714285714285714
6054,25,0,2,4,6,0.3333333333333333,0.6666666666666666
6032,25,0,2,10,12,0.16666666666666666,0.8333333333333334
6170,25,0,1,63,64,0.015625,0.984375
6063,25,0,1,2,3,0.3333333333333333,0.6666666666666666
5988,25,0,1,0,1,1.0,0.0
6075,25,0,0,3,3,0.0,1.0
6061,25,0,0,67,67,0.0,1.0
5965,25,0,2,47,49,0.04081632653061224,0.9591836734693877
6040,25,0,2,8,10,0.2,0.8
6059,25,0,0,85,85,0.0,1.0
6106,25,0,0,63,63,0.0,1.0
6031,25,0,2,12,14,0.14285714285714285,0.8571428571428571
6180,25,0,0,6,6,0.0,1.0
6039,25,0,1,62,63,0.015873015873015872,0.9841269841269841
6189,26,0,0,18,18,0.0,1.0
5936,26,0,0,6,6,0.0,1.0
6087,26,0,2,9,11,0.18181818181818182,0.8181818181818182
5973,26,0,0,848,848,0.0,1.0
6085,26,0,0,12,12,0.0,1.0
6012,26,0,0,62,62,0.0,1.0
5982,26,0,1,5,6,0.16666666666666666,0.8333333333333334
5948,26,0,0,57,57,0.0,1.0
5974,26,0,0,6,6,0.0,1.0
6090,26,0,0,4,4,0.0,1.0
6068,26,0,1,2,3,0.3333333333333333,0.6666666666666666
5962,26,0,1,40,41,0.024390243902439025,0.975609756097561
6033,26,0,0,1,1,0.0,1.0
6038,26,0,2,0,2,1.0,0.0
6042,26,0,2,95,97,0.020618556701030927,0.979381443298969
5924,26,0,0,3,3,0.0,1.0
6083,26,0,0,27,27,0.0,1.0
6178,26,0,2,16,18,0.1111111111111111,0.8888888888888888
5958,26,0,1,3,4,0.25,0.75
6086,26,0,0,14,14,0.0,1.0
5945,26,0,1,18,19,0.05263157894736842,0.9473684210526315
5935,26,0,1,4,5,0.2,0.8
6073,26,0,1,14,15,0.06666666666666667,0.9333333333333333
5980,26,0,0,45,45,0.0,1.0
5993,26,0,0,483,483,0.0,1.0
6037,26,0,0,223,223,0.0,1.0
5979,26,0,2,3,5,0.4,0.6
5966,26,0,0,73,73,0.0,1.0
5985,26,0,0,3,3,0.0,1.0
5967,26,0,0,76,76,0.0,1.0
6188,26,0,0,22,22,0.0,1.0
6041,26,0,0,12,12,0.0,1.0
5972,26,0,2,11,13,0.15384615384615385,0.8461538461538461
6069,26,0,1,3,4,0.25,0.75
5937,26,0,1,0,1,1.0,0.0
6028,26,0,2,29,31,0.06451612903225806,0.9354838709677419
5990,26,0,0,130,130,0.0,1.0
5928,26,0,1,480,481,0.002079002079002079,0.997920997920998
5992,26,0,2,2,4,0.5,0.5
6058,26,0,2,11,13,0.15384615384615385,0.8461538461538461
6001,26,0,1,28,29,0.034482758620689655,0.9655172413793104
5964,26,0,3,28,31,0.0967741935483871,0.9032258064516129
5950,26,0,0,4,4,0.0,1.0
5991,26,0,0,8,8,0.0,1.0
6177,26,0,0,309,309,0.0,1.0
5961,26,0,0,321,321,0.0,1.0
6176,26,0,0,93,93,0.0,1.0
5956,26,0,0,31,31,0.0,1.0
5938,26,0,0,639,639,0.0,1.0
6179,26,0,1,27,28,0.03571428571428571,0.9642857142857143
5947,26,0,1,59,60,0.016666666666666666,0.9833333333333333
5927,26,0,0,455,455,0.0,1.0
5977,26,0,0,306,306,0.0,1.0
6198,26,0,0,5,5,0.0,1.0
5957,26,0,0,45,45,0.0,1.0
6057,26,0,0,29,29,0.0,1.0
6043,26,0,1,7,8,0.125,0.875
6077,26,0,0,4,4,0.0,1.0
6014,26,0,2,12,14,0.14285714285714285,0.8571428571428571
6015,26,0,0,3,3,0.0,1.0
5978,26,0,1,2,3,0.3333333333333333,0.6666666666666666
5986,26,0,1,49,50,0.02,0.98
5959,26,0,1,358,359,0.002785515320334262,0.9972144846796658
6051,26,0,0,38,38,0.0,1.0
6029,26,0,0,3,3,0.0,1.0
6070,26,0,0,1,1,0.0,1.0
5942,26,0,0,145,145,0.0,1.0
5953,26,0,1,3,4,0.25,0.75
6076,26,0,0,7,7,0.0,1.0
5940,26,0,2,8,10,0.2,0.8
6109,26,0,1,92,93,0.010752688172043012,0.989247311827957
6187,26,0,1,2,3,0.3333333333333333,0.6666666666666666
6053,26,0,0,17,17,0.0,1.0
6104,26,0,1,8,9,0.1111111111111111,0.8888888888888888
5943,26,0,0,2,2,0.0,1.0
6017,26,0,2,1,3,0.6666666666666666,0.3333333333333333
6168,26,0,0,16,16,0.0,1.0
5989,26,0,2,4,6,0.3333333333333333,0.6666666666666666
5963,26,0,6,0,6,1.0,0.0
6194,26,0,0,26,26,0.0,1.0
6167,26,0,0,19,19,0.0,1.0
6004,26,0,0,64,64,0.0,1.0
6030,26,0,3,4,7,0.42857142857142855,0.5714285714285714
6054,26,0,1,5,6,0.16666666666666666,0.8333333333333334
6032,26,0,6,6,12,0.5,0.5
6170,26,0,2,62,64,0.03125,0.96875
6063,26,0,1,2,3,0.3333333333333333,0.6666666666666666
5988,26,0,1,0,1,1.0,0.0
6075,26,0,0,3,3,0.0,1.0
6061,26,0,0,67,67,0.0,1.0
5965,26,0,0,49,49,0.0,1.0
6040,26,0,3,7,10,0.3,0.7
6059,26,0,0,85,85,0.0,1.0
6106,26,0,1,62,63,0.015873015873015872,0.9841269841269841
6031,26,0,2,12,14,0.14285714285714285,0.8571428571428571
6180,26,0,0,6,6,0.0,1.0
6039,26,0,3,60,63,0.047619047619047616,0.9523809523809523
6189,27,0,0,18,18,0.0,1.0
5936,27,0,0,6,6,0.0,1.0
6087,27,0,2,9,11,0.18181818181818182,0.8181818181818182
5973,27,0,0,848,848,0.0,1.0
6085,27,0,1,11,12,0.08333333333333333,0.9166666666666666
6012,27,0,0,62,62,0.0,1.0
5982,27,0,0,6,6,0.0,1.0
5948,27,0,0,57,57,0.0,1.0
5974,27,0,2,4,6,0.3333333333333333,0.6666666666666666
6090,27,0,0,4,4,0.0,1.0
6068,27,0,1,2,3,0.3333333333333333,0.6666666666666666
5962,27,0,1,40,41,0.024390243902439025,0.975609756097561
6033,27,0,0,1,1,0.0,1.0
6038,27,0,1,1,2,0.5,0.5
6042,27,0,0,97,97,0.0,1.0
5924,27,0,1,2,3,0.3333333333333333,0.6666666666666666
6083,27,0,0,27,27,0.0,1.0
6178,27,0,2,16,18,0.1111111111111111,0.8888888888888888
5958,27,0,2,2,4,0.5,0.5
6086,27,0,0,14,14,0.0,1.0
5945,27,0,0,19,19,0.0,1.0
5935,27,0,0,5,5,0.0,1.0
6073,27,0,1,14,15,0.06666666666666667,0.9333333333333333
5980,27,0,1,44,45,0.022222222222222223,0.9777777777777777
5993,27,0,0,483,483,0.0,1.0
6037,27,0,0,223,223,0.0,1.0
5979,27,0,2,3,5,0.4,0.6
5966,27,0,0,73,73,0.0,1.0
5985,27,0,0,3,3,0.0,1.0
5967,27,0,0,76,76,0.0,1.0
6188,27,0,1,21,22,0.045454545454545456,0.9545454545454546
6041,27,0,0,12,12,0.0,1.0
5972,27,0,1,12,13,0.07692307692307693,0.9230769230769231
6069,27,0,0,4,4,0.0,1.0
5937,27,0,1,0,1,1.0,0.0
6028,27,0,0,31,31,0.0,1.0
5990,27,0,0,130,130,0.0,1.0
5928,27,0,0,481,481,0.0,1.0
5992,27,0,3,1,4,0.75,0.25
6058,27,0,1,12,13,0.07692307692307693,0.9230769230769231
6001,27,0,2,27,29,0.06896551724137931,0.9310344827586207
5964,27,0,3,28,31,0.0967741935483871,0.9032258064516129
5950,27,0,0,4,4,0.0,1.0
5991,27,0,1,7,8,0.125,0.875
6177,27,0,0,309,309,0.0,1.0
5961,27,0,0,321,321,0.0,1.0
6176,27,0,0,93,93,0.0,1.0
5956,27,0,0,31,31,0.0,1.0
5938,27,0,0,639,639,0.0,1.0
6179,27,0,0,28,28,0.0,1.0
5947,27,0,0,60,60,0.0,1.0
5927,27,0,1,454,455,0.002197802197802198,0.9978021978021978
5977,27,0,0,306,306,0.0,1.0
6198,27,0,0,5,5,0.0,1.0
5957,27,0,0,45,45,0.0,1.0
6057,27,0,0,29,29,0.0,1.0
6043,27,0,3,5,8,0.375,0.625
6077,27,0,0,4,4,0.0,1.0
6014,27,0,3,11,14,0.21428571428571427,0.7857142857142857
6015,27,0,0,3,3,0.0,1.0
5978,27,0,1,2,3,0.3333333333333333,0.6666666666666666
5986,27,0,0,50,50,0.0,1.0
5959,27,0,1,358,359,0.002785515320334262,0.9972144846796658
6051,27,0,0,38,38,0.0,1.0
6029,27,0,0,3,3,0.0,1.0
6070,27,0,0,1,1,0.0,1.0
5942,27,0,0,145,145,0.0,1.0
5953,27,0,0,4,4,0.0,1.0
6076,27,0,0,7,7,0.0,1.0
5940,27,0,2,8,10,0.2,0.8
6109,27,0,1,92,93,0.010752688172043012,0.989247311827957
6187,27,0,1,2,3,0.3333333333333333,0.6666666666666666
6053,27,0,0,17,17,0.0,1.0
6104,27,0,0,9,9,0.0,1.0
5943,27,0,0,2,2,0.0,1.0
6017,27,0,1,2,3,0.3333333333333333,0.6666666666666666
6168,27,0,2,14,16,0.125,0.875
5989,27,0,0,6,6,0.0,1.0
5963,27,0,5,1,6,0.8333333333333334,0.16666666666666666
6194,27,0,0,26,26,0.0,1.0
6167,27,0,1,18,19,0.05263157894736842,0.9473684210526315
6004,27,0,0,64,64,0.0,1.0
6030,27,0,4,3,7,0.5714285714285714,0.42857142857142855
6054,27,0,1,5,6,0.16666666666666666,0.8333333333333334
6032,27,0,1,11,12,0.08333333333333333,0.9166666666666666
6170,27,0,0,64,64,0.0,1.0
6063,27,0,1,2,3,0.3333333333333333,0.6666666666666666
5988,27,0,1,0,1,1.0,0.0
6075,27,0,0,3,3,0.0,1.0
6061,27,0,0,67,67,0.0,1.0
5965,27,0,1,48,49,0.02040816326530612,0.9795918367346939
6040,27,0,2,8,10,0.2,0.8
6059,27,0,0,85,85,0.0,1.0
6106,27,0,0,63,63,0.0,1.0
6031,27,0,0,14,14,0.0,1.0
6180,27,0,0,6,6,0.0,1.0
6039,27,0,1,62,63,0.015873015873015872,0.9841269841269841
6189,28,0,0,18,18,0.0,1.0
5936,28,0,1,5,6,0.16666666666666666,0.8333333333333334
6087,28,0,1,10,11,0.09090909090909091,0.9090909090909091
5973,28,0,0,848,848,0.0,1.0
6085,28,0,2,10,12,0.16666666666666666,0.8333333333333334
6012,28,0,0,62,62,0.0,1.0
5982,28,0,1,5,6,0.16666666666666666,0.8333333333333334
5948,28,0,0,57,57,0.0,1.0
5974,28,0,1,5,6,0.16666666666666666,0.8333333333333334
6090,28,0,0,4,4,0.0,1.0
6068,28,0,2,1,3,0.6666666666666666,0.3333333333333333
5962,28,0,0,41,41,0.0,1.0
6033,28,0,0,1,1,0.0,1.0
6038,28,0,1,1,2,0.5,0.5
6042,28,0,3,94,97,0.030927835051546393,0.9690721649484536
5924,28,0,1,2,3,0.3333333333333333,0.6666666666666666
6083,28,0,0,27,27,0.0,1.0
6178,28,0,4,14,18,0.2222222222222222,0.7777777777777778
5958,28,0,1,3,4,0.25,0.75
6086,28,0,0,14,14,0.0,1.0
5945,28,0,0,19,19,0.0,1.0
5935,28,0,0,5,5,0.0,1.0
6073,28,0,1,14,15,0.06666666666666667,0.9333333333333333
5980,28,0,1,44,45,0.022222222222222223,0.9777777777777777
5993,28,0,1,482,483,0.002070393374741201,0.9979296066252588
6037,28,0,0,223,223,0.0,1.0
5979,28,0,2,3,5,0.4,0.6
5966,28,0,0,73,73,0.0,1.0
5985,28,0,0,3,3,0.0,1.0
5967,28,0,0,76,76,0.0,1.0
6188,28,0,1,21,22,0.045454545454545456,0.9545454545454546
6041,28,0,0,12,12,0.0,1.0
5972,28,0,1,12,13,0.07692307692307693,0.9230769230769231
6069,28,0,1,3,4,0.25,0.75
5937,28,0,1,0,1,1.0,0.0
6028,28,0,3,28,31,0.0967741935483871,0.9032258064516129
5990,28,0,0,130,130,0.0,1.0
5928,28,0,0,481,481,0.0,1.0
5992,28,0,2,2,4,0.5,0.5
6058,28,0,1,12,13,0.07692307692307693,0.9230769230769231
6001,28,0,1,28,29,0.034482758620689655,0.9655172413793104
5964,28,0,1,30,31,0.03225806451612903,0.967741935483871
5950,28,0,0,4,4,0.0,1.0
5991,28,0,0,8,8,0.0,1.0
6177,28,0,0,309,309,0.0,1.0
5961,28,0,0,321,321,0.0,1.0
6176,28,0,0,93,93,0.0,1.0
5956,28,0,0,31,31,0.0,1.0
5938,28,0,0,639,639,0.0,1.0
6179,28,0,0,28,28,0.0,1.0
5947,28,0,0,60,60,0.0,1.0
5927,28,0,1,454,455,0.002197802197802198,0.9978021978021978
5977,28,0,0,306,306,0.0,1.0
6198,28,0,0,5,5,0.0,1.0
5957,28,0,0,45,45,0.0,1.0
6057,28,0,0,29,29,0.0,1.0
6043,28,0,1,7,8,0.125,0.875
6077,28,0,0,4,4,0.0,1.0
6014,28,0,5,9,14,0.35714285714285715,0.6428571428571429
6015,28,0,0,3,3,0.0,1.0
5978,28,0,1,2,3,0.3333333333333333,0.6666666666666666
5986,28,0,0,50,50,0.0,1.0
5959,28,0,0,359,359,0.0,1.0
6051,28,0,0,38,38,0.0,1.0
6029,28,0,0,3,3,0.0,1.0
6070,28,0,0,1,1,0.0,1.0
5942,28,0,0,145,145,0.0,1.0
5953,28,0,0,4,4,0.0,1.0
6076,28,0,0,7,7,0.0,1.0
5940,28,0,0,10,10,0.0,1.0
6109,28,0,0,93,93,0.0,1.0
6187,28,0,0,3,3,0.0,1.0
6053,28,0,0,17,17,0.0,1.0
6104,28,0,0,9,9,0.0,1.0
5943,28,0,1,1,2,0.5,0.5
6017,28,0,3,0,3,1.0,0.0
6168,28,0,1,15,16,0.0625,0.9375
5989,28,0,0,6,6,0.0,1.0
5963,28,0,5,1,6,0.8333333333333334,0.16666666666666666
6194,28,0,0,26,26,0.0,1.0
6167,28,0,1,18,19,0.05263157894736842,0.9473684210526315
6004,28,0,0,64,64,0.0,1.0
6030,28,0,5,2,7,0.7142857142857143,0.2857142857142857
6054,28,0,0,6,6,0.0,1.0
6032,28,0,2,10,12,0.16666666666666666,0.8333333333333334
6170,28,0,2,62,64,0.03125,0.96875
6063,28,0,1,2,3,0.3333333333333333,0.6666666666666666
5988,28,0,1,0,1,1.0,0.0
6075,28,0,0,3,3,0.0,1.0
6061,28,0,0,67,67,0.0,1.0
5965,28,0,0,49,49,0.0,1.0
6040,28,0,0,10,10,0.0,1.0
6059,28,0,0,85,85,0.0,1.0
6106,28,0,1,62,63,0.015873015873015872,0.9841269841269841
6031,28,0,2,12,14,0.14285714285714285,0.8571428571428571
6180,28,0,0,6,6,0.0,1.0
6039,28,0,1,62,63,0.015873015873015872,0.9841269841269841
6189,29,0,0,18,18,0.0,1.0
5936,29,0,1,5,6,0.16666666666666666,0.8333333333333334
6087,29,0,0,11,11,0.0,1.0
5973,29,0,0,848,848,0.0,1.0
6085,29,0,5,7,12,0.4166666666666667,0.5833333333333334
6012,29,0,0,62,62,0.0,1.0
5982,29,0,0,6,6,0.0,1.0
5948,29,0,0,57,57,0.0,1.0
5974,29,0,1,5,6,0.16666666666666666,0.8333333333333334
6090,29,0,0,4,4,0.0,1.0
6068,29,0,1,2,3,0.3333333333333333,0.6666666666666666
5962,29,0,6,35,41,0.14634146341463414,0.8536585365853658
6033,29,0,0,1,1,0.0,1.0
6038,29,0,1,1,2,0.5,0.5
6042,29,0,0,97,97,0.0,1.0
5924,29,0,1,2,3,0.3333333333333333,0.6666666666666666
6083,29,0,0,27,27,0.0,1.0
6178,29,0,3,15,18,0.16666666666666666,0.8333333333333334
5958,29,0,1,3,4,0.25,0.75
6086,29,0,0,14,14,0.0,1.0
5945,29,0,1,18,19,0.05263157894736842,0.9473684210526315
5935,29,0,2,3,5,0.4,0.6
6073,29,0,0,15,15,0.0,1.0
5980,29,0,1,44,45,0.022222222222222223,0.9777777777777777
5993,29,0,1,482,483,0.002070393374741201,0.9979296066252588
6037,29,0,0,223,223,0.0,1.0
5979,29,0,3,2,5,0.6,0.4
5966,29,0,0,73,73,0.0,1.0
5985,29,0,0,3,3,0.0,1.0
5967,29,0,0,76,76,0.0,1.0
6188,29,0,1,21,22,0.045454545454545456,0.9545454545454546
6041,29,0,0,12,12,0.0,1.0
5972,29,0,1,12,13,0.07692307692307693,0.9230769230769231
6069,29,0,0,4,4,0.0,1.0
5937,29,0,1,0,1,1.0,0.0
6028,29,0,2,29,31,0.06451612903225806,0.9354838709677419
5990,29,0,0,130,130,0.0,1.0
5928,29,0,1,480,481,0.002079002079002079,0.997920997920998
5992,29,0,2,2,4,0.5,0.5
6058,29,0,1,12,13,0.07692307692307693,0.9230769230769231
6001,29,0,1,28,29,0.034482758620689655,0.9655172413793104
5964,29,0,0,31,31,0.0,1.0
5950,29,0,0,4,4,0.0,1.0
5991,29,0,0,8,8,0.0,1.0
6177,29,0,0,309,309,0.0,1.0
5961,29,0,0,321,321,0.0,1.0
6176,29,0,0,93,93,0.0,1.0
5956,29,0,0,31,31,0.0,1.0
5938,29,0,0,639,639,0.0,1.0
6179,29,0,0,28,28,0.0,1.0
5947,29,0,0,60,60,0.0,1.0
5927,29,0,0,455,455,0.0,1.0
5977,29,0,0,306,306,0.0,1.0
6198,29,0,0,5,5,0.0,1.0
5957,29,0,0,45,45,0.0,1.0
6057,29,0,0,29,29,0.0,1.0
6043,29,0,1,7,8,0.125,0.875
6077,29,0,0,4,4,0.0,1.0
6014,29,0,1,13,14,0.07142857142857142,0.9285714285714286
6015,29,0,0,3,3,0.0,1.0
5978,29,0,2,1,3,0.6666666666666666,0.3333333333333333
5986,29,0,1,49,50,0.02,0.98
5959,29,0,0,359,359,0.0,1.0
6051,29,0,0,38,38,0.0,1.0
6029,29,0,0,3,3,0.0,1.0
6070,29,0,0,1,1,0.0,1.0
5942,29,0,0,145,145,0.0,1.0
5953,29,0,0,4,4,0.0,1.0
6076,29,0,0,7,7,0.0,1.0
5940,29,0,0,10,10,0.0,1.0
6109,29,0,1,92,93,0.010752688172043012,0.989247311827957
6187,29,0,0,3,3,0.0,1.0
6053,29,0,0,17,17,0.0,1.0
6104,29,0,0,9,9,0.0,1.0
5943,29,0,1,1,2,0.5,0.5
6017,29,0,1,2,3,0.3333333333333333,0.6666666666666666
6168,29,0,1,15,16,0.0625,0.9375
5989,29,0,0,6,6,0.0,1.0
5963,29,0,6,0,6,1.0,0.0
6194,29,0,0,26,26,0.0,1.0
6167,29,0,1,18,19,0.05263157894736842,0.9473684210526315
6004,29,0,1,63,64,0.015625,0.984375
6030,29,0,5,2,7,0.7142857142857143,0.2857142857142857
6054,29,0,1,5,6,0.16666666666666666,0.8333333333333334
6032,29,0,3,9,12,0.25,0.75
6170,29,0,2,62,64,0.03125,0.96875
6063,29,0,2,1,3,0.6666666666666666,0.3333333333333333
5988,29,0,1,0,1,1.0,0.0
6075,29,0,0,3,3,0.0,1.0
6061,29,0,0,67,67,0.0,1.0
5965,29,0,1,48,49,0.02040816326530612,0.9795918367346939
6040,29,0,3,7,10,0.3,0.7
6059,29,0,0,85,85,0.0,1.0
6106,29,0,0,63,63,0.0,1.0
6031,29,0,3,11,14,0.21428571428571427,0.7857142857142857
6180,29,0,0,6,6,0.0,1.0
6039,29,0,3,60,63,0.047619047619047616,0.9523809523809523
6189,0,1,0,18,18,0.0,1.0
5936,0,1,6,0,6,1.0,0.0
6087,0,1,2,9,11,0.18181818181818182,0.8181818181818182
5973,0,1,6,842,848,0.007075471698113208,0.9929245283018868
6085,0,1,12,0,12,1.0,0.0
6012,0,1,0,62,62,0.0,1.0
5982,0,1,0,6,6,0.0,1.0
5948,0,1,0,57,57,0.0,1.0
5974,0,1,6,0,6,1.0,0.0
6090,0,1,0,4,4,0.0,1.0
6068,0,1,3,0,3,1.0,0.0
5962,0,1,37,4,41,0.9024390243902439,0.0975609756097561
6033,0,1,1,0,1,1.0,0.0
6038,0,1,2,0,2,1.0,0.0
6042,0,1,86,11,97,0.8865979381443299,0.1134020618556701
5924,0,1,3,0,3,1.0,0.0
6083,0,1,0,27,27,0.0,1.0
6178,0,1,18,0,18,1.0,0.0
5958,0,1,4,0,4,1.0,0.0
6086,0,1,0,14,14,0.0,1.0
5945,0,1,18,1,19,0.9473684210526315,0.05263157894736842
5935,0,1,5,0,5,1.0,0.0
6073,0,1,15,0,15,1.0,0.0
5980,0,1,45,0,45,1.0,0.0
5993,0,1,173,310,483,0.3581780538302277,0.6418219461697723
6037,0,1,167,56,223,0.7488789237668162,0.25112107623318386
5979,0,1,5,0,5,1.0,0.0
5966,0,1,0,73,73,0.0,1.0
5985,0,1,3,0,3,1.0,0.0
5967,0,1,0,76,76,0.0,1.0
6188,0,1,22,0,22,1.0,0.0
6041,0,1,0,12,12,0.0,1.0
5972,0,1,13,0,13,1.0,0.0
6069,0,1,1,3,4,0.25,0.75
5937,0,1,1,0,1,1.0,0.0
6028,0,1,31,0,31,1.0,0.0
5990,0,1,0,130,130,0.0,1.0
5928,0,1,243,238,481,0.5051975051975052,0.49480249480249483
5992,0,1,4,0,4,1.0,0.0
6058,0,1,13,0,13,1.0,0.0
6001,0,1,29,0,29,1.0,0.0
5964,0,1,31,0,31,1.0,0.0
5950,0,1,4,0,4,1.0,0.0
5991,0,1,8,0,8,1.0,0.0
6177,0,1,248,61,309,0.8025889967637541,0.19741100323624594
5961,0,1,0,321,321,0.0,1.0
6176,0,1,0,93,93,0.0,1.0
5956,0,1,0,31,31,0.0,1.0
5938,0,1,79,560,639,0.12363067292644757,0.8763693270735524
6179,0,1,28,0,28,1.0,0.0
5947,0,1,56,4,60,0.9333333333333333,0.06666666666666667
5927,0,1,12,443,455,0.026373626373626374,0.9736263736263736
5977,0,1,5,301,306,0.016339869281045753,0.9836601307189542
6198,0,1,0,5,5,0.0,1.0
5957,0,1,0,45,45,0.0,1.0
6057,0,1,29,0,29,1.0,0.0
6043,0,1,8,0,8,1.0,0.0
6077,0,1,0,4,4,0.0,1.0
6014,0,1,14,0,14,1.0,0.0
6015,0,1,3,0,3,1.0,0.0
5978,0,1,3,0,3,1.0,0.0
5986,0,1,16,34,50,0.32,0.68
5959,0,1,262,97,359,0.7298050139275766,0.27019498607242337
6051,0,1,30,8,38,0.7894736842105263,0.21052631578947367
6029,0,1,3,0,3,1.0,0.0
6070,0,1,1,0,1,1.0,0.0
5942,0,1,0,145,145,0.0,1.0
5953,0,1,4,0,4,1.0,0.0
6076,0,1,7,0,7,1.0,0.0
5940,0,1,10,0,10,1.0,0.0
6109,0,1,81,12,93,0.8709677419354839,0.12903225806451613
6187,0,1,3,0,3,1.0,0.0
6053,0,1,0,17,17,0.0,1.0
6104,0,1,9,0,9,1.0,0.0
5943,0,1,2,0,2,1.0,0.0
6017,0,1,3,0,3,1.0,0.0
6168,0,1,13,3,16,0.8125,0.1875
5989,0,1,6,0,6,1.0,0.0
5963,0,1,6,0,6,1.0,0.0
6194,0,1,0,26,26,0.0,1.0
6167,0,1,19,0,19,1.0,0.0
6004,0,1,0,64,64,0.0,1.0
6030,0,1,7,0,7,1.0,0.0
6054,0,1,6,0,6,1.0,0.0
6032,0,1,12,0,12,1.0,0.0
6170,0,1,59,5,64,0.921875,0.078125
6063,0,1,3,0,3,1.0,0.0
5988,0,1,1,0,1,1.0,0.0
6075,0,1,3,0,3,1.0,0.0
6061,0,1,0,67,67,0.0,1.0
5965,0,1,47,2,49,0.9591836734693877,0.04081632653061224
6040,0,1,10,0,10,1.0,0.0
6059,0,1,0,85,85,0.0,1.0
6106,0,1,60,3,63,0.9523809523809523,0.047619047619047616
6031,0,1,6,8,14,0.42857142857142855,0.5714285714285714
6180,0,1,0,6,6,0.0,1.0
6039,0,1,28,35,63,0.4444444444444444,0.5555555555555556
6189,1,1,0,18,18,0.0,1.0
5936,1,1,6,0,6,1.0,0.0
6087,1,1,0,11,11,0.0,1.0
5973,1,1,5,843,848,0.00589622641509434,0.9941037735849056
6085,1,1,12,0,12,1.0,0.0
6012,1,1,0,62,62,0.0,1.0
5982,1,1,0,6,6,0.0,1.0
5948,1,1,0,57,57,0.0,1.0
5974,1,1,6,0,6,1.0,0.0
6090,1,1,0,4,4,0.0,1.0
6068,1,1,3,0,3,1.0,0.0
5962,1,1,35,6,41,0.8536585365853658,0.14634146341463414
6033,1,1,1,0,1,1.0,0.0
6038,1,1,2,0,2,1.0,0.0
6042,1,1,71,26,97,0.7319587628865979,0.26804123711340205
5924,1,1,3,0,3,1.0,0.0
6083,1,1,0,27,27,0.0,1.0
6178,1,1,17,1,18,0.9444444444444444,0.05555555555555555
5958,1,1,4,0,4,1.0,0.0
6086,1,1,0,14,14,0.0,1.0
5945,1,1,18,1,19,0.9473684210526315,0.05263157894736842
5935,1,1,5,0,5,1.0,0.0
6073,1,1,13,2,15,0.8666666666666667,0.13333333333333333
5980,1,1,44,1,45,0.9777777777777777,0.022222222222222223
5993,1,1,99,384,483,0.20496894409937888,0.7950310559006211
6037,1,1,101,122,223,0.452914798206278,0.547085201793722
5979,1,1,5,0,5,1.0,0.0
5966,1,1,0,73,73,0.0,1.0
5985,1,1,3,0,3,1.0,0.0
5967,1,1,0,76,76,0.0,1.0
6188,1,1,20,2,22,0.9090909090909091,0.09090909090909091
6041,1,1,0,12,12,0.0,1.0
5972,1,1,13,0,13,1.0,0.0
6069,1,1,0,4,4,0.0,1.0
5937,1,1,1,0,1,1.0,0.0
6028,1,1,27,4,31,0.8709677419354839,0.12903225806451613
5990,1,1,0,130,130,0.0,1.0
5928,1,1,145,336,481,0.30145530145530147,0.6985446985446986
5992,1,1,4,0,4,1.0,0.0
6058,1,1,13,0,13,1.0,0.0
6001,1,1,26,3,29,0.896551724137931,0.10344827586206896
5964,1,1,29,2,31,0.9354838709677419,0.06451612903225806
5950,1,1,3,1,4,0.75,0.25
5991,1,1,8,0,8,1.0,0.0
6177,1,1,180,129,309,0.5825242718446602,0.4174757281553398
5961,1,1,0,321,321,0.0,1.0
6176,1,1,0,93,93,0.0,1.0
5956,1,1,0,31,31,0.0,1.0
5938,1,1,50,589,639,0.0782472613458529,0.9217527386541471
6179,1,1,28,0,28,1.0,0.0
5947,1,1,53,7,60,0.8833333333333333,0.11666666666666667
5927,1,1,13,442,455,0.02857142857142857,0.9714285714285714
5977,1,1,5,301,306,0.016339869281045753,0.9836601307189542
6198,1,1,0,5,5,0.0,1.0
5957,1,1,0,45,45,0.0,1.0
6057,1,1,25,4,29,0.8620689655172413,0.13793103448275862
6043,1,1,8,0,8,1.0,0.0
6077,1,1,0,4,4,0.0,1.0
6014,1,1,13,1,14,0.9285714285714286,0.07142857142857142
6015,1,1,3,0,3,1.0,0.0
5978,1,1,3,0,3,1.0,0.0
5986,1,1,12,38,50,0.24,0.76
5959,1,1,180,179,359,0.5013927576601671,0.4986072423398329
6051,1,1,35,3,38,0.9210526315789473,0.07894736842105263
6029,1,1,3,0,3,1.0,0.0
6070,1,1,1,0,1,1.0,0.0
5942,1,1,0,145,145,0.0,1.0
5953,1,1,4,0,4,1.0,0.0
6076,1,1,7,0,7,1.0,0.0
5940,1,1,10,0,10,1.0,0.0
6109,1,1,64,29,93,0.6881720430107527,0.3118279569892473
6187,1,1,3,0,3,1.0,0.0
6053,1,1,0,17,17,0.0,1.0
6104,1,1,9,0,9,1.0,0.0
5943,1,1,2,0,2,1.0,0.0
6017,1,1,3,0,3,1.0,0.0
6168,1,1,13,3,16,0.8125,0.1875
5989,1,1,6,0,6,1.0,0.0
5963,1,1,6,0,6,1.0,0.0
6194,1,1,0,26,26,0.0,1.0
6167,1,1,18,1,19,0.9473684210526315,0.05263157894736842
6004,1,1,1,63,64,0.015625,0.984375
6030,1,1,7,0,7,1.0,0.0
6054,1,1,6,0,6,1.0,0.0
6032,1,1,12,0,12,1.0,0.0
6170,1,1,55,9,64,0.859375,0.140625
6063,1,1,3,0,3,1.0,0.0
5988,1,1,1,0,1,1.0,0.0
6075,1,1,3,0,3,1.0,0.0
6061,1,1,0,67,67,0.0,1.0
5965,1,1,44,5,49,0.8979591836734694,0.10204081632653061
6040,1,1,9,1,10,0.9,0.1
6059,1,1,0,85,85,0.0,1.0
6106,1,1,52,11,63,0.8253968253968254,0.1746031746031746
6031,1,1,4,10,14,0.2857142857142857,0.7142857142857143
6180,1,1,0,6,6,0.0,1.0
6039,1,1,20,43,63,0.31746031746031744,0.6825396825396826
6189,2,1,0,18,18,0.0,1.0
5936,2,1,6,0,6,1.0,0.0
6087,2,1,3,8,11,0.2727272727272727,0.7272727272727273
5973,2,1,1,847,848,0.0011792452830188679,0.9988207547169812
6085,2,1,12,0,12,1.0,0.0
6012,2,1,0,62,62,0.0,1.0
5982,2,1,1,5,6,0.16666666666666666,0.8333333333333334
5948,2,1,0,57,57,0.0,1.0
5974,2,1,5,1,6,0.8333333333333334,0.16666666666666666
6090,2,1,0,4,4,0.0,1.0
6068,2,1,3,0,3,1.0,0.0
5962,2,1,29,12,41,0.7073170731707317,0.2926829268292683
6033,2,1,0,1,1,0.0,1.0
6038,2,1,2,0,2,1.0,0.0
6042,2,1,52,45,97,0.5360824742268041,0.4639175257731959
5924,2,1,3,0,3,1.0,0.0
6083,2,1,0,27,27,0.0,1.0
6178,2,1,17,1,18,0.9444444444444444,0.05555555555555555
5958,2,1,4,0,4,1.0,0.0
6086,2,1,0,14,14,0.0,1.0
5945,2,1,14,5,19,0.7368421052631579,0.2631578947368421
5935,2,1,5,0,5,1.0,0.0
6073,2,1,10,5,15,0.6666666666666666,0.3333333333333333
5980,2,1,42,3,45,0.9333333333333333,0.06666666666666667
5993,2,1,48,435,483,0.09937888198757763,0.9006211180124224
6037,2,1,39,184,223,0.17488789237668162,0.8251121076233184
5979,2,1,5,0,5,1.0,0.0
5966,2,1,0,73,73,0.0,1.0
5985,2,1,3,0,3,1.0,0.0
5967,2,1,0,76,76,0.0,1.0
6188,2,1,20,2,22,0.9090909090909091,0.09090909090909091
6041,2,1,0,12,12,0.0,1.0
5972,2,1,13,0,13,1.0,0.0
6069,2,1,1,3,4,0.25,0.75
5937,2,1,1,0,1,1.0,0.0
6028,2,1,19,12,31,0.6129032258064516,0.3870967741935484
5990,2,1,0,130,130,0.0,1.0
5928,2,1,53,428,481,0.1101871101871102,0.8898128898128899
5992,2,1,4,0,4,1.0,0.0
6058,2,1,12,1,13,0.9230769230769231,0.07692307692307693
6001,2,1,22,7,29,0.7586206896551724,0.2413793103448276
5964,2,1,28,3,31,0.9032258064516129,0.0967741935483871
5950,2,1,4,0,4,1.0,0.0
5991,2,1,7,1,8,0.875,0.125
6177,2,1,59,250,309,0.19093851132686085,0.8090614886731392
5961,2,1,0,321,321,0.0,1.0
6176,2,1,0,93,93,0.0,1.0
5956,2,1,0,31,31,0.0,1.0
5938,2,1,29,610,639,0.04538341158059468,0.9546165884194053
6179,2,1,20,8,28,0.7142857142857143,0.2857142857142857
5947,2,1,44,16,60,0.7333333333333333,0.26666666666666666
5927,2,1,5,450,455,0.01098901098901099,0.989010989010989
5977,2,1,3,303,306,0.00980392156862745,0.9901960784313726
6198,2,1,0,5,5,0.0,1.0
5957,2,1,0,45,45,0.0,1.0
6057,2,1,19,10,29,0.6551724137931034,0.3448275862068966
6043,2,1,8,0,8,1.0,0.0
6077,2,1,0,4,4,0.0,1.0
6014,2,1,12,2,14,0.8571428571428571,0.14285714285714285
6015,2,1,3,0,3,1.0,0.0
5978,2,1,2,1,3,0.6666666666666666,0.3333333333333333
5986,2,1,8,42,50,0.16,0.84
5959,2,1,97,262,359,0.27019498607242337,0.7298050139275766
6051,2,1,31,7,38,0.8157894736842105,0.18421052631578946
6029,2,1,2,1,3,0.6666666666666666,0.3333333333333333
6070,2,1,1,0,1,1.0,0.0
5942,2,1,0,145,145,0.0,1.0
5953,2,1,4,0,4,1.0,0.0
6076,2,1,7,0,7,1.0,0.0
5940,2,1,9,1,10,0.9,0.1
6109,2,1,28,65,93,0.3010752688172043,0.6989247311827957
6187,2,1,2,1,3,0.6666666666666666,0.3333333333333333
6053,2,1,0,17,17,0.0,1.0
6104,2,1,9,0,9,1.0,0.0
5943,2,1,2,0,2,1.0,0.0
6017,2,1,2,1,3,0.6666666666666666,0.3333333333333333
6168,2,1,12,4,16,0.75,0.25
5989,2,1,5,1,6,0.8333333333333334,0.16666666666666666
5963,2,1,6,0,6,1.0,0.0
6194,2,1,0,26,26,0.0,1.0
6167,2,1,19,0,19,1.0,0.0
6004,2,1,0,64,64,0.0,1.0
6030,2,1,7,0,7,1.0,0.0
6054,2,1,6,0,6,1.0,0.0
6032,2,1,12,0,12,1.0,0.0
6170,2,1,41,23,64,0.640625,0.359375
6063,2,1,3,0,3,1.0,0.0
5988,2,1,1,0,1,1.0,0.0
6075,2,1,3,0,3,1.0,0.0
6061,2,1,0,67,67,0.0,1.0
5965,2,1,27,22,49,0.5510204081632653,0.4489795918367347
6040,2,1,10,0,10,1.0,0.0
6059,2,1,0,85,85,0.0,1.0
6106,2,1,32,31,63,0.5079365079365079,0.49206349206349204
6031,2,1,5,9,14,0.35714285714285715,0.6428571428571429
6180,2,1,0,6,6,0.0,1.0
6039,2,1,24,39,63,0.38095238095238093,0.6190476190476191
6189,3,1,0,18,18,0.0,1.0
5936,3,1,6,0,6,1.0,0.0
6087,3,1,1,10,11,0.09090909090909091,0.9090909090909091
5973,3,1,2,846,848,0.0023584905660377358,0.9976415094339622
6085,3,1,11,1,12,0.9166666666666666,0.08333333333333333
6012,3,1,0,62,62,0.0,1.0
5982,3,1,0,6,6,0.0,1.0
5948,3,1,0,57,57,0.0,1.0
5974,3,1,3,3,6,0.5,0.5
6090,3,1,0,4,4,0.0,1.0
6068,3,1,3,0,3,1.0,0.0
5962,3,1,19,22,41,0.4634146341463415,0.5365853658536586
6033,3,1,0,1,1,0.0,1.0
6038,3,1,2,0,2,1.0,0.0
6042,3,1,33,64,97,0.3402061855670103,0.6597938144329897
5924,3,1,1,2,3,0.3333333333333333,0.6666666666666666
6083,3,1,0,27,27,0.0,1.0
6178,3,1,16,2,18,0.8888888888888888,0.1111111111111111
5958,3,1,3,1,4,0.75,0.25
6086,3,1,0,14,14,0.0,1.0
5945,3,1,10,9,19,0.5263157894736842,0.47368421052631576
5935,3,1,4,1,5,0.8,0.2
6073,3,1,14,1,15,0.9333333333333333,0.06666666666666667
5980,3,1,36,9,45,0.8,0.2
5993,3,1,33,450,483,0.06832298136645963,0.9316770186335404
6037,3,1,21,202,223,0.09417040358744394,0.905829596412556
5979,3,1,5,0,5,1.0,0.0
5966,3,1,0,73,73,0.0,1.0
5985,3,1,3,0,3,1.0,0.0
5967,3,1,0,76,76,0.0,1.0
6188,3,1,17,5,22,0.7727272727272727,0.22727272727272727
6041,3,1,0,12,12,0.0,1.0
5972,3,1,12,1,13,0.9230769230769231,0.07692307692307693
6069,3,1,1,3,4,0.25,0.75
5937,3,1,1,0,1,1.0,0.0
6028,3,1,15,16,31,0.4838709677419355,0.5161290322580645
5990,3,1,0,130,130,0.0,1.0
5928,3,1,43,438,481,0.0893970893970894,0.9106029106029107
5992,3,1,4,0,4,1.0,0.0
6058,3,1,12,1,13,0.9230769230769231,0.07692307692307693
6001,3,1,19,10,29,0.6551724137931034,0.3448275862068966
5964,3,1,23,8,31,0.7419354838709677,0.25806451612903225
5950,3,1,4,0,4,1.0,0.0
5991,3,1,4,4,8,0.5,0.5
6177,3,1,40,269,309,0.12944983818770225,0.8705501618122977
5961,3,1,0,321,321,0.0,1.0
6176,3,1,0,93,93,0.0,1.0
5956,3,1,0,31,31,0.0,1.0
5938,3,1,12,627,639,0.018779342723004695,0.9812206572769953
6179,3,1,13,15,28,0.4642857142857143,0.5357142857142857
5947,3,1,31,29,60,0.5166666666666667,0.48333333333333334
5927,3,1,2,453,455,0.004395604395604396,0.9956043956043956
5977,3,1,2,304,306,0.006535947712418301,0.9934640522875817
6198,3,1,0,5,5,0.0,1.0
5957,3,1,0,45,45,0.0,1.0
6057,3,1,15,14,29,0.5172413793103449,0.4827586206896552
6043,3,1,8,0,8,1.0,0.0
6077,3,1,0,4,4,0.0,1.0
6014,3,1,11,3,14,0.7857142857142857,0.21428571428571427
6015,3,1,3,0,3,1.0,0.0
5978,3,1,2,1,3,0.6666666666666666,0.3333333333333333
5986,3,1,5,45,50,0.1,0.9
5959,3,1,44,315,359,0.12256267409470752,0.8774373259052924
6051,3,1,26,12,38,0.6842105263157895,0.3157894736842105
6029,3,1,2,1,3,0.6666666666666666,0.3333333333333333
6070,3,1,1,0,1,1.0,0.0
5942,3,1,0,145,145,0.0,1.0
5953,3,1,4,0,4,1.0,0.0
6076,3,1,6,1,7,0.8571428571428571,0.14285714285714285
5940,3,1,8,2,10,0.8,0.2
6109,3,1,31,62,93,0.3333333333333333,0.6666666666666666
6187,3,1,2,1,3,0.6666666666666666,0.3333333333333333
6053,3,1,0,17,17,0.0,1.0
6104,3,1,9,0,9,1.0,0.0
5943,3,1,2,0,2,1.0,0.0
6017,3,1,3,0,3,1.0,0.0
6168,3,1,11,5,16,0.6875,0.3125
5989,3,1,5,1,6,0.8333333333333334,0.16666666666666666
5963,3,1,6,0,6,1.0,0.0
6194,3,1,0,26,26,0.0,1.0
6167,3,1,18,1,19,0.9473684210526315,0.05263157894736842
6004,3,1,1,63,64,0.015625,0.984375
6030,3,1,6,1,7,0.8571428571428571,0.14285714285714285
6054,3,1,5,1,6,0.8333333333333334,0.16666666666666666
6032,3,1,11,1,12,0.9166666666666666,0.08333333333333333
6170,3,1,25,39,64,0.390625,0.609375
6063,3,1,3,0,3,1.0,0.0
5988,3,1,1,0,1,1.0,0.0
6075,3,1,3,0,3,1.0,0.0
6061,3,1,0,67,67,0.0,1.0
5965,3,1,21,28,49,0.42857142857142855,0.5714285714285714
6040,3,1,9,1,10,0.9,0.1
6059,3,1,0,85,85,0.0,1.0
6106,3,1,27,36,63,0.42857142857142855,0.5714285714285714
6031,3,1,7,7,14,0.5,0.5
6180,3,1,0,6,6,0.0,1.0
6039,3,1,23,40,63,0.36507936507936506,0.6349206349206349
6189,4,1,0,18,18,0.0,1.0
5936,4,1,6,0,6,1.0,0.0
6087,4,1,2,9,11,0.18181818181818182,0.8181818181818182
5973,4,1,0,848,848,0.0,1.0
6085,4,1,10,2,12,0.8333333333333334,0.16666666666666666
6012,4,1,0,62,62,0.0,1.0
5982,4,1,0,6,6,0.0,1.0
5948,4,1,0,57,57,0.0,1.0
5974,4,1,2,4,6,0.3333333333333333,0.6666666666666666
6090,4,1,0,4,4,0.0,1.0
6068,4,1,3,0,3,1.0,0.0
5962,4,1,19,22,41,0.4634146341463415,0.5365853658536586
6033,4,1,0,1,1,0.0,1.0
6038,4,1,2,0,2,1.0,0.0
6042,4,1,24,73,97,0.24742268041237114,0.7525773195876289
5924,4,1,1,2,3,0.3333333333333333,0.6666666666666666
6083,4,1,0,27,27,0.0,1.0
6178,4,1,13,5,18,0.7222222222222222,0.2777777777777778
5958,4,1,3,1,4,0.75,0.25
6086,4,1,0,14,14,0.0,1.0
5945,4,1,6,13,19,0.3157894736842105,0.6842105263157895
5935,4,1,5,0,5,1.0,0.0
6073,4,1,10,5,15,0.6666666666666666,0.3333333333333333
5980,4,1,29,16,45,0.6444444444444445,0.35555555555555557
5993,4,1,16,467,483,0.033126293995859216,0.9668737060041408
6037,4,1,12,211,223,0.053811659192825115,0.9461883408071748
5979,4,1,5,0,5,1.0,0.0
5966,4,1,0,73,73,0.0,1.0
5985,4,1,3,0,3,1.0,0.0
5967,4,1,0,76,76,0.0,1.0
6188,4,1,13,9,22,0.5909090909090909,0.4090909090909091
6041,4,1,0,12,12,0.0,1.0
5972,4,1,12,1,13,0.9230769230769231,0.07692307692307693
6069,4,1,1,3,4,0.25,0.75
5937,4,1,1,0,1,1.0,0.0
6028,4,1,16,15,31,0.5161290322580645,0.4838709677419355
5990,4,1,0,130,130,0.0,1.0
5928,4,1,21,460,481,0.04365904365904366,0.9563409563409564
5992,4,1,4,0,4,1.0,0.0
6058,4,1,11,2,13,0.8461538461538461,0.15384615384615385
6001,4,1,17,12,29,0.5862068965517241,0.41379310344827586
5964,4,1,19,12,31,0.6129032258064516,0.3870967741935484
5950,4,1,3,1,4,0.75,0.25
5991,4,1,5,3,8,0.625,0.375
6177,4,1,29,280,309,0.09385113268608414,0.9061488673139159
5961,4,1,0,321,321,0.0,1.0
6176,4,1,0,93,93,0.0,1.0
5956,4,1,0,31,31,0.0,1.0
5938,4,1,10,629,639,0.01564945226917058,0.9843505477308294
6179,4,1,12,16,28,0.42857142857142855,0.5714285714285714
5947,4,1,29,31,60,0.48333333333333334,0.5166666666666667
5927,4,1,2,453,455,0.004395604395604396,0.9956043956043956
5977,4,1,1,305,306,0.0032679738562091504,0.9967320261437909
6198,4,1,0,5,5,0.0,1.0
5957,4,1,0,45,45,0.0,1.0
6057,4,1,10,19,29,0.3448275862068966,0.6551724137931034
6043,4,1,8,0,8,1.0,0.0
6077,4,1,0,4,4,0.0,1.0
6014,4,1,11,3,14,0.7857142857142857,0.21428571428571427
6015,4,1,2,1,3,0.6666666666666666,0.3333333333333333
5978,4,1,3,0,3,1.0,0.0
5986,4,1,7,43,50,0.14,0.86
5959,4,1,31,328,359,0.08635097493036212,0.9136490250696379
6051,4,1,23,15,38,0.6052631578947368,0.39473684210526316
6029,4,1,1,2,3,0.3333333333333333,0.6666666666666666
6070,4,1,1,0,1,1.0,0.0
5942,4,1,0,145,145,0.0,1.0
5953,4,1,4,0,4,1.0,0.0
6076,4,1,5,2,7,0.7142857142857143,0.2857142857142857
5940,4,1,6,4,10,0.6,0.4
6109,4,1,17,76,93,0.1827956989247312,0.8172043010752689
6187,4,1,3,0,3,1.0,0.0
6053,4,1,0,17,17,0.0,1.0
6104,4,1,8,1,9,0.8888888888888888,0.1111111111111111
5943,4,1,2,0,2,1.0,0.0
6017,4,1,3,0,3,1.0,0.0
6168,4,1,9,7,16,0.5625,0.4375
5989,4,1,6,0,6,1.0,0.0
5963,4,1,6,0,6,1.0,0.0
6194,4,1,0,26,26,0.0,1.0
6167,4,1,13,6,19,0.6842105263157895,0.3157894736842105
6004,4,1,1,63,64,0.015625,0.984375
6030,4,1,6,1,7,0.8571428571428571,0.14285714285714285
6054,4,1,5,1,6,0.8333333333333334,0.16666666666666666
6032,4,1,9,3,12,0.75,0.25
6170,4,1,23,41,64,0.359375,0.640625
6063,4,1,3,0,3,1.0,0.0
5988,4,1,1,0,1,1.0,0.0
6075,4,1,3,0,3,1.0,0.0
6061,4,1,0,67,67,0.0,1.0
5965,4,1,18,31,49,0.3673469387755102,0.6326530612244898
6040,4,1,10,0,10,1.0,0.0
6059,4,1,0,85,85,0.0,1.0
6106,4,1,14,49,63,0.2222222222222222,0.7777777777777778
6031,4,1,5,9,14,0.35714285714285715,0.6428571428571429
6180,4,1,0,6,6,0.0,1.0
6039,4,1,15,48,63,0.23809523809523808,0.7619047619047619
6189,5,1,0,18,18,0.0,1.0
5936,5,1,5,1,6,0.8333333333333334,0.16666666666666666
6087,5,1,1,10,11,0.09090909090909091,0.9090909090909091
5973,5,1,0,848,848,0.0,1.0
6085,5,1,10,2,12,0.8333333333333334,0.16666666666666666
6012,5,1,0,62,62,0.0,1.0
5982,5,1,1,5,6,0.16666666666666666,0.8333333333333334
5948,5,1,0,57,57,0.0,1.0
5974,5,1,3,3,6,0.5,0.5
6090,5,1,0,4,4,0.0,1.0
6068,5,1,3,0,3,1.0,0.0
5962,5,1,10,31,41,0.24390243902439024,0.7560975609756098
6033,5,1,0,1,1,0.0,1.0
6038,5,1,2,0,2,1.0,0.0
6042,5,1,21,76,97,0.21649484536082475,0.7835051546391752
5924,5,1,1,2,3,0.3333333333333333,0.6666666666666666
6083,5,1,0,27,27,0.0,1.0
6178,5,1,14,4,18,0.7777777777777778,0.2222222222222222
5958,5,1,3,1,4,0.75,0.25
6086,5,1,0,14,14,0.0,1.0
5945,5,1,5,14,19,0.2631578947368421,0.7368421052631579
5935,5,1,4,1,5,0.8,0.2
6073,5,1,10,5,15,0.6666666666666666,0.3333333333333333
5980,5,1,24,21,45,0.5333333333333333,0.4666666666666667
5993,5,1,21,462,483,0.043478260869565216,0.9565217391304348
6037,5,1,16,207,223,0.07174887892376682,0.9282511210762332
5979,5,1,5,0,5,1.0,0.0
5966,5,1,0,73,73,0.0,1.0
5985,5,1,3,0,3,1.0,0.0
5967,5,1,0,76,76,0.0,1.0
6188,5,1,9,13,22,0.4090909090909091,0.5909090909090909
6041,5,1,0,12,12,0.0,1.0
5972,5,1,11,2,13,0.8461538461538461,0.15384615384615385
6069,5,1,1,3,4,0.25,0.75
5937,5,1,1,0,1,1.0,0.0
6028,5,1,12,19,31,0.3870967741935484,0.6129032258064516
5990,5,1,0,130,130,0.0,1.0
5928,5,1,15,466,481,0.031185031185031187,0.9688149688149689
5992,5,1,4,0,4,1.0,0.0
6058,5,1,12,1,13,0.9230769230769231,0.07692307692307693
6001,5,1,12,17,29,0.41379310344827586,0.5862068965517241
5964,5,1,15,16,31,0.4838709677419355,0.5161290322580645
5950,5,1,2,2,4,0.5,0.5
5991,5,1,6,2,8,0.75,0.25
6177,5,1,20,289,309,0.06472491909385113,0.9352750809061489
5961,5,1,0,321,321,0.0,1.0
6176,5,1,0,93,93,0.0,1.0
5956,5,1,0,31,31,0.0,1.0
5938,5,1,10,629,639,0.01564945226917058,0.9843505477308294
6179,5,1,7,21,28,0.25,0.75
5947,5,1,22,38,60,0.36666666666666664,0.6333333333333333
5927,5,1,1,454,455,0.002197802197802198,0.9978021978021978
5977,5,1,3,303,306,0.00980392156862745,0.9901960784313726
6198,5,1,0,5,5,0.0,1.0
5957,5,1,0,45,45,0.0,1.0
6057,5,1,11,18,29,0.3793103448275862,0.6206896551724138
6043,5,1,8,0,8,1.0,0.0
6077,5,1,0,4,4,0.0,1.0
6014,5,1,7,7,14,0.5,0.5
6015,5,1,3,0,3,1.0,0.0
5978,5,1,2,1,3,0.6666666666666666,0.3333333333333333
5986,5,1,3,47,50,0.06,0.94
5959,5,1,24,335,359,0.06685236768802229,0.9331476323119777
6051,5,1,18,20,38,0.47368421052631576,0.5263157894736842
6029,5,1,1,2,3,0.3333333333333333,0.6666666666666666
6070,5,1,1,0,1,1.0,0.0
5942,5,1,0,145,145,0.0,1.0
5953,5,1,4,0,4,1.0,0.0
6076,5,1,4,3,7,0.5714285714285714,0.42857142857142855
5940,5,1,5,5,10,0.5,0.5
6109,5,1,11,82,93,0.11827956989247312,0.8817204301075269
6187,5,1,2,1,3,0.6666666666666666,0.3333333333333333
6053,5,1,0,17,17,0.0,1.0
6104,5,1,7,2,9,0.7777777777777778,0.2222222222222222
5943,5,1,2,0,2,1.0,0.0
6017,5,1,2,1,3,0.6666666666666666,0.3333333333333333
6168,5,1,4,12,16,0.25,0.75
5989,5,1,5,1,6,0.8333333333333334,0.16666666666666666
5963,5,1,6,0,6,1.0,0.0
6194,5,1,0,26,26,0.0,1.0
6167,5,1,11,8,19,0.5789473684210527,0.42105263157894735
6004,5,1,1,63,64,0.015625,0.984375
6030,5,1,7,0,7,1.0,0.0
6054,5,1,5,1,6,0.8333333333333334,0.16666666666666666
6032,5,1,11,1,12,0.9166666666666666,0.08333333333333333
6170,5,1,14,50,64,0.21875,0.78125
6063,5,1,3,0,3,1.0,0.0
5988,5,1,1,0,1,1.0,0.0
6075,5,1,3,0,3,1.0,0.0
6061,5,1,0,67,67,0.0,1.0
5965,5,1,12,37,49,0.24489795918367346,0.7551020408163265
6040,5,1,9,1,10,0.9,0.1
6059,5,1,0,85,85,0.0,1.0
6106,5,1,7,56,63,0.1111111111111111,0.8888888888888888
6031,5,1,4,10,14,0.2857142857142857,0.7142857142857143
6180,5,1,0,6,6,0.0,1.0
6039,5,1,9,54,63,0.14285714285714285,0.8571428571428571
6189,6,1,0,18,18,0.0,1.0
5936,6,1,4,2,6,0.6666666666666666,0.3333333333333333
6087,6,1,4,7,11,0.36363636363636365,0.6363636363636364
5973,6,1,1,847,848,0.0011792452830188679,0.9988207547169812
6085,6,1,7,5,12,0.5833333333333334,0.4166666666666667
6012,6,1,0,62,62,0.0,1.0
5982,6,1,1,5,6,0.16666666666666666,0.8333333333333334
5948,6,1,0,57,57,0.0,1.0
5974,6,1,3,3,6,0.5,0.5
6090,6,1,0,4,4,0.0,1.0
6068,6,1,3,0,3,1.0,0.0
5962,6,1,8,33,41,0.1951219512195122,0.8048780487804879
6033,6,1,0,1,1,0.0,1.0
6038,6,1,2,0,2,1.0,0.0
6042,6,1,12,85,97,0.12371134020618557,0.8762886597938144
5924,6,1,1,2,3,0.3333333333333333,0.6666666666666666
6083,6,1,0,27,27,0.0,1.0
6178,6,1,13,5,18,0.7222222222222222,0.2777777777777778
5958,6,1,4,0,4,1.0,0.0
6086,6,1,0,14,14,0.0,1.0
5945,6,1,4,15,19,0.21052631578947367,0.7894736842105263
5935,6,1,5,0,5,1.0,0.0
6073,6,1,11,4,15,0.7333333333333333,0.26666666666666666
5980,6,1,17,28,45,0.37777777777777777,0.6222222222222222
5993,6,1,13,470,483,0.026915113871635612,0.9730848861283644
6037,6,1,7,216,223,0.03139013452914798,0.968609865470852
5979,6,1,5,0,5,1.0,0.0
5966,6,1,0,73,73,0.0,1.0
5985,6,1,2,1,3,0.6666666666666666,0.3333333333333333
5967,6,1,0,76,76,0.0,1.0
6188,6,1,9,13,22,0.4090909090909091,0.5909090909090909
6041,6,1,0,12,12,0.0,1.0
5972,6,1,10,3,13,0.7692307692307693,0.23076923076923078
6069,6,1,1,3,4,0.25,0.75
5937,6,1,1,0,1,1.0,0.0
6028,6,1,10,21,31,0.3225806451612903,0.6774193548387096
5990,6,1,0,130,130,0.0,1.0
5928,6,1,11,470,481,0.02286902286902287,0.9771309771309772
5992,6,1,3,1,4,0.75,0.25
6058,6,1,9,4,13,0.6923076923076923,0.3076923076923077
6001,6,1,4,25,29,0.13793103448275862,0.8620689655172413
5964,6,1,11,20,31,0.3548387096774194,0.6451612903225806
5950,6,1,2,2,4,0.5,0.5
5991,6,1,6,2,8,0.75,0.25
6177,6,1,12,297,309,0.038834951456310676,0.9611650485436893
5961,6,1,0,321,321,0.0,1.0
6176,6,1,0,93,93,0.0,1.0
5956,6,1,0,31,31,0.0,1.0
5938,6,1,11,628,639,0.017214397496087636,0.9827856025039123
6179,6,1,8,20,28,0.2857142857142857,0.7142857142857143
5947,6,1,10,50,60,0.16666666666666666,0.8333333333333334
5927,6,1,1,454,455,0.002197802197802198,0.9978021978021978
5977,6,1,1,305,306,0.0032679738562091504,0.9967320261437909
6198,6,1,0,5,5,0.0,1.0
5957,6,1,0,45,45,0.0,1.0
6057,6,1,6,23,29,0.20689655172413793,0.7931034482758621
6043,6,1,8,0,8,1.0,0.0
6077,6,1,0,4,4,0.0,1.0
6014,6,1,8,6,14,0.5714285714285714,0.42857142857142855
6015,6,1,1,2,3,0.3333333333333333,0.6666666666666666
5978,6,1,3,0,3,1.0,0.0
5986,6,1,6,44,50,0.12,0.88
5959,6,1,22,337,359,0.06128133704735376,0.9387186629526463
6051,6,1,12,26,38,0.3157894736842105,0.6842105263157895
6029,6,1,1,2,3,0.3333333333333333,0.6666666666666666
6070,6,1,1,0,1,1.0,0.0
5942,6,1,0,145,145,0.0,1.0
5953,6,1,4,0,4,1.0,0.0
6076,6,1,3,4,7,0.42857142857142855,0.5714285714285714
5940,6,1,4,6,10,0.4,0.6
6109,6,1,13,80,93,0.13978494623655913,0.8602150537634409
6187,6,1,3,0,3,1.0,0.0
6053,6,1,0,17,17,0.0,1.0
6104,6,1,7,2,9,0.7777777777777778,0.2222222222222222
5943,6,1,2,0,2,1.0,0.0
6017,6,1,3,0,3,1.0,0.0
6168,6,1,7,9,16,0.4375,0.5625
5989,6,1,5,1,6,0.8333333333333334,0.16666666666666666
5963,6,1,6,0,6,1.0,0.0
6194,6,1,0,26,26,0.0,1.0
6167,6,1,6,13,19,0.3157894736842105,0.6842105263157895
6004,6,1,0,64,64,0.0,1.0
6030,6,1,7,0,7,1.0,0.0
6054,6,1,5,1,6,0.8333333333333334,0.16666666666666666
6032,6,1,9,3,12,0.75,0.25
6170,6,1,16,48,64,0.25,0.75
6063,6,1,3,0,3,1.0,0.0
5988,6,1,1,0,1,1.0,0.0
6075,6,1,2,1,3,0.6666666666666666,0.3333333333333333
6061,6,1,0,67,67,0.0,1.0
5965,6,1,10,39,49,0.20408163265306123,0.7959183673469388
6040,6,1,8,2,10,0.8,0.2
6059,6,1,0,85,85,0.0,1.0
6106,6,1,4,59,63,0.06349206349206349,0.9365079365079365
6031,6,1,7,7,14,0.5,0.5
6180,6,1,0,6,6,0.0,1.0
6039,6,1,6,57,63,0.09523809523809523,0.9047619047619048
6189,7,1,0,18,18,0.0,1.0
5936,7,1,5,1,6,0.8333333333333334,0.16666666666666666
6087,7,1,1,10,11,0.09090909090909091,0.9090909090909091
5973,7,1,0,848,848,0.0,1.0
6085,7,1,7,5,12,0.5833333333333334,0.4166666666666667
6012,7,1,0,62,62,0.0,1.0
5982,7,1,1,5,6,0.16666666666666666,0.8333333333333334
5948,7,1,0,57,57,0.0,1.0
5974,7,1,2,4,6,0.3333333333333333,0.6666666666666666
6090,7,1,0,4,4,0.0,1.0
6068,7,1,3,0,3,1.0,0.0
5962,7,1,7,34,41,0.17073170731707318,0.8292682926829268
6033,7,1,0,1,1,0.0,1.0
6038,7,1,2,0,2,1.0,0.0
6042,7,1,9,88,97,0.09278350515463918,0.9072164948453608
5924,7,1,0,3,3,0.0,1.0
6083,7,1,0,27,27,0.0,1.0
6178,7,1,10,8,18,0.5555555555555556,0.4444444444444444
5958,7,1,3,1,4,0.75,0.25
6086,7,1,0,14,14,0.0,1.0
5945,7,1,5,14,19,0.2631578947368421,0.7368421052631579
5935,7,1,5,0,5,1.0,0.0
6073,7,1,5,10,15,0.3333333333333333,0.6666666666666666
5980,7,1,7,38,45,0.15555555555555556,0.8444444444444444
5993,7,1,8,475,483,0.016563146997929608,0.9834368530020704
6037,7,1,5,218,223,0.02242152466367713,0.9775784753363229
5979,7,1,5,0,5,1.0,0.0
5966,7,1,0,73,73,0.0,1.0
5985,7,1,2,1,3,0.6666666666666666,0.3333333333333333
5967,7,1,0,76,76,0.0,1.0
6188,7,1,4,18,22,0.18181818181818182,0.8181818181818182
6041,7,1,0,12,12,0.0,1.0
5972,7,1,9,4,13,0.6923076923076923,0.3076923076923077
6069,7,1,0,4,4,0.0,1.0
5937,7,1,1,0,1,1.0,0.0
6028,7,1,7,24,31,0.22580645161290322,0.7741935483870968
5990,7,1,0,130,130,0.0,1.0
5928,7,1,12,469,481,0.02494802494802495,0.975051975051975
5992,7,1,2,2,4,0.5,0.5
6058,7,1,8,5,13,0.6153846153846154,0.38461538461538464
6001,7,1,3,26,29,0.10344827586206896,0.896551724137931
5964,7,1,13,18,31,0.41935483870967744,0.5806451612903226
5950,7,1,4,0,4,1.0,0.0
5991,7,1,2,6,8,0.25,0.75
6177,7,1,12,297,309,0.038834951456310676,0.9611650485436893
5961,7,1,0,321,321,0.0,1.0
6176,7,1,0,93,93,0.0,1.0
5956,7,1,0,31,31,0.0,1.0
5938,7,1,9,630,639,0.014084507042253521,0.9859154929577465
6179,7,1,4,24,28,0.14285714285714285,0.8571428571428571
5947,7,1,11,49,60,0.18333333333333332,0.8166666666666667
5927,7,1,2,453,455,0.004395604395604396,0.9956043956043956
5977,7,1,0,306,306,0.0,1.0
6198,7,1,0,5,5,0.0,1.0
5957,7,1,0,45,45,0.0,1.0
6057,7,1,6,23,29,0.20689655172413793,0.7931034482758621
6043,7,1,8,0,8,1.0,0.0
6077,7,1,0,4,4,0.0,1.0
6014,7,1,10,4,14,0.7142857142857143,0.2857142857142857
6015,7,1,2,1,3,0.6666666666666666,0.3333333333333333
5978,7,1,2,1,3,0.6666666666666666,0.3333333333333333
5986,7,1,1,49,50,0.02,0.98
5959,7,1,10,349,359,0.027855153203342618,0.9721448467966574
6051,7,1,9,29,38,0.23684210526315788,0.7631578947368421
6029,7,1,1,2,3,0.3333333333333333,0.6666666666666666
6070,7,1,1,0,1,1.0,0.0
5942,7,1,0,145,145,0.0,1.0
5953,7,1,4,0,4,1.0,0.0
6076,7,1,2,5,7,0.2857142857142857,0.7142857142857143
5940,7,1,4,6,10,0.4,0.6
6109,7,1,12,81,93,0.12903225806451613,0.8709677419354839
6187,7,1,1,2,3,0.3333333333333333,0.6666666666666666
6053,7,1,0,17,17,0.0,1.0
6104,7,1,7,2,9,0.7777777777777778,0.2222222222222222
5943,7,1,1,1,2,0.5,0.5
6017,7,1,3,0,3,1.0,0.0
6168,7,1,7,9,16,0.4375,0.5625
5989,7,1,3,3,6,0.5,0.5
5963,7,1,6,0,6,1.0,0.0
6194,7,1,0,26,26,0.0,1.0
6167,7,1,9,10,19,0.47368421052631576,0.5263157894736842
6004,7,1,0,64,64,0.0,1.0
6030,7,1,7,0,7,1.0,0.0
6054,7,1,3,3,6,0.5,0.5
6032,7,1,5,7,12,0.4166666666666667,0.5833333333333334
6170,7,1,11,53,64,0.171875,0.828125
6063,7,1,3,0,3,1.0,0.0
5988,7,1,1,0,1,1.0,0.0
6075,7,1,2,1,3,0.6666666666666666,0.3333333333333333
6061,7,1,0,67,67,0.0,1.0
5965,7,1,9,40,49,0.1836734693877551,0.8163265306122449
6040,7,1,8,2,10,0.8,0.2
6059,7,1,0,85,85,0.0,1.0
6106,7,1,2,61,63,0.031746031746031744,0.9682539682539683
6031,7,1,5,9,14,0.35714285714285715,0.6428571428571429
6180,7,1,0,6,6,0.0,1.0
6039,7,1,9,54,63,0.14285714285714285,0.8571428571428571
6189,8,1,0,18,18,0.0,1.0
5936,8,1,5,1,6,0.8333333333333334,0.16666666666666666
6087,8,1,3,8,11,0.2727272727272727,0.7272727272727273
5973,8,1,0,848,848,0.0,1.0
6085,8,1,8,4,12,0.6666666666666666,0.3333333333333333
6012,8,1,0,62,62,0.0,1.0
5982,8,1,0,6,6,0.0,1.0
5948,8,1,0,57,57,0.0,1.0
5974,8,1,5,1,6,0.8333333333333334,0.16666666666666666
6090,8,1,0,4,4,0.0,1.0
6068,8,1,3,0,3,1.0,0.0
5962,8,1,5,36,41,0.12195121951219512,0.8780487804878049
6033,8,1,0,1,1,0.0,1.0
6038,8,1,2,0,2,1.0,0.0
6042,8,1,8,89,97,0.08247422680412371,0.9175257731958762
5924,8,1,1,2,3,0.3333333333333333,0.6666666666666666
6083,8,1,0,27,27,0.0,1.0
6178,8,1,8,10,18,0.4444444444444444,0.5555555555555556
5958,8,1,3,1,4,0.75,0.25
6086,8,1,0,14,14,0.0,1.0
5945,8,1,3,16,19,0.15789473684210525,0.8421052631578947
5935,8,1,4,1,5,0.8,0.2
6073,8,1,4,11,15,0.26666666666666666,0.7333333333333333
5980,8,1,5,40,45,0.1111111111111111,0.8888888888888888
5993,8,1,8,475,483,0.016563146997929608,0.9834368530020704
6037,8,1,5,218,223,0.02242152466367713,0.9775784753363229
5979,8,1,5,0,5,1.0,0.0
5966,8,1,0,73,73,0.0,1.0
5985,8,1,1,2,3,0.3333333333333333,0.6666666666666666
5967,8,1,0,76,76,0.0,1.0
6188,8,1,6,16,22,0.2727272727272727,0.7272727272727273
6041,8,1,0,12,12,0.0,1.0
5972,8,1,9,4,13,0.6923076923076923,0.3076923076923077
6069,8,1,1,3,4,0.25,0.75
5937,8,1,1,0,1,1.0,0.0
6028,8,1,7,24,31,0.22580645161290322,0.7741935483870968
5990,8,1,0,130,130,0.0,1.0
5928,8,1,9,472,481,0.018711018711018712,0.9812889812889813
5992,8,1,3,1,4,0.75,0.25
6058,8,1,10,3,13,0.7692307692307693,0.23076923076923078
6001,8,1,4,25,29,0.13793103448275862,0.8620689655172413
5964,8,1,8,23,31,0.25806451612903225,0.7419354838709677
5950,8,1,3,1,4,0.75,0.25
5991,8,1,2,6,8,0.25,0.75
6177,8,1,10,299,309,0.032362459546925564,0.9676375404530745
5961,8,1,0,321,321,0.0,1.0
6176,8,1,0,93,93,0.0,1.0
5956,8,1,0,31,31,0.0,1.0
5938,8,1,10,629,639,0.01564945226917058,0.9843505477308294
6179,8,1,3,25,28,0.10714285714285714,0.8928571428571429
5947,8,1,15,45,60,0.25,0.75
5927,8,1,0,455,455,0.0,1.0
5977,8,1,1,305,306,0.0032679738562091504,0.9967320261437909
6198,8,1,0,5,5,0.0,1.0
5957,8,1,0,45,45,0.0,1.0
6057,8,1,7,22,29,0.2413793103448276,0.7586206896551724
6043,8,1,8,0,8,1.0,0.0
6077,8,1,0,4,4,0.0,1.0
6014,8,1,7,7,14,0.5,0.5
6015,8,1,2,1,3,0.6666666666666666,0.3333333333333333
5978,8,1,3,0,3,1.0,0.0
5986,8,1,1,49,50,0.02,0.98
5959,8,1,8,351,359,0.022284122562674095,0.9777158774373259
6051,8,1,8,30,38,0.21052631578947367,0.7894736842105263
6029,8,1,2,1,3,0.6666666666666666,0.3333333333333333
6070,8,1,1,0,1,1.0,0.0
5942,8,1,0,145,145,0.0,1.0
5953,8,1,4,0,4,1.0,0.0
6076,8,1,2,5,7,0.2857142857142857,0.7142857142857143
5940,8,1,5,5,10,0.5,0.5
6109,8,1,9,84,93,0.0967741935483871,0.9032258064516129
6187,8,1,1,2,3,0.3333333333333333,0.6666666666666666
6053,8,1,0,17,17,0.0,1.0
6104,8,1,8,1,9,0.8888888888888888,0.1111111111111111
5943,8,1,1,1,2,0.5,0.5
6017,8,1,3,0,3,1.0,0.0
6168,8,1,9,7,16,0.5625,0.4375
5989,8,1,4,2,6,0.6666666666666666,0.3333333333333333
5963,8,1,6,0,6,1.0,0.0
6194,8,1,0,26,26,0.0,1.0
6167,8,1,7,12,19,0.3684210526315789,0.631578947368421
6004,8,1,0,64,64,0.0,1.0
6030,8,1,7,0,7,1.0,0.0
6054,8,1,4,2,6,0.6666666666666666,0.3333333333333333
6032,8,1,9,3,12,0.75,0.25
6170,8,1,6,58,64,0.09375,0.90625
6063,8,1,3,0,3,1.0,0.0
5988,8,1,1,0,1,1.0,0.0
6075,8,1,2,1,3,0.6666666666666666,0.3333333333333333
6061,8,1,0,67,67,0.0,1.0
5965,8,1,7,42,49,0.14285714285714285,0.8571428571428571
6040,8,1,7,3,10,0.7,0.3
6059,8,1,0,85,85,0.0,1.0
6106,8,1,3,60,63,0.047619047619047616,0.9523809523809523
6031,8,1,1,13,14,0.07142857142857142,0.9285714285714286
6180,8,1,0,6,6,0.0,1.0
6039,8,1,10,53,63,0.15873015873015872,0.8412698412698413
6189,9,1,0,18,18,0.0,1.0
5936,9,1,4,2,6,0.6666666666666666,0.3333333333333333
6087,9,1,2,9,11,0.18181818181818182,0.8181818181818182
5973,9,1,3,845,848,0.003537735849056604,0.9964622641509434
6085,9,1,5,7,12,0.4166666666666667,0.5833333333333334
6012,9,1,0,62,62,0.0,1.0
5982,9,1,1,5,6,0.16666666666666666,0.8333333333333334
5948,9,1,0,57,57,0.0,1.0
5974,9,1,2,4,6,0.3333333333333333,0.6666666666666666
6090,9,1,0,4,4,0.0,1.0
6068,9,1,3,0,3,1.0,0.0
5962,9,1,8,33,41,0.1951219512195122,0.8048780487804879
6033,9,1,0,1,1,0.0,1.0
6038,9,1,2,0,2,1.0,0.0
6042,9,1,5,92,97,0.05154639175257732,0.9484536082474226
5924,9,1,0,3,3,0.0,1.0
6083,9,1,0,27,27,0.0,1.0
6178,9,1,10,8,18,0.5555555555555556,0.4444444444444444
5958,9,1,3,1,4,0.75,0.25
6086,9,1,0,14,14,0.0,1.0
5945,9,1,3,16,19,0.15789473684210525,0.8421052631578947
5935,9,1,4,1,5,0.8,0.2
6073,9,1,4,11,15,0.26666666666666666,0.7333333333333333
5980,9,1,5,40,45,0.1111111111111111,0.8888888888888888
5993,9,1,5,478,483,0.010351966873706004,0.989648033126294
6037,9,1,2,221,223,0.008968609865470852,0.9910313901345291
5979,9,1,4,1,5,0.8,0.2
5966,9,1,0,73,73,0.0,1.0
5985,9,1,1,2,3,0.3333333333333333,0.6666666666666666
5967,9,1,0,76,76,0.0,1.0
6188,9,1,5,17,22,0.22727272727272727,0.7727272727272727
6041,9,1,0,12,12,0.0,1.0
5972,9,1,7,6,13,0.5384615384615384,0.46153846153846156
6069,9,1,1,3,4,0.25,0.75
5937,9,1,1,0,1,1.0,0.0
6028,9,1,6,25,31,0.1935483870967742,0.8064516129032258
5990,9,1,0,130,130,0.0,1.0
5928,9,1,5,476,481,0.010395010395010396,0.9896049896049897
5992,9,1,4,0,4,1.0,0.0
6058,9,1,3,10,13,0.23076923076923078,0.7692307692307693
6001,9,1,3,26,29,0.10344827586206896,0.896551724137931
5964,9,1,9,22,31,0.2903225806451613,0.7096774193548387
5950,9,1,4,0,4,1.0,0.0
5991,9,1,2,6,8,0.25,0.75
6177,9,1,3,306,309,0.009708737864077669,0.9902912621359223
5961,9,1,0,321,321,0.0,1.0
6176,9,1,0,93,93,0.0,1.0
5956,9,1,0,31,31,0.0,1.0
5938,9,1,2,637,639,0.003129890453834116,0.9968701095461658
6179,9,1,4,24,28,0.14285714285714285,0.8571428571428571
5947,9,1,12,48,60,0.2,0.8
5927,9,1,0,455,455,0.0,1.0
5977,9,1,0,306,306,0.0,1.0
6198,9,1,0,5,5,0.0,1.0
5957,9,1,0,45,45,0.0,1.0
6057,9,1,4,25,29,0.13793103448275862,0.8620689655172413
6043,9,1,8,0,8,1.0,0.0
6077,9,1,0,4,4,0.0,1.0
6014,9,1,8,6,14,0.5714285714285714,0.42857142857142855
6015,9,1,1,2,3,0.3333333333333333,0.6666666666666666
5978,9,1,2,1,3,0.6666666666666666,0.3333333333333333
5986,9,1,1,49,50,0.02,0.98
5959,9,1,7,352,359,0.019498607242339833,0.9805013927576601
6051,9,1,6,32,38,0.15789473684210525,0.8421052631578947
6029,9,1,1,2,3,0.3333333333333333,0.6666666666666666
6070,9,1,1,0,1,1.0,0.0
5942,9,1,0,145,145,0.0,1.0
5953,9,1,4,0,4,1.0,0.0
6076,9,1,2,5,7,0.2857142857142857,0.7142857142857143
5940,9,1,6,4,10,0.6,0.4
6109,9,1,4,89,93,0.043010752688172046,0.956989247311828
6187,9,1,2,1,3,0.6666666666666666,0.3333333333333333
6053,9,1,0,17,17,0.0,1.0
6104,9,1,7,2,9,0.7777777777777778,0.2222222222222222
5943,9,1,2,0,2,1.0,0.0
6017,9,1,2,1,3,0.6666666666666666,0.3333333333333333
6168,9,1,5,11,16,0.3125,0.6875
5989,9,1,3,3,6,0.5,0.5
5963,9,1,6,0,6,1.0,0.0
6194,9,1,0,26,26,0.0,1.0
6167,9,1,7,12,19,0.3684210526315789,0.631578947368421
6004,9,1,1,63,64,0.015625,0.984375
6030,9,1,6,1,7,0.8571428571428571,0.14285714285714285
6054,9,1,2,4,6,0.3333333333333333,0.6666666666666666
6032,9,1,6,6,12,0.5,0.5
6170,9,1,9,55,64,0.140625,0.859375
6063,9,1,3,0,3,1.0,0.0
5988,9,1,1,0,1,1.0,0.0
6075,9,1,1,2,3,0.3333333333333333,0.6666666666666666
6061,9,1,0,67,67,0.0,1.0
5965,9,1,7,42,49,0.14285714285714285,0.8571428571428571
6040,9,1,6,4,10,0.6,0.4
6059,9,1,0,85,85,0.0,1.0
6106,9,1,1,62,63,0.015873015873015872,0.9841269841269841
6031,9,1,3,11,14,0.21428571428571427,0.7857142857142857
6180,9,1,0,6,6,0.0,1.0
6039,9,1,6,57,63,0.09523809523809523,0.9047619047619048
6189,10,1,0,18,18,0.0,1.0
5936,10,1,3,3,6,0.5,0.5
6087,10,1,3,8,11,0.2727272727272727,0.7272727272727273
5973,10,1,0,848,848,0.0,1.0
6085,10,1,7,5,12,0.5833333333333334,0.4166666666666667
6012,10,1,0,62,62,0.0,1.0
5982,10,1,0,6,6,0.0,1.0
5948,10,1,0,57,57,0.0,1.0
5974,10,1,1,5,6,0.16666666666666666,0.8333333333333334
6090,10,1,0,4,4,0.0,1.0
6068,10,1,3,0,3,1.0,0.0
5962,10,1,5,36,41,0.12195121951219512,0.8780487804878049
6033,10,1,0,1,1,0.0,1.0
6038,10,1,2,0,2,1.0,0.0
6042,10,1,7,90,97,0.07216494845360824,0.9278350515463918
5924,10,1,1,2,3,0.3333333333333333,0.6666666666666666
6083,10,1,0,27,27,0.0,1.0
6178,10,1,6,12,18,0.3333333333333333,0.6666666666666666
5958,10,1,4,0,4,1.0,0.0
6086,10,1,0,14,14,0.0,1.0
5945,10,1,3,16,19,0.15789473684210525,0.8421052631578947
5935,10,1,4,1,5,0.8,0.2
6073,10,1,7,8,15,0.4666666666666667,0.5333333333333333
5980,10,1,4,41,45,0.08888888888888889,0.9111111111111111
5993,10,1,7,476,483,0.014492753623188406,0.9855072463768116
6037,10,1,3,220,223,0.013452914798206279,0.9865470852017937
5979,10,1,5,0,5,1.0,0.0
5966,10,1,0,73,73,0.0,1.0
5985,10,1,1,2,3,0.3333333333333333,0.6666666666666666
5967,10,1,0,76,76,0.0,1.0
6188,10,1,1,21,22,0.045454545454545456,0.9545454545454546
6041,10,1,0,12,12,0.0,1.0
5972,10,1,6,7,13,0.46153846153846156,0.5384615384615384
6069,10,1,1,3,4,0.25,0.75
5937,10,1,1,0,1,1.0,0.0
6028,10,1,7,24,31,0.22580645161290322,0.7741935483870968
5990,10,1,0,130,130,0.0,1.0
5928,10,1,5,476,481,0.010395010395010396,0.9896049896049897
5992,10,1,2,2,4,0.5,0.5
6058,10,1,5,8,13,0.38461538461538464,0.6153846153846154
6001,10,1,1,28,29,0.034482758620689655,0.9655172413793104
5964,10,1,11,20,31,0.3548387096774194,0.6451612903225806
5950,10,1,2,2,4,0.5,0.5
5991,10,1,4,4,8,0.5,0.5
6177,10,1,6,303,309,0.019417475728155338,0.9805825242718447
5961,10,1,0,321,321,0.0,1.0
6176,10,1,0,93,93,0.0,1.0
5956,10,1,0,31,31,0.0,1.0
5938,10,1,3,636,639,0.004694835680751174,0.9953051643192489
6179,10,1,6,22,28,0.21428571428571427,0.7857142857142857
5947,10,1,9,51,60,0.15,0.85
5927,10,1,2,453,455,0.004395604395604396,0.9956043956043956
5977,10,1,2,304,306,0.006535947712418301,0.9934640522875817
6198,10,1,0,5,5,0.0,1.0
5957,10,1,0,45,45,0.0,1.0
6057,10,1,3,26,29,0.10344827586206896,0.896551724137931
6043,10,1,7,1,8,0.875,0.125
6077,10,1,0,4,4,0.0,1.0
6014,10,1,3,11,14,0.21428571428571427,0.7857142857142857
6015,10,1,3,0,3,1.0,0.0
5978,10,1,1,2,3,0.3333333333333333,0.6666666666666666
5986,10,1,4,46,50,0.08,0.92
5959,10,1,8,351,359,0.022284122562674095,0.9777158774373259
6051,10,1,5,33,38,0.13157894736842105,0.868421052631579
6029,10,1,1,2,3,0.3333333333333333,0.6666666666666666
6070,10,1,1,0,1,1.0,0.0
5942,10,1,0,145,145,0.0,1.0
5953,10,1,3,1,4,0.75,0.25
6076,10,1,5,2,7,0.7142857142857143,0.2857142857142857
5940,10,1,4,6,10,0.4,0.6
6109,10,1,5,88,93,0.053763440860215055,0.946236559139785
6187,10,1,1,2,3,0.3333333333333333,0.6666666666666666
6053,10,1,0,17,17,0.0,1.0
6104,10,1,6,3,9,0.6666666666666666,0.3333333333333333
5943,10,1,2,0,2,1.0,0.0
6017,10,1,2,1,3,0.6666666666666666,0.3333333333333333
6168,10,1,5,11,16,0.3125,0.6875
5989,10,1,2,4,6,0.3333333333333333,0.6666666666666666
5963,10,1,6,0,6,1.0,0.0
6194,10,1,0,26,26,0.0,1.0
6167,10,1,5,14,19,0.2631578947368421,0.7368421052631579
6004,10,1,1,63,64,0.015625,0.984375
6030,10,1,7,0,7,1.0,0.0
6054,10,1,2,4,6,0.3333333333333333,0.6666666666666666
6032,10,1,4,8,12,0.3333333333333333,0.6666666666666666
6170,10,1,9,55,64,0.140625,0.859375
6063,10,1,3,0,3,1.0,0.0
5988,10,1,1,0,1,1.0,0.0
6075,10,1,1,2,3,0.3333333333333333,0.6666666666666666
6061,10,1,0,67,67,0.0,1.0
5965,10,1,4,45,49,0.08163265306122448,0.9183673469387755
6040,10,1,8,2,10,0.8,0.2
6059,10,1,0,85,85,0.0,1.0
6106,10,1,3,60,63,0.047619047619047616,0.9523809523809523
6031,10,1,4,10,14,0.2857142857142857,0.7142857142857143
6180,10,1,0,6,6,0.0,1.0
6039,10,1,5,58,63,0.07936507936507936,0.9206349206349206
6189,11,1,0,18,18,0.0,1.0
5936,11,1,3,3,6,0.5,0.5
6087,11,1,3,8,11,0.2727272727272727,0.7272727272727273
5973,11,1,0,848,848,0.0,1.0
6085,11,1,5,7,12,0.4166666666666667,0.5833333333333334
6012,11,1,0,62,62,0.0,1.0
5982,11,1,1,5,6,0.16666666666666666,0.8333333333333334
5948,11,1,0,57,57,0.0,1.0
5974,11,1,1,5,6,0.16666666666666666,0.8333333333333334
6090,11,1,0,4,4,0.0,1.0
6068,11,1,3,0,3,1.0,0.0
5962,11,1,2,39,41,0.04878048780487805,0.9512195121951219
6033,11,1,0,1,1,0.0,1.0
6038,11,1,2,0,2,1.0,0.0
6042,11,1,5,92,97,0.05154639175257732,0.9484536082474226
5924,11,1,1,2,3,0.3333333333333333,0.6666666666666666
6083,11,1,0,27,27,0.0,1.0
6178,11,1,8,10,18,0.4444444444444444,0.5555555555555556
5958,11,1,2,2,4,0.5,0.5
6086,11,1,0,14,14,0.0,1.0
5945,11,1,2,17,19,0.10526315789473684,0.8947368421052632
5935,11,1,3,2,5,0.6,0.4
6073,11,1,5,10,15,0.3333333333333333,0.6666666666666666
5980,11,1,2,43,45,0.044444444444444446,0.9555555555555556
5993,11,1,7,476,483,0.014492753623188406,0.9855072463768116
6037,11,1,3,220,223,0.013452914798206279,0.9865470852017937
5979,11,1,4,1,5,0.8,0.2
5966,11,1,0,73,73,0.0,1.0
5985,11,1,2,1,3,0.6666666666666666,0.3333333333333333
5967,11,1,0,76,76,0.0,1.0
6188,11,1,2,20,22,0.09090909090909091,0.9090909090909091
6041,11,1,0,12,12,0.0,1.0
5972,11,1,4,9,13,0.3076923076923077,0.6923076923076923
6069,11,1,1,3,4,0.25,0.75
5937,11,1,1,0,1,1.0,0.0
6028,11,1,3,28,31,0.0967741935483871,0.9032258064516129
5990,11,1,0,130,130,0.0,1.0
5928,11,1,6,475,481,0.012474012474012475,0.9875259875259875
5992,11,1,2,2,4,0.5,0.5
6058,11,1,6,7,13,0.46153846153846156,0.5384615384615384
6001,11,1,3,26,29,0.10344827586206896,0.896551724137931
5964,11,1,3,28,31,0.0967741935483871,0.9032258064516129
5950,11,1,2,2,4,0.5,0.5
5991,11,1,2,6,8,0.25,0.75
6177,11,1,4,305,309,0.012944983818770227,0.9870550161812298
5961,11,1,0,321,321,0.0,1.0
6176,11,1,0,93,93,0.0,1.0
5956,11,1,0,31,31,0.0,1.0
5938,11,1,4,635,639,0.006259780907668232,0.9937402190923318
6179,11,1,4,24,28,0.14285714285714285,0.8571428571428571
5947,11,1,9,51,60,0.15,0.85
5927,11,1,1,454,455,0.002197802197802198,0.9978021978021978
5977,11,1,0,306,306,0.0,1.0
6198,11,1,0,5,5,0.0,1.0
5957,11,1,0,45,45,0.0,1.0
6057,11,1,2,27,29,0.06896551724137931,0.9310344827586207
6043,11,1,7,1,8,0.875,0.125
6077,11,1,0,4,4,0.0,1.0
6014,11,1,7,7,14,0.5,0.5
6015,11,1,1,2,3,0.3333333333333333,0.6666666666666666
5978,11,1,1,2,3,0.3333333333333333,0.6666666666666666
5986,11,1,2,48,50,0.04,0.96
5959,11,1,5,354,359,0.013927576601671309,0.9860724233983287
6051,11,1,8,30,38,0.21052631578947367,0.7894736842105263
6029,11,1,1,2,3,0.3333333333333333,0.6666666666666666
6070,11,1,1,0,1,1.0,0.0
5942,11,1,0,145,145,0.0,1.0
5953,11,1,3,1,4,0.75,0.25
6076,11,1,3,4,7,0.42857142857142855,0.5714285714285714
5940,11,1,3,7,10,0.3,0.7
6109,11,1,3,90,93,0.03225806451612903,0.967741935483871
6187,11,1,1,2,3,0.3333333333333333,0.6666666666666666
6053,11,1,0,17,17,0.0,1.0
6104,11,1,5,4,9,0.5555555555555556,0.4444444444444444
5943,11,1,1,1,2,0.5,0.5
6017,11,1,3,0,3,1.0,0.0
6168,11,1,5,11,16,0.3125,0.6875
5989,11,1,0,6,6,0.0,1.0
5963,11,1,5,1,6,0.8333333333333334,0.16666666666666666
6194,11,1,0,26,26,0.0,1.0
6167,11,1,5,14,19,0.2631578947368421,0.7368421052631579
6004,11,1,1,63,64,0.015625,0.984375
6030,11,1,6,1,7,0.8571428571428571,0.14285714285714285
6054,11,1,5,1,6,0.8333333333333334,0.16666666666666666
6032,11,1,8,4,12,0.6666666666666666,0.3333333333333333
6170,11,1,8,56,64,0.125,0.875
6063,11,1,3,0,3,1.0,0.0
5988,11,1,1,0,1,1.0,0.0
6075,11,1,0,3,3,0.0,1.0
6061,11,1,0,67,67,0.0,1.0
5965,11,1,3,46,49,0.061224489795918366,0.9387755102040817
6040,11,1,6,4,10,0.6,0.4
6059,11,1,0,85,85,0.0,1.0
6106,11,1,1,62,63,0.015873015873015872,0.9841269841269841
6031,11,1,6,8,14,0.42857142857142855,0.5714285714285714
6180,11,1,0,6,6,0.0,1.0
6039,11,1,2,61,63,0.031746031746031744,0.9682539682539683
6189,12,1,0,18,18,0.0,1.0
5936,12,1,5,1,6,0.8333333333333334,0.16666666666666666
6087,12,1,0,11,11,0.0,1.0
5973,12,1,2,846,848,0.0023584905660377358,0.9976415094339622
6085,12,1,3,9,12,0.25,0.75
6012,12,1,0,62,62,0.0,1.0
5982,12,1,1,5,6,0.16666666666666666,0.8333333333333334
5948,12,1,0,57,57,0.0,1.0
5974,12,1,3,3,6,0.5,0.5
6090,12,1,0,4,4,0.0,1.0
6068,12,1,3,0,3,1.0,0.0
5962,12,1,2,39,41,0.04878048780487805,0.9512195121951219
6033,12,1,0,1,1,0.0,1.0
6038,12,1,2,0,2,1.0,0.0
6042,12,1,3,94,97,0.030927835051546393,0.9690721649484536
5924,12,1,1,2,3,0.3333333333333333,0.6666666666666666
6083,12,1,0,27,27,0.0,1.0
6178,12,1,6,12,18,0.3333333333333333,0.6666666666666666
5958,12,1,4,0,4,1.0,0.0
6086,12,1,0,14,14,0.0,1.0
5945,12,1,1,18,19,0.05263157894736842,0.9473684210526315
5935,12,1,3,2,5,0.6,0.4
6073,12,1,3,12,15,0.2,0.8
5980,12,1,3,42,45,0.06666666666666667,0.9333333333333333
5993,12,1,2,481,483,0.004140786749482402,0.9958592132505176
6037,12,1,2,221,223,0.008968609865470852,0.9910313901345291
5979,12,1,3,2,5,0.6,0.4
5966,12,1,0,73,73,0.0,1.0
5985,12,1,2,1,3,0.6666666666666666,0.3333333333333333
5967,12,1,0,76,76,0.0,1.0
6188,12,1,2,20,22,0.09090909090909091,0.9090909090909091
6041,12,1,0,12,12,0.0,1.0
5972,12,1,5,8,13,0.38461538461538464,0.6153846153846154
6069,12,1,0,4,4,0.0,1.0
5937,12,1,1,0,1,1.0,0.0
6028,12,1,7,24,31,0.22580645161290322,0.7741935483870968
5990,12,1,0,130,130,0.0,1.0
5928,12,1,7,474,481,0.014553014553014554,0.9854469854469855
5992,12,1,2,2,4,0.5,0.5
6058,12,1,5,8,13,0.38461538461538464,0.6153846153846154
6001,12,1,2,27,29,0.06896551724137931,0.9310344827586207
5964,12,1,2,29,31,0.06451612903225806,0.9354838709677419
5950,12,1,2,2,4,0.5,0.5
5991,12,1,3,5,8,0.375,0.625
6177,12,1,1,308,309,0.003236245954692557,0.9967637540453075
5961,12,1,0,321,321,0.0,1.0
6176,12,1,0,93,93,0.0,1.0
5956,12,1,0,31,31,0.0,1.0
5938,12,1,2,637,639,0.003129890453834116,0.9968701095461658
6179,12,1,2,26,28,0.07142857142857142,0.9285714285714286
5947,12,1,7,53,60,0.11666666666666667,0.8833333333333333
5927,12,1,0,455,455,0.0,1.0
5977,12,1,0,306,306,0.0,1.0
6198,12,1,0,5,5,0.0,1.0
5957,12,1,0,45,45,0.0,1.0
6057,12,1,1,28,29,0.034482758620689655,0.9655172413793104
6043,12,1,8,0,8,1.0,0.0
6077,12,1,0,4,4,0.0,1.0
6014,12,1,6,8,14,0.42857142857142855,0.5714285714285714
6015,12,1,1,2,3,0.3333333333333333,0.6666666666666666
5978,12,1,0,3,3,0.0,1.0
5986,12,1,1,49,50,0.02,0.98
5959,12,1,0,359,359,0.0,1.0
6051,12,1,10,28,38,0.2631578947368421,0.7368421052631579
6029,12,1,0,3,3,0.0,1.0
6070,12,1,1,0,1,1.0,0.0
5942,12,1,0,145,145,0.0,1.0
5953,12,1,4,0,4,1.0,0.0
6076,12,1,1,6,7,0.14285714285714285,0.8571428571428571
5940,12,1,2,8,10,0.2,0.8
6109,12,1,4,89,93,0.043010752688172046,0.956989247311828
6187,12,1,1,2,3,0.3333333333333333,0.6666666666666666
6053,12,1,0,17,17,0.0,1.0
6104,12,1,4,5,9,0.4444444444444444,0.5555555555555556
5943,12,1,1,1,2,0.5,0.5
6017,12,1,2,1,3,0.6666666666666666,0.3333333333333333
6168,12,1,5,11,16,0.3125,0.6875
5989,12,1,1,5,6,0.16666666666666666,0.8333333333333334
5963,12,1,5,1,6,0.8333333333333334,0.16666666666666666
6194,12,1,0,26,26,0.0,1.0
6167,12,1,8,11,19,0.42105263157894735,0.5789473684210527
6004,12,1,1,63,64,0.015625,0.984375
6030,12,1,6,1,7,0.8571428571428571,0.14285714285714285
6054,12,1,2,4,6,0.3333333333333333,0.6666666666666666
6032,12,1,3,9,12,0.25,0.75
6170,12,1,8,56,64,0.125,0.875
6063,12,1,3,0,3,1.0,0.0
5988,12,1,1,0,1,1.0,0.0
6075,12,1,0,3,3,0.0,1.0
6061,12,1,0,67,67,0.0,1.0
5965,12,1,2,47,49,0.04081632653061224,0.9591836734693877
6040,12,1,4,6,10,0.4,0.6
6059,12,1,0,85,85,0.0,1.0
6106,12,1,2,61,63,0.031746031746031744,0.9682539682539683
6031,12,1,5,9,14,0.35714285714285715,0.6428571428571429
6180,12,1,0,6,6,0.0,1.0
6039,12,1,5,58,63,0.07936507936507936,0.9206349206349206
6189,13,1,0,18,18,0.0,1.0
5936,13,1,3,3,6,0.5,0.5
6087,13,1,1,10,11,0.09090909090909091,0.9090909090909091
5973,13,1,2,846,848,0.0023584905660377358,0.9976415094339622
6085,13,1,4,8,12,0.3333333333333333,0.6666666666666666
6012,13,1,0,62,62,0.0,1.0
5982,13,1,1,5,6,0.16666666666666666,0.8333333333333334
5948,13,1,0,57,57,0.0,1.0
5974,13,1,2,4,6,0.3333333333333333,0.6666666666666666
6090,13,1,0,4,4,0.0,1.0
6068,13,1,3,0,3,1.0,0.0
5962,13,1,2,39,41,0.04878048780487805,0.9512195121951219
6033,13,1,0,1,1,0.0,1.0
6038,13,1,2,0,2,1.0,0.0
6042,13,1,4,93,97,0.041237113402061855,0.9587628865979382
5924,13,1,1,2,3,0.3333333333333333,0.6666666666666666
6083,13,1,0,27,27,0.0,1.0
6178,13,1,8,10,18,0.4444444444444444,0.5555555555555556
5958,13,1,2,2,4,0.5,0.5
6086,13,1,0,14,14,0.0,1.0
5945,13,1,0,19,19,0.0,1.0
5935,13,1,4,1,5,0.8,0.2
6073,13,1,5,10,15,0.3333333333333333,0.6666666666666666
5980,13,1,3,42,45,0.06666666666666667,0.9333333333333333
5993,13,1,2,481,483,0.004140786749482402,0.9958592132505176
6037,13,1,0,223,223,0.0,1.0
5979,13,1,4,1,5,0.8,0.2
5966,13,1,0,73,73,0.0,1.0
5985,13,1,1,2,3,0.3333333333333333,0.6666666666666666
5967,13,1,0,76,76,0.0,1.0
6188,13,1,2,20,22,0.09090909090909091,0.9090909090909091
6041,13,1,0,12,12,0.0,1.0
5972,13,1,5,8,13,0.38461538461538464,0.6153846153846154
6069,13,1,2,2,4,0.5,0.5
5937,13,1,1,0,1,1.0,0.0
6028,13,1,8,23,31,0.25806451612903225,0.7419354838709677
5990,13,1,0,130,130,0.0,1.0
5928,13,1,3,478,481,0.006237006237006237,0.9937629937629938
5992,13,1,3,1,4,0.75,0.25
6058,13,1,2,11,13,0.15384615384615385,0.8461538461538461
6001,13,1,1,28,29,0.034482758620689655,0.9655172413793104
5964,13,1,5,26,31,0.16129032258064516,0.8387096774193549
5950,13,1,2,2,4,0.5,0.5
5991,13,1,0,8,8,0.0,1.0
6177,13,1,3,306,309,0.009708737864077669,0.9902912621359223
5961,13,1,0,321,321,0.0,1.0
6176,13,1,0,93,93,0.0,1.0
5956,13,1,0,31,31,0.0,1.0
5938,13,1,2,637,639,0.003129890453834116,0.9968701095461658
6179,13,1,2,26,28,0.07142857142857142,0.9285714285714286
5947,13,1,7,53,60,0.11666666666666667,0.8833333333333333
5927,13,1,1,454,455,0.002197802197802198,0.9978021978021978
5977,13,1,0,306,306,0.0,1.0
6198,13,1,0,5,5,0.0,1.0
5957,13,1,0,45,45,0.0,1.0
6057,13,1,1,28,29,0.034482758620689655,0.9655172413793104
6043,13,1,7,1,8,0.875,0.125
6077,13,1,0,4,4,0.0,1.0
6014,13,1,10,4,14,0.7142857142857143,0.2857142857142857
6015,13,1,1,2,3,0.3333333333333333,0.6666666666666666
5978,13,1,1,2,3,0.3333333333333333,0.6666666666666666
5986,13,1,2,48,50,0.04,0.96
5959,13,1,2,357,359,0.005571030640668524,0.9944289693593314
6051,13,1,3,35,38,0.07894736842105263,0.9210526315789473
6029,13,1,0,3,3,0.0,1.0
6070,13,1,1,0,1,1.0,0.0
5942,13,1,0,145,145,0.0,1.0
5953,13,1,2,2,4,0.5,0.5
6076,13,1,1,6,7,0.14285714285714285,0.8571428571428571
5940,13,1,1,9,10,0.1,0.9
6109,13,1,2,91,93,0.021505376344086023,0.978494623655914
6187,13,1,1,2,3,0.3333333333333333,0.6666666666666666
6053,13,1,0,17,17,0.0,1.0
6104,13,1,3,6,9,0.3333333333333333,0.6666666666666666
5943,13,1,1,1,2,0.5,0.5
6017,13,1,3,0,3,1.0,0.0
6168,13,1,3,13,16,0.1875,0.8125
5989,13,1,2,4,6,0.3333333333333333,0.6666666666666666
5963,13,1,6,0,6,1.0,0.0
6194,13,1,0,26,26,0.0,1.0
6167,13,1,4,15,19,0.21052631578947367,0.7894736842105263
6004,13,1,1,63,64,0.015625,0.984375
6030,13,1,6,1,7,0.8571428571428571,0.14285714285714285
6054,13,1,1,5,6,0.16666666666666666,0.8333333333333334
6032,13,1,4,8,12,0.3333333333333333,0.6666666666666666
6170,13,1,6,58,64,0.09375,0.90625
6063,13,1,3,0,3,1.0,0.0
5988,13,1,1,0,1,1.0,0.0
6075,13,1,3,0,3,1.0,0.0
6061,13,1,0,67,67,0.0,1.0
5965,13,1,2,47,49,0.04081632653061224,0.9591836734693877
6040,13,1,6,4,10,0.6,0.4
6059,13,1,0,85,85,0.0,1.0
6106,13,1,2,61,63,0.031746031746031744,0.9682539682539683
6031,13,1,6,8,14,0.42857142857142855,0.5714285714285714
6180,13,1,0,6,6,0.0,1.0
6039,13,1,4,59,63,0.06349206349206349,0.9365079365079365
6189,14,1,0,18,18,0.0,1.0
5936,14,1,3,3,6,0.5,0.5
6087,14,1,2,9,11,0.18181818181818182,0.8181818181818182
5973,14,1,1,847,848,0.0011792452830188679,0.9988207547169812
6085,14,1,2,10,12,0.16666666666666666,0.8333333333333334
6012,14,1,0,62,62,0.0,1.0
5982,14,1,1,5,6,0.16666666666666666,0.8333333333333334
5948,14,1,0,57,57,0.0,1.0
5974,14,1,3,3,6,0.5,0.5
6090,14,1,0,4,4,0.0,1.0
6068,14,1,3,0,3,1.0,0.0
5962,14,1,1,40,41,0.024390243902439025,0.975609756097561
6033,14,1,0,1,1,0.0,1.0
6038,14,1,1,1,2,0.5,0.5
6042,14,1,3,94,97,0.030927835051546393,0.9690721649484536
5924,14,1,1,2,3,0.3333333333333333,0.6666666666666666
6083,14,1,0,27,27,0.0,1.0
6178,14,1,5,13,18,0.2777777777777778,0.7222222222222222
5958,14,1,3,1,4,0.75,0.25
6086,14,1,0,14,14,0.0,1.0
5945,14,1,0,19,19,0.0,1.0
5935,14,1,3,2,5,0.6,0.4
6073,14,1,2,13,15,0.13333333333333333,0.8666666666666667
5980,14,1,1,44,45,0.022222222222222223,0.9777777777777777
5993,14,1,3,480,483,0.006211180124223602,0.9937888198757764
6037,14,1,2,221,223,0.008968609865470852,0.9910313901345291
5979,14,1,3,2,5,0.6,0.4
5966,14,1,0,73,73,0.0,1.0
5985,14,1,1,2,3,0.3333333333333333,0.6666666666666666
5967,14,1,0,76,76,0.0,1.0
6188,14,1,0,22,22,0.0,1.0
6041,14,1,0,12,12,0.0,1.0
5972,14,1,5,8,13,0.38461538461538464,0.6153846153846154
6069,14,1,1,3,4,0.25,0.75
5937,14,1,1,0,1,1.0,0.0
6028,14,1,6,25,31,0.1935483870967742,0.8064516129032258
5990,14,1,0,130,130,0.0,1.0
5928,14,1,4,477,481,0.008316008316008316,0.9916839916839917
5992,14,1,3,1,4,0.75,0.25
6058,14,1,0,13,13,0.0,1.0
6001,14,1,0,29,29,0.0,1.0
5964,14,1,4,27,31,0.12903225806451613,0.8709677419354839
5950,14,1,2,2,4,0.5,0.5
5991,14,1,2,6,8,0.25,0.75
6177,14,1,6,303,309,0.019417475728155338,0.9805825242718447
5961,14,1,0,321,321,0.0,1.0
6176,14,1,0,93,93,0.0,1.0
5956,14,1,0,31,31,0.0,1.0
5938,14,1,1,638,639,0.001564945226917058,0.9984350547730829
6179,14,1,2,26,28,0.07142857142857142,0.9285714285714286
5947,14,1,5,55,60,0.08333333333333333,0.9166666666666666
5927,14,1,0,455,455,0.0,1.0
5977,14,1,0,306,306,0.0,1.0
6198,14,1,0,5,5,0.0,1.0
5957,14,1,0,45,45,0.0,1.0
6057,14,1,1,28,29,0.034482758620689655,0.9655172413793104
6043,14,1,7,1,8,0.875,0.125
6077,14,1,0,4,4,0.0,1.0
6014,14,1,3,11,14,0.21428571428571427,0.7857142857142857
6015,14,1,1,2,3,0.3333333333333333,0.6666666666666666
5978,14,1,1,2,3,0.3333333333333333,0.6666666666666666
5986,14,1,2,48,50,0.04,0.96
5959,14,1,0,359,359,0.0,1.0
6051,14,1,7,31,38,0.18421052631578946,0.8157894736842105
6029,14,1,2,1,3,0.6666666666666666,0.3333333333333333
6070,14,1,1,0,1,1.0,0.0
5942,14,1,0,145,145,0.0,1.0
5953,14,1,3,1,4,0.75,0.25
6076,14,1,0,7,7,0.0,1.0
5940,14,1,2,8,10,0.2,0.8
6109,14,1,3,90,93,0.03225806451612903,0.967741935483871
6187,14,1,0,3,3,0.0,1.0
6053,14,1,0,17,17,0.0,1.0
6104,14,1,3,6,9,0.3333333333333333,0.6666666666666666
5943,14,1,1,1,2,0.5,0.5
6017,14,1,3,0,3,1.0,0.0
6168,14,1,3,13,16,0.1875,0.8125
5989,14,1,3,3,6,0.5,0.5
5963,14,1,6,0,6,1.0,0.0
6194,14,1,0,26,26,0.0,1.0
6167,14,1,2,17,19,0.10526315789473684,0.8947368421052632
6004,14,1,0,64,64,0.0,1.0
6030,14,1,5,2,7,0.7142857142857143,0.2857142857142857
6054,14,1,1,5,6,0.16666666666666666,0.8333333333333334
6032,14,1,3,9,12,0.25,0.75
6170,14,1,3,61,64,0.046875,0.953125
6063,14,1,3,0,3,1.0,0.0
5988,14,1,1,0,1,1.0,0.0
6075,14,1,0,3,3,0.0,1.0
6061,14,1,0,67,67,0.0,1.0
5965,14,1,5,44,49,0.10204081632653061,0.8979591836734694
6040,14,1,7,3,10,0.7,0.3
6059,14,1,0,85,85,0.0,1.0
6106,14,1,3,60,63,0.047619047619047616,0.9523809523809523
6031,14,1,4,10,14,0.2857142857142857,0.7142857142857143
6180,14,1,0,6,6,0.0,1.0
6039,14,1,5,58,63,0.07936507936507936,0.9206349206349206
6189,15,1,0,18,18,0.0,1.0
5936,15,1,3,3,6,0.5,0.5
6087,15,1,2,9,11,0.18181818181818182,0.8181818181818182
5973,15,1,1,847,848,0.0011792452830188679,0.9988207547169812
6085,15,1,5,7,12,0.4166666666666667,0.5833333333333334
6012,15,1,0,62,62,0.0,1.0
5982,15,1,1,5,6,0.16666666666666666,0.8333333333333334
5948,15,1,0,57,57,0.0,1.0
5974,15,1,2,4,6,0.3333333333333333,0.6666666666666666
6090,15,1,0,4,4,0.0,1.0
6068,15,1,3,0,3,1.0,0.0
5962,15,1,2,39,41,0.04878048780487805,0.9512195121951219
6033,15,1,0,1,1,0.0,1.0
6038,15,1,1,1,2,0.5,0.5
6042,15,1,2,95,97,0.020618556701030927,0.979381443298969
5924,15,1,0,3,3,0.0,1.0
6083,15,1,0,27,27,0.0,1.0
6178,15,1,5,13,18,0.2777777777777778,0.7222222222222222
5958,15,1,3,1,4,0.75,0.25
6086,15,1,0,14,14,0.0,1.0
5945,15,1,2,17,19,0.10526315789473684,0.8947368421052632
5935,15,1,0,5,5,0.0,1.0
6073,15,1,5,10,15,0.3333333333333333,0.6666666666666666
5980,15,1,3,42,45,0.06666666666666667,0.9333333333333333
5993,15,1,1,482,483,0.002070393374741201,0.9979296066252588
6037,15,1,0,223,223,0.0,1.0
5979,15,1,2,3,5,0.4,0.6
5966,15,1,0,73,73,0.0,1.0
5985,15,1,0,3,3,0.0,1.0
5967,15,1,0,76,76,0.0,1.0
6188,15,1,2,20,22,0.09090909090909091,0.9090909090909091
6041,15,1,0,12,12,0.0,1.0
5972,15,1,4,9,13,0.3076923076923077,0.6923076923076923
6069,15,1,1,3,4,0.25,0.75
5937,15,1,1,0,1,1.0,0.0
6028,15,1,4,27,31,0.12903225806451613,0.8709677419354839
5990,15,1,0,130,130,0.0,1.0
5928,15,1,6,475,481,0.012474012474012475,0.9875259875259875
5992,15,1,4,0,4,1.0,0.0
6058,15,1,3,10,13,0.23076923076923078,0.7692307692307693
6001,15,1,2,27,29,0.06896551724137931,0.9310344827586207
5964,15,1,5,26,31,0.16129032258064516,0.8387096774193549
5950,15,1,3,1,4,0.75,0.25
5991,15,1,1,7,8,0.125,0.875
6177,15,1,1,308,309,0.003236245954692557,0.9967637540453075
5961,15,1,0,321,321,0.0,1.0
6176,15,1,0,93,93,0.0,1.0
5956,15,1,0,31,31,0.0,1.0
5938,15,1,1,638,639,0.001564945226917058,0.9984350547730829
6179,15,1,1,27,28,0.03571428571428571,0.9642857142857143
5947,15,1,2,58,60,0.03333333333333333,0.9666666666666667
5927,15,1,0,455,455,0.0,1.0
5977,15,1,0,306,306,0.0,1.0
6198,15,1,0,5,5,0.0,1.0
5957,15,1,0,45,45,0.0,1.0
6057,15,1,1,28,29,0.034482758620689655,0.9655172413793104
6043,15,1,7,1,8,0.875,0.125
6077,15,1,0,4,4,0.0,1.0
6014,15,1,4,10,14,0.2857142857142857,0.7142857142857143
6015,15,1,0,3,3,0.0,1.0
5978,15,1,1,2,3,0.3333333333333333,0.6666666666666666
5986,15,1,2,48,50,0.04,0.96
5959,15,1,3,356,359,0.008356545961002786,0.9916434540389972
6051,15,1,4,34,38,0.10526315789473684,0.8947368421052632
6029,15,1,1,2,3,0.3333333333333333,0.6666666666666666
6070,15,1,0,1,1,0.0,1.0
5942,15,1,0,145,145,0.0,1.0
5953,15,1,3,1,4,0.75,0.25
6076,15,1,1,6,7,0.14285714285714285,0.8571428571428571
5940,15,1,2,8,10,0.2,0.8
6109,15,1,4,89,93,0.043010752688172046,0.956989247311828
6187,15,1,1,2,3,0.3333333333333333,0.6666666666666666
6053,15,1,0,17,17,0.0,1.0
6104,15,1,2,7,9,0.2222222222222222,0.7777777777777778
5943,15,1,1,1,2,0.5,0.5
6017,15,1,2,1,3,0.6666666666666666,0.3333333333333333
6168,15,1,4,12,16,0.25,0.75
5989,15,1,0,6,6,0.0,1.0
5963,15,1,6,0,6,1.0,0.0
6194,15,1,0,26,26,0.0,1.0
6167,15,1,0,19,19,0.0,1.0
6004,15,1,0,64,64,0.0,1.0
6030,15,1,6,1,7,0.8571428571428571,0.14285714285714285
6054,15,1,2,4,6,0.3333333333333333,0.6666666666666666
6032,15,1,6,6,12,0.5,0.5
6170,15,1,2,62,64,0.03125,0.96875
6063,15,1,3,0,3,1.0,0.0
5988,15,1,1,0,1,1.0,0.0
6075,15,1,0,3,3,0.0,1.0
6061,15,1,0,67,67,0.0,1.0
5965,15,1,1,48,49,0.02040816326530612,0.9795918367346939
6040,15,1,4,6,10,0.4,0.6
6059,15,1,0,85,85,0.0,1.0
6106,15,1,3,60,63,0.047619047619047616,0.9523809523809523
6031,15,1,4,10,14,0.2857142857142857,0.7142857142857143
6180,15,1,0,6,6,0.0,1.0
6039,15,1,6,57,63,0.09523809523809523,0.9047619047619048
6189,16,1,0,18,18,0.0,1.0
5936,16,1,1,5,6,0.16666666666666666,0.8333333333333334
6087,16,1,1,10,11,0.09090909090909091,0.9090909090909091
5973,16,1,1,847,848,0.0011792452830188679,0.9988207547169812
6085,16,1,4,8,12,0.3333333333333333,0.6666666666666666
6012,16,1,0,62,62,0.0,1.0
5982,16,1,0,6,6,0.0,1.0
5948,16,1,0,57,57,0.0,1.0
5974,16,1,3,3,6,0.5,0.5
6090,16,1,0,4,4,0.0,1.0
6068,16,1,2,1,3,0.6666666666666666,0.3333333333333333
5962,16,1,3,38,41,0.07317073170731707,0.926829268292683
6033,16,1,0,1,1,0.0,1.0
6038,16,1,1,1,2,0.5,0.5
6042,16,1,6,91,97,0.061855670103092786,0.9381443298969072
5924,16,1,0,3,3,0.0,1.0
6083,16,1,0,27,27,0.0,1.0
6178,16,1,4,14,18,0.2222222222222222,0.7777777777777778
5958,16,1,2,2,4,0.5,0.5
6086,16,1,0,14,14,0.0,1.0
5945,16,1,1,18,19,0.05263157894736842,0.9473684210526315
5935,16,1,1,4,5,0.2,0.8
6073,16,1,4,11,15,0.26666666666666666,0.7333333333333333
5980,16,1,2,43,45,0.044444444444444446,0.9555555555555556
5993,16,1,2,481,483,0.004140786749482402,0.9958592132505176
6037,16,1,1,222,223,0.004484304932735426,0.9955156950672646
5979,16,1,3,2,5,0.6,0.4
5966,16,1,0,73,73,0.0,1.0
5985,16,1,1,2,3,0.3333333333333333,0.6666666666666666
5967,16,1,0,76,76,0.0,1.0
6188,16,1,2,20,22,0.09090909090909091,0.9090909090909091
6041,16,1,0,12,12,0.0,1.0
5972,16,1,5,8,13,0.38461538461538464,0.6153846153846154
6069,16,1,1,3,4,0.25,0.75
5937,16,1,1,0,1,1.0,0.0
6028,16,1,5,26,31,0.16129032258064516,0.8387096774193549
5990,16,1,0,130,130,0.0,1.0
5928,16,1,1,480,481,0.002079002079002079,0.997920997920998
5992,16,1,4,0,4,1.0,0.0
6058,16,1,1,12,13,0.07692307692307693,0.9230769230769231
6001,16,1,2,27,29,0.06896551724137931,0.9310344827586207
5964,16,1,6,25,31,0.1935483870967742,0.8064516129032258
5950,16,1,1,3,4,0.25,0.75
5991,16,1,1,7,8,0.125,0.875
6177,16,1,4,305,309,0.012944983818770227,0.9870550161812298
5961,16,1,0,321,321,0.0,1.0
6176,16,1,0,93,93,0.0,1.0
5956,16,1,0,31,31,0.0,1.0
5938,16,1,1,638,639,0.001564945226917058,0.9984350547730829
6179,16,1,2,26,28,0.07142857142857142,0.9285714285714286
5947,16,1,1,59,60,0.016666666666666666,0.9833333333333333
5927,16,1,0,455,455,0.0,1.0
5977,16,1,0,306,306,0.0,1.0
6198,16,1,0,5,5,0.0,1.0
5957,16,1,0,45,45,0.0,1.0
6057,16,1,1,28,29,0.034482758620689655,0.9655172413793104
6043,16,1,7,1,8,0.875,0.125
6077,16,1,0,4,4,0.0,1.0
6014,16,1,3,11,14,0.21428571428571427,0.7857142857142857
6015,16,1,0,3,3,0.0,1.0
5978,16,1,1,2,3,0.3333333333333333,0.6666666666666666
5986,16,1,1,49,50,0.02,0.98
5959,16,1,2,357,359,0.005571030640668524,0.9944289693593314
6051,16,1,0,38,38,0.0,1.0
6029,16,1,2,1,3,0.6666666666666666,0.3333333333333333
6070,16,1,0,1,1,0.0,1.0
5942,16,1,0,145,145,0.0,1.0
5953,16,1,1,3,4,0.25,0.75
6076,16,1,0,7,7,0.0,1.0
5940,16,1,2,8,10,0.2,0.8
6109,16,1,0,93,93,0.0,1.0
6187,16,1,0,3,3,0.0,1.0
6053,16,1,0,17,17,0.0,1.0
6104,16,1,3,6,9,0.3333333333333333,0.6666666666666666
5943,16,1,1,1,2,0.5,0.5
6017,16,1,2,1,3,0.6666666666666666,0.3333333333333333
6168,16,1,1,15,16,0.0625,0.9375
5989,16,1,2,4,6,0.3333333333333333,0.6666666666666666
5963,16,1,5,1,6,0.8333333333333334,0.16666666666666666
6194,16,1,0,26,26,0.0,1.0
6167,16,1,2,17,19,0.10526315789473684,0.8947368421052632
6004,16,1,1,63,64,0.015625,0.984375
6030,16,1,5,2,7,0.7142857142857143,0.2857142857142857
6054,16,1,2,4,6,0.3333333333333333,0.6666666666666666
6032,16,1,3,9,12,0.25,0.75
6170,16,1,7,57,64,0.109375,0.890625
6063,16,1,3,0,3,1.0,0.0
5988,16,1,1,0,1,1.0,0.0
6075,16,1,0,3,3,0.0,1.0
6061,16,1,0,67,67,0.0,1.0
5965,16,1,3,46,49,0.061224489795918366,0.9387755102040817
6040,16,1,5,5,10,0.5,0.5
6059,16,1,0,85,85,0.0,1.0
6106,16,1,1,62,63,0.015873015873015872,0.9841269841269841
6031,16,1,4,10,14,0.2857142857142857,0.7142857142857143
6180,16,1,0,6,6,0.0,1.0
6039,16,1,1,62,63,0.015873015873015872,0.9841269841269841
6189,17,1,0,18,18,0.0,1.0
5936,17,1,2,4,6,0.3333333333333333,0.6666666666666666
6087,17,1,2,9,11,0.18181818181818182,0.8181818181818182
5973,17,1,1,847,848,0.0011792452830188679,0.9988207547169812
6085,17,1,1,11,12,0.08333333333333333,0.9166666666666666
6012,17,1,0,62,62,0.0,1.0
5982,17,1,0,6,6,0.0,1.0
5948,17,1,0,57,57,0.0,1.0
5974,17,1,2,4,6,0.3333333333333333,0.6666666666666666
6090,17,1,0,4,4,0.0,1.0
6068,17,1,2,1,3,0.6666666666666666,0.3333333333333333
5962,17,1,0,41,41,0.0,1.0
6033,17,1,0,1,1,0.0,1.0
6038,17,1,2,0,2,1.0,0.0
6042,17,1,3,94,97,0.030927835051546393,0.9690721649484536
5924,17,1,0,3,3,0.0,1.0
6083,17,1,0,27,27,0.0,1.0
6178,17,1,2,16,18,0.1111111111111111,0.8888888888888888
5958,17,1,2,2,4,0.5,0.5
6086,17,1,0,14,14,0.0,1.0
5945,17,1,2,17,19,0.10526315789473684,0.8947368421052632
5935,17,1,2,3,5,0.4,0.6
6073,17,1,4,11,15,0.26666666666666666,0.7333333333333333
5980,17,1,2,43,45,0.044444444444444446,0.9555555555555556
5993,17,1,2,481,483,0.004140786749482402,0.9958592132505176
6037,17,1,0,223,223,0.0,1.0
5979,17,1,2,3,5,0.4,0.6
5966,17,1,0,73,73,0.0,1.0
5985,17,1,0,3,3,0.0,1.0
5967,17,1,0,76,76,0.0,1.0
6188,17,1,1,21,22,0.045454545454545456,0.9545454545454546
6041,17,1,0,12,12,0.0,1.0
5972,17,1,4,9,13,0.3076923076923077,0.6923076923076923
6069,17,1,0,4,4,0.0,1.0
5937,17,1,1,0,1,1.0,0.0
6028,17,1,5,26,31,0.16129032258064516,0.8387096774193549
5990,17,1,0,130,130,0.0,1.0
5928,17,1,5,476,481,0.010395010395010396,0.9896049896049897
5992,17,1,2,2,4,0.5,0.5
6058,17,1,2,11,13,0.15384615384615385,0.8461538461538461
6001,17,1,1,28,29,0.034482758620689655,0.9655172413793104
5964,17,1,3,28,31,0.0967741935483871,0.9032258064516129
5950,17,1,0,4,4,0.0,1.0
5991,17,1,1,7,8,0.125,0.875
6177,17,1,0,309,309,0.0,1.0
5961,17,1,0,321,321,0.0,1.0
6176,17,1,0,93,93,0.0,1.0
5956,17,1,0,31,31,0.0,1.0
5938,17,1,0,639,639,0.0,1.0
6179,17,1,2,26,28,0.07142857142857142,0.9285714285714286
5947,17,1,3,57,60,0.05,0.95
5927,17,1,0,455,455,0.0,1.0
5977,17,1,0,306,306,0.0,1.0
6198,17,1,0,5,5,0.0,1.0
5957,17,1,0,45,45,0.0,1.0
6057,17,1,0,29,29,0.0,1.0
6043,17,1,6,2,8,0.75,0.25
6077,17,1,0,4,4,0.0,1.0
6014,17,1,2,12,14,0.14285714285714285,0.8571428571428571
6015,17,1,0,3,3,0.0,1.0
5978,17,1,2,1,3,0.6666666666666666,0.3333333333333333
5986,17,1,1,49,50,0.02,0.98
5959,17,1,2,357,359,0.005571030640668524,0.9944289693593314
6051,17,1,5,33,38,0.13157894736842105,0.868421052631579
6029,17,1,0,3,3,0.0,1.0
6070,17,1,0,1,1,0.0,1.0
5942,17,1,0,145,145,0.0,1.0
5953,17,1,1,3,4,0.25,0.75
6076,17,1,1,6,7,0.14285714285714285,0.8571428571428571
5940,17,1,3,7,10,0.3,0.7
6109,17,1,3,90,93,0.03225806451612903,0.967741935483871
6187,17,1,0,3,3,0.0,1.0
6053,17,1,0,17,17,0.0,1.0
6104,17,1,2,7,9,0.2222222222222222,0.7777777777777778
5943,17,1,0,2,2,0.0,1.0
6017,17,1,3,0,3,1.0,0.0
6168,17,1,3,13,16,0.1875,0.8125
5989,17,1,0,6,6,0.0,1.0
5963,17,1,6,0,6,1.0,0.0
6194,17,1,0,26,26,0.0,1.0
6167,17,1,1,18,19,0.05263157894736842,0.9473684210526315
6004,17,1,0,64,64,0.0,1.0
6030,17,1,5,2,7,0.7142857142857143,0.2857142857142857
6054,17,1,3,3,6,0.5,0.5
6032,17,1,3,9,12,0.25,0.75
6170,17,1,11,53,64,0.171875,0.828125
6063,17,1,3,0,3,1.0,0.0
5988,17,1,1,0,1,1.0,0.0
6075,17,1,0,3,3,0.0,1.0
6061,17,1,0,67,67,0.0,1.0
5965,17,1,1,48,49,0.02040816326530612,0.9795918367346939
6040,17,1,2,8,10,0.2,0.8
6059,17,1,0,85,85,0.0,1.0
6106,17,1,1,62,63,0.015873015873015872,0.9841269841269841
6031,17,1,4,10,14,0.2857142857142857,0.7142857142857143
6180,17,1,0,6,6,0.0,1.0
6039,17,1,6,57,63,0.09523809523809523,0.9047619047619048
6189,18,1,0,18,18,0.0,1.0
5936,18,1,2,4,6,0.3333333333333333,0.6666666666666666
6087,18,1,1,10,11,0.09090909090909091,0.9090909090909091
5973,18,1,1,847,848,0.0011792452830188679,0.9988207547169812
6085,18,1,1,11,12,0.08333333333333333,0.9166666666666666
6012,18,1,0,62,62,0.0,1.0
5982,18,1,1,5,6,0.16666666666666666,0.8333333333333334
5948,18,1,0,57,57,0.0,1.0
5974,18,1,2,4,6,0.3333333333333333,0.6666666666666666
6090,18,1,0,4,4,0.0,1.0
6068,18,1,2,1,3,0.6666666666666666,0.3333333333333333
5962,18,1,1,40,41,0.024390243902439025,0.975609756097561
6033,18,1,0,1,1,0.0,1.0
6038,18,1,1,1,2,0.5,0.5
6042,18,1,2,95,97,0.020618556701030927,0.979381443298969
5924,18,1,1,2,3,0.3333333333333333,0.6666666666666666
6083,18,1,0,27,27,0.0,1.0
6178,18,1,3,15,18,0.16666666666666666,0.8333333333333334
5958,18,1,2,2,4,0.5,0.5
6086,18,1,0,14,14,0.0,1.0
5945,18,1,0,19,19,0.0,1.0
5935,18,1,0,5,5,0.0,1.0
6073,18,1,2,13,15,0.13333333333333333,0.8666666666666667
5980,18,1,2,43,45,0.044444444444444446,0.9555555555555556
5993,18,1,1,482,483,0.002070393374741201,0.9979296066252588
6037,18,1,0,223,223,0.0,1.0
5979,18,1,3,2,5,0.6,0.4
5966,18,1,0,73,73,0.0,1.0
5985,18,1,0,3,3,0.0,1.0
5967,18,1,0,76,76,0.0,1.0
6188,18,1,1,21,22,0.045454545454545456,0.9545454545454546
6041,18,1,0,12,12,0.0,1.0
5972,18,1,7,6,13,0.5384615384615384,0.46153846153846156
6069,18,1,0,4,4,0.0,1.0
5937,18,1,1,0,1,1.0,0.0
6028,18,1,0,31,31,0.0,1.0
5990,18,1,0,130,130,0.0,1.0
5928,18,1,1,480,481,0.002079002079002079,0.997920997920998
5992,18,1,2,2,4,0.5,0.5
6058,18,1,2,11,13,0.15384615384615385,0.8461538461538461
6001,18,1,2,27,29,0.06896551724137931,0.9310344827586207
5964,18,1,2,29,31,0.06451612903225806,0.9354838709677419
5950,18,1,0,4,4,0.0,1.0
5991,18,1,1,7,8,0.125,0.875
6177,18,1,1,308,309,0.003236245954692557,0.9967637540453075
5961,18,1,0,321,321,0.0,1.0
6176,18,1,0,93,93,0.0,1.0
5956,18,1,0,31,31,0.0,1.0
5938,18,1,2,637,639,0.003129890453834116,0.9968701095461658
6179,18,1,1,27,28,0.03571428571428571,0.9642857142857143
5947,18,1,4,56,60,0.06666666666666667,0.9333333333333333
5927,18,1,1,454,455,0.002197802197802198,0.9978021978021978
5977,18,1,0,306,306,0.0,1.0
6198,18,1,0,5,5,0.0,1.0
5957,18,1,0,45,45,0.0,1.0
6057,18,1,1,28,29,0.034482758620689655,0.9655172413793104
6043,18,1,5,3,8,0.625,0.375
6077,18,1,0,4,4,0.0,1.0
6014,18,1,4,10,14,0.2857142857142857,0.7142857142857143
6015,18,1,0,3,3,0.0,1.0
5978,18,1,2,1,3,0.6666666666666666,0.3333333333333333
5986,18,1,3,47,50,0.06,0.94
5959,18,1,2,357,359,0.005571030640668524,0.9944289693593314
6051,18,1,0,38,38,0.0,1.0
6029,18,1,0,3,3,0.0,1.0
6070,18,1,0,1,1,0.0,1.0
5942,18,1,0,145,145,0.0,1.0
5953,18,1,1,3,4,0.25,0.75
6076,18,1,3,4,7,0.42857142857142855,0.5714285714285714
5940,18,1,1,9,10,0.1,0.9
6109,18,1,1,92,93,0.010752688172043012,0.989247311827957
6187,18,1,1,2,3,0.3333333333333333,0.6666666666666666
6053,18,1,0,17,17,0.0,1.0
6104,18,1,2,7,9,0.2222222222222222,0.7777777777777778
5943,18,1,1,1,2,0.5,0.5
6017,18,1,3,0,3,1.0,0.0
6168,18,1,6,10,16,0.375,0.625
5989,18,1,0,6,6,0.0,1.0
5963,18,1,5,1,6,0.8333333333333334,0.16666666666666666
6194,18,1,0,26,26,0.0,1.0
6167,18,1,2,17,19,0.10526315789473684,0.8947368421052632
6004,18,1,1,63,64,0.015625,0.984375
6030,18,1,5,2,7,0.7142857142857143,0.2857142857142857
6054,18,1,1,5,6,0.16666666666666666,0.8333333333333334
6032,18,1,2,10,12,0.16666666666666666,0.8333333333333334
6170,18,1,1,63,64,0.015625,0.984375
6063,18,1,3,0,3,1.0,0.0
5988,18,1,1,0,1,1.0,0.0
6075,18,1,0,3,3,0.0,1.0
6061,18,1,0,67,67,0.0,1.0
5965,18,1,3,46,49,0.061224489795918366,0.9387755102040817
6040,18,1,1,9,10,0.1,0.9
6059,18,1,0,85,85,0.0,1.0
6106,18,1,0,63,63,0.0,1.0
6031,18,1,5,9,14,0.35714285714285715,0.6428571428571429
6180,18,1,0,6,6,0.0,1.0
6039,18,1,3,60,63,0.047619047619047616,0.9523809523809523
6189,19,1,0,18,18,0.0,1.0
5936,19,1,3,3,6,0.5,0.5
6087,19,1,2,9,11,0.18181818181818182,0.8181818181818182
5973,19,1,0,848,848,0.0,1.0
6085,19,1,0,12,12,0.0,1.0
6012,19,1,0,62,62,0.0,1.0
5982,19,1,1,5,6,0.16666666666666666,0.8333333333333334
5948,19,1,0,57,57,0.0,1.0
5974,19,1,3,3,6,0.5,0.5
6090,19,1,0,4,4,0.0,1.0
6068,19,1,2,1,3,0.6666666666666666,0.3333333333333333
5962,19,1,1,40,41,0.024390243902439025,0.975609756097561
6033,19,1,0,1,1,0.0,1.0
6038,19,1,1,1,2,0.5,0.5
6042,19,1,3,94,97,0.030927835051546393,0.9690721649484536
5924,19,1,1,2,3,0.3333333333333333,0.6666666666666666
6083,19,1,0,27,27,0.0,1.0
6178,19,1,7,11,18,0.3888888888888889,0.6111111111111112
5958,19,1,1,3,4,0.25,0.75
6086,19,1,0,14,14,0.0,1.0
5945,19,1,1,18,19,0.05263157894736842,0.9473684210526315
5935,19,1,0,5,5,0.0,1.0
6073,19,1,0,15,15,0.0,1.0
5980,19,1,2,43,45,0.044444444444444446,0.9555555555555556
5993,19,1,2,481,483,0.004140786749482402,0.9958592132505176
6037,19,1,1,222,223,0.004484304932735426,0.9955156950672646
5979,19,1,3,2,5,0.6,0.4
5966,19,1,0,73,73,0.0,1.0
5985,19,1,0,3,3,0.0,1.0
5967,19,1,0,76,76,0.0,1.0
6188,19,1,1,21,22,0.045454545454545456,0.9545454545454546
6041,19,1,0,12,12,0.0,1.0
5972,19,1,4,9,13,0.3076923076923077,0.6923076923076923
6069,19,1,2,2,4,0.5,0.5
5937,19,1,1,0,1,1.0,0.0
6028,19,1,2,29,31,0.06451612903225806,0.9354838709677419
5990,19,1,0,130,130,0.0,1.0
5928,19,1,2,479,481,0.004158004158004158,0.9958419958419958
5992,19,1,4,0,4,1.0,0.0
6058,19,1,3,10,13,0.23076923076923078,0.7692307692307693
6001,19,1,1,28,29,0.034482758620689655,0.9655172413793104
5964,19,1,3,28,31,0.0967741935483871,0.9032258064516129
5950,19,1,0,4,4,0.0,1.0
5991,19,1,2,6,8,0.25,0.75
6177,19,1,2,307,309,0.006472491909385114,0.9935275080906149
5961,19,1,0,321,321,0.0,1.0
6176,19,1,0,93,93,0.0,1.0
5956,19,1,0,31,31,0.0,1.0
5938,19,1,1,638,639,0.001564945226917058,0.9984350547730829
6179,19,1,2,26,28,0.07142857142857142,0.9285714285714286
5947,19,1,2,58,60,0.03333333333333333,0.9666666666666667
5927,19,1,0,455,455,0.0,1.0
5977,19,1,0,306,306,0.0,1.0
6198,19,1,0,5,5,0.0,1.0
5957,19,1,0,45,45,0.0,1.0
6057,19,1,1,28,29,0.034482758620689655,0.9655172413793104
6043,19,1,6,2,8,0.75,0.25
6077,19,1,0,4,4,0.0,1.0
6014,19,1,4,10,14,0.2857142857142857,0.7142857142857143
6015,19,1,0,3,3,0.0,1.0
5978,19,1,1,2,3,0.3333333333333333,0.6666666666666666
5986,19,1,1,49,50,0.02,0.98
5959,19,1,1,358,359,0.002785515320334262,0.9972144846796658
6051,19,1,1,37,38,0.02631578947368421,0.9736842105263158
6029,19,1,1,2,3,0.3333333333333333,0.6666666666666666
6070,19,1,0,1,1,0.0,1.0
5942,19,1,0,145,145,0.0,1.0
5953,19,1,1,3,4,0.25,0.75
6076,19,1,0,7,7,0.0,1.0
5940,19,1,1,9,10,0.1,0.9
6109,19,1,2,91,93,0.021505376344086023,0.978494623655914
6187,19,1,0,3,3,0.0,1.0
6053,19,1,0,17,17,0.0,1.0
6104,19,1,3,6,9,0.3333333333333333,0.6666666666666666
5943,19,1,0,2,2,0.0,1.0
6017,19,1,2,1,3,0.6666666666666666,0.3333333333333333
6168,19,1,1,15,16,0.0625,0.9375
5989,19,1,2,4,6,0.3333333333333333,0.6666666666666666
5963,19,1,6,0,6,1.0,0.0
6194,19,1,0,26,26,0.0,1.0
6167,19,1,6,13,19,0.3157894736842105,0.6842105263157895
6004,19,1,0,64,64,0.0,1.0
6030,19,1,4,3,7,0.5714285714285714,0.42857142857142855
6054,19,1,1,5,6,0.16666666666666666,0.8333333333333334
6032,19,1,3,9,12,0.25,0.75
6170,19,1,4,60,64,0.0625,0.9375
6063,19,1,3,0,3,1.0,0.0
5988,19,1,1,0,1,1.0,0.0
6075,19,1,0,3,3,0.0,1.0
6061,19,1,0,67,67,0.0,1.0
5965,19,1,1,48,49,0.02040816326530612,0.9795918367346939
6040,19,1,3,7,10,0.3,0.7
6059,19,1,0,85,85,0.0,1.0
6106,19,1,1,62,63,0.015873015873015872,0.9841269841269841
6031,19,1,3,11,14,0.21428571428571427,0.7857142857142857
6180,19,1,0,6,6,0.0,1.0
6039,19,1,1,62,63,0.015873015873015872,0.9841269841269841
6189,20,1,0,18,18,0.0,1.0
5936,20,1,1,5,6,0.16666666666666666,0.8333333333333334
6087,20,1,3,8,11,0.2727272727272727,0.7272727272727273
5973,20,1,1,847,848,0.0011792452830188679,0.9988207547169812
6085,20,1,0,12,12,0.0,1.0
6012,20,1,0,62,62,0.0,1.0
5982,20,1,0,6,6,0.0,1.0
5948,20,1,0,57,57,0.0,1.0
5974,20,1,2,4,6,0.3333333333333333,0.6666666666666666
6090,20,1,0,4,4,0.0,1.0
6068,20,1,3,0,3,1.0,0.0
5962,20,1,2,39,41,0.04878048780487805,0.9512195121951219
6033,20,1,0,1,1,0.0,1.0
6038,20,1,1,1,2,0.5,0.5
6042,20,1,2,95,97,0.020618556701030927,0.979381443298969
5924,20,1,0,3,3,0.0,1.0
6083,20,1,0,27,27,0.0,1.0
6178,20,1,6,12,18,0.3333333333333333,0.6666666666666666
5958,20,1,2,2,4,0.5,0.5
6086,20,1,0,14,14,0.0,1.0
5945,20,1,1,18,19,0.05263157894736842,0.9473684210526315
5935,20,1,0,5,5,0.0,1.0
6073,20,1,2,13,15,0.13333333333333333,0.8666666666666667
5980,20,1,1,44,45,0.022222222222222223,0.9777777777777777
5993,20,1,2,481,483,0.004140786749482402,0.9958592132505176
6037,20,1,0,223,223,0.0,1.0
5979,20,1,4,1,5,0.8,0.2
5966,20,1,0,73,73,0.0,1.0
5985,20,1,0,3,3,0.0,1.0
5967,20,1,0,76,76,0.0,1.0
6188,20,1,2,20,22,0.09090909090909091,0.9090909090909091
6041,20,1,0,12,12,0.0,1.0
5972,20,1,4,9,13,0.3076923076923077,0.6923076923076923
6069,20,1,1,3,4,0.25,0.75
5937,20,1,1,0,1,1.0,0.0
6028,20,1,5,26,31,0.16129032258064516,0.8387096774193549
5990,20,1,0,130,130,0.0,1.0
5928,20,1,0,481,481,0.0,1.0
5992,20,1,3,1,4,0.75,0.25
6058,20,1,1,12,13,0.07692307692307693,0.9230769230769231
6001,20,1,3,26,29,0.10344827586206896,0.896551724137931
5964,20,1,1,30,31,0.03225806451612903,0.967741935483871
5950,20,1,0,4,4,0.0,1.0
5991,20,1,0,8,8,0.0,1.0
6177,20,1,4,305,309,0.012944983818770227,0.9870550161812298
5961,20,1,0,321,321,0.0,1.0
6176,20,1,0,93,93,0.0,1.0
5956,20,1,0,31,31,0.0,1.0
5938,20,1,0,639,639,0.0,1.0
6179,20,1,1,27,28,0.03571428571428571,0.9642857142857143
5947,20,1,3,57,60,0.05,0.95
5927,20,1,0,455,455,0.0,1.0
5977,20,1,0,306,306,0.0,1.0
6198,20,1,0,5,5,0.0,1.0
5957,20,1,0,45,45,0.0,1.0
6057,20,1,0,29,29,0.0,1.0
6043,20,1,3,5,8,0.375,0.625
6077,20,1,0,4,4,0.0,1.0
6014,20,1,3,11,14,0.21428571428571427,0.7857142857142857
6015,20,1,0,3,3,0.0,1.0
5978,20,1,0,3,3,0.0,1.0
5986,20,1,0,50,50,0.0,1.0
5959,20,1,0,359,359,0.0,1.0
6051,20,1,0,38,38,0.0,1.0
6029,20,1,1,2,3,0.3333333333333333,0.6666666666666666
6070,20,1,0,1,1,0.0,1.0
5942,20,1,0,145,145,0.0,1.0
5953,20,1,1,3,4,0.25,0.75
6076,20,1,0,7,7,0.0,1.0
5940,20,1,3,7,10,0.3,0.7
6109,20,1,0,93,93,0.0,1.0
6187,20,1,0,3,3,0.0,1.0
6053,20,1,0,17,17,0.0,1.0
6104,20,1,0,9,9,0.0,1.0
5943,20,1,1,1,2,0.5,0.5
6017,20,1,3,0,3,1.0,0.0
6168,20,1,5,11,16,0.3125,0.6875
5989,20,1,0,6,6,0.0,1.0
5963,20,1,5,1,6,0.8333333333333334,0.16666666666666666
6194,20,1,0,26,26,0.0,1.0
6167,20,1,0,19,19,0.0,1.0
6004,20,1,1,63,64,0.015625,0.984375
6030,20,1,4,3,7,0.5714285714285714,0.42857142857142855
6054,20,1,2,4,6,0.3333333333333333,0.6666666666666666
6032,20,1,5,7,12,0.4166666666666667,0.5833333333333334
6170,20,1,1,63,64,0.015625,0.984375
6063,20,1,3,0,3,1.0,0.0
5988,20,1,1,0,1,1.0,0.0
6075,20,1,0,3,3,0.0,1.0
6061,20,1,0,67,67,0.0,1.0
5965,20,1,4,45,49,0.08163265306122448,0.9183673469387755
6040,20,1,2,8,10,0.2,0.8
6059,20,1,0,85,85,0.0,1.0
6106,20,1,1,62,63,0.015873015873015872,0.9841269841269841
6031,20,1,2,12,14,0.14285714285714285,0.8571428571428571
6180,20,1,0,6,6,0.0,1.0
6039,20,1,5,58,63,0.07936507936507936,0.9206349206349206
6189,21,1,0,18,18,0.0,1.0
5936,21,1,0,6,6,0.0,1.0
6087,21,1,2,9,11,0.18181818181818182,0.8181818181818182
5973,21,1,0,848,848,0.0,1.0
6085,21,1,1,11,12,0.08333333333333333,0.9166666666666666
6012,21,1,0,62,62,0.0,1.0
5982,21,1,0,6,6,0.0,1.0
5948,21,1,0,57,57,0.0,1.0
5974,21,1,1,5,6,0.16666666666666666,0.8333333333333334
6090,21,1,0,4,4,0.0,1.0
6068,21,1,2,1,3,0.6666666666666666,0.3333333333333333
5962,21,1,0,41,41,0.0,1.0
6033,21,1,0,1,1,0.0,1.0
6038,21,1,2,0,2,1.0,0.0
6042,21,1,2,95,97,0.020618556701030927,0.979381443298969
5924,21,1,1,2,3,0.3333333333333333,0.6666666666666666
6083,21,1,0,27,27,0.0,1.0
6178,21,1,1,17,18,0.05555555555555555,0.9444444444444444
5958,21,1,2,2,4,0.5,0.5
6086,21,1,0,14,14,0.0,1.0
5945,21,1,0,19,19,0.0,1.0
5935,21,1,0,5,5,0.0,1.0
6073,21,1,3,12,15,0.2,0.8
5980,21,1,2,43,45,0.044444444444444446,0.9555555555555556
5993,21,1,3,480,483,0.006211180124223602,0.9937888198757764
6037,21,1,0,223,223,0.0,1.0
5979,21,1,3,2,5,0.6,0.4
5966,21,1,0,73,73,0.0,1.0
5985,21,1,0,3,3,0.0,1.0
5967,21,1,0,76,76,0.0,1.0
6188,21,1,2,20,22,0.09090909090909091,0.9090909090909091
6041,21,1,0,12,12,0.0,1.0
5972,21,1,4,9,13,0.3076923076923077,0.6923076923076923
6069,21,1,1,3,4,0.25,0.75
5937,21,1,1,0,1,1.0,0.0
6028,21,1,1,30,31,0.03225806451612903,0.967741935483871
5990,21,1,0,130,130,0.0,1.0
5928,21,1,0,481,481,0.0,1.0
5992,21,1,2,2,4,0.5,0.5
6058,21,1,2,11,13,0.15384615384615385,0.8461538461538461
6001,21,1,3,26,29,0.10344827586206896,0.896551724137931
5964,21,1,5,26,31,0.16129032258064516,0.8387096774193549
5950,21,1,0,4,4,0.0,1.0
5991,21,1,1,7,8,0.125,0.875
6177,21,1,1,308,309,0.003236245954692557,0.9967637540453075
5961,21,1,0,321,321,0.0,1.0
6176,21,1,0,93,93,0.0,1.0
5956,21,1,0,31,31,0.0,1.0
5938,21,1,3,636,639,0.004694835680751174,0.9953051643192489
6179,21,1,1,27,28,0.03571428571428571,0.9642857142857143
5947,21,1,6,54,60,0.1,0.9
5927,21,1,0,455,455,0.0,1.0
5977,21,1,0,306,306,0.0,1.0
6198,21,1,0,5,5,0.0,1.0
5957,21,1,0,45,45,0.0,1.0
6057,21,1,1,28,29,0.034482758620689655,0.9655172413793104
6043,21,1,3,5,8,0.375,0.625
6077,21,1,0,4,4,0.0,1.0
6014,21,1,1,13,14,0.07142857142857142,0.9285714285714286
6015,21,1,0,3,3,0.0,1.0
5978,21,1,1,2,3,0.3333333333333333,0.6666666666666666
5986,21,1,3,47,50,0.06,0.94
5959,21,1,0,359,359,0.0,1.0
6051,21,1,0,38,38,0.0,1.0
6029,21,1,1,2,3,0.3333333333333333,0.6666666666666666
6070,21,1,0,1,1,0.0,1.0
5942,21,1,0,145,145,0.0,1.0
5953,21,1,1,3,4,0.25,0.75
6076,21,1,0,7,7,0.0,1.0
5940,21,1,0,10,10,0.0,1.0
6109,21,1,0,93,93,0.0,1.0
6187,21,1,0,3,3,0.0,1.0
6053,21,1,0,17,17,0.0,1.0
6104,21,1,2,7,9,0.2222222222222222,0.7777777777777778
5943,21,1,1,1,2,0.5,0.5
6017,21,1,3,0,3,1.0,0.0
6168,21,1,4,12,16,0.25,0.75
5989,21,1,0,6,6,0.0,1.0
5963,21,1,5,1,6,0.8333333333333334,0.16666666666666666
6194,21,1,0,26,26,0.0,1.0
6167,21,1,0,19,19,0.0,1.0
6004,21,1,1,63,64,0.015625,0.984375
6030,21,1,4,3,7,0.5714285714285714,0.42857142857142855
6054,21,1,3,3,6,0.5,0.5
6032,21,1,2,10,12,0.16666666666666666,0.8333333333333334
6170,21,1,0,64,64,0.0,1.0
6063,21,1,3,0,3,1.0,0.0
5988,21,1,1,0,1,1.0,0.0
6075,21,1,0,3,3,0.0,1.0
6061,21,1,0,67,67,0.0,1.0
5965,21,1,2,47,49,0.04081632653061224,0.9591836734693877
6040,21,1,3,7,10,0.3,0.7
6059,21,1,0,85,85,0.0,1.0
6106,21,1,1,62,63,0.015873015873015872,0.9841269841269841
6031,21,1,3,11,14,0.21428571428571427,0.7857142857142857
6180,21,1,0,6,6,0.0,1.0
6039,21,1,4,59,63,0.06349206349206349,0.9365079365079365
6189,22,1,0,18,18,0.0,1.0
5936,22,1,1,5,6,0.16666666666666666,0.8333333333333334
6087,22,1,3,8,11,0.2727272727272727,0.7272727272727273
5973,22,1,0,848,848,0.0,1.0
6085,22,1,1,11,12,0.08333333333333333,0.9166666666666666
6012,22,1,0,62,62,0.0,1.0
5982,22,1,1,5,6,0.16666666666666666,0.8333333333333334
5948,22,1,0,57,57,0.0,1.0
5974,22,1,2,4,6,0.3333333333333333,0.6666666666666666
6090,22,1,0,4,4,0.0,1.0
6068,22,1,2,1,3,0.6666666666666666,0.3333333333333333
5962,22,1,0,41,41,0.0,1.0
6033,22,1,0,1,1,0.0,1.0
6038,22,1,2,0,2,1.0,0.0
6042,22,1,4,93,97,0.041237113402061855,0.9587628865979382
5924,22,1,0,3,3,0.0,1.0
6083,22,1,0,27,27,0.0,1.0
6178,22,1,3,15,18,0.16666666666666666,0.8333333333333334
5958,22,1,3,1,4,0.75,0.25
6086,22,1,0,14,14,0.0,1.0
5945,22,1,1,18,19,0.05263157894736842,0.9473684210526315
5935,22,1,0,5,5,0.0,1.0
6073,22,1,0,15,15,0.0,1.0
5980,22,1,3,42,45,0.06666666666666667,0.9333333333333333
5993,22,1,1,482,483,0.002070393374741201,0.9979296066252588
6037,22,1,0,223,223,0.0,1.0
5979,22,1,2,3,5,0.4,0.6
5966,22,1,0,73,73,0.0,1.0
5985,22,1,0,3,3,0.0,1.0
5967,22,1,0,76,76,0.0,1.0
6188,22,1,0,22,22,0.0,1.0
6041,22,1,0,12,12,0.0,1.0
5972,22,1,6,7,13,0.46153846153846156,0.5384615384615384
6069,22,1,1,3,4,0.25,0.75
5937,22,1,1,0,1,1.0,0.0
6028,22,1,2,29,31,0.06451612903225806,0.9354838709677419
5990,22,1,0,130,130,0.0,1.0
5928,22,1,1,480,481,0.002079002079002079,0.997920997920998
5992,22,1,2,2,4,0.5,0.5
6058,22,1,2,11,13,0.15384615384615385,0.8461538461538461
6001,22,1,3,26,29,0.10344827586206896,0.896551724137931
5964,22,1,4,27,31,0.12903225806451613,0.8709677419354839
5950,22,1,2,2,4,0.5,0.5
5991,22,1,0,8,8,0.0,1.0
6177,22,1,0,309,309,0.0,1.0
5961,22,1,0,321,321,0.0,1.0
6176,22,1,0,93,93,0.0,1.0
5956,22,1,0,31,31,0.0,1.0
5938,22,1,0,639,639,0.0,1.0
6179,22,1,1,27,28,0.03571428571428571,0.9642857142857143
5947,22,1,2,58,60,0.03333333333333333,0.9666666666666667
5927,22,1,1,454,455,0.002197802197802198,0.9978021978021978
5977,22,1,0,306,306,0.0,1.0
6198,22,1,0,5,5,0.0,1.0
5957,22,1,0,45,45,0.0,1.0
6057,22,1,0,29,29,0.0,1.0
6043,22,1,4,4,8,0.5,0.5
6077,22,1,0,4,4,0.0,1.0
6014,22,1,2,12,14,0.14285714285714285,0.8571428571428571
6015,22,1,0,3,3,0.0,1.0
5978,22,1,1,2,3,0.3333333333333333,0.6666666666666666
5986,22,1,1,49,50,0.02,0.98
5959,22,1,0,359,359,0.0,1.0
6051,22,1,0,38,38,0.0,1.0
6029,22,1,1,2,3,0.3333333333333333,0.6666666666666666
6070,22,1,0,1,1,0.0,1.0
5942,22,1,0,145,145,0.0,1.0
5953,22,1,0,4,4,0.0,1.0
6076,22,1,0,7,7,0.0,1.0
5940,22,1,1,9,10,0.1,0.9
6109,22,1,1,92,93,0.010752688172043012,0.989247311827957
6187,22,1,0,3,3,0.0,1.0
6053,22,1,0,17,17,0.0,1.0
6104,22,1,2,7,9,0.2222222222222222,0.7777777777777778
5943,22,1,1,1,2,0.5,0.5
6017,22,1,2,1,3,0.6666666666666666,0.3333333333333333
6168,22,1,0,16,16,0.0,1.0
5989,22,1,2,4,6,0.3333333333333333,0.6666666666666666
5963,22,1,6,0,6,1.0,0.0
6194,22,1,0,26,26,0.0,1.0
6167,22,1,0,19,19,0.0,1.0
6004,22,1,1,63,64,0.015625,0.984375
6030,22,1,5,2,7,0.7142857142857143,0.2857142857142857
6054,22,1,0,6,6,0.0,1.0
6032,22,1,2,10,12,0.16666666666666666,0.8333333333333334
6170,22,1,2,62,64,0.03125,0.96875
6063,22,1,3,0,3,1.0,0.0
5988,22,1,1,0,1,1.0,0.0
6075,22,1,0,3,3,0.0,1.0
6061,22,1,0,67,67,0.0,1.0
5965,22,1,1,48,49,0.02040816326530612,0.9795918367346939
6040,22,1,0,10,10,0.0,1.0
6059,22,1,0,85,85,0.0,1.0
6106,22,1,2,61,63,0.031746031746031744,0.9682539682539683
6031,22,1,3,11,14,0.21428571428571427,0.7857142857142857
6180,22,1,0,6,6,0.0,1.0
6039,22,1,2,61,63,0.031746031746031744,0.9682539682539683
6189,23,1,0,18,18,0.0,1.0
5936,23,1,1,5,6,0.16666666666666666,0.8333333333333334
6087,23,1,3,8,11,0.2727272727272727,0.7272727272727273
5973,23,1,0,848,848,0.0,1.0
6085,23,1,0,12,12,0.0,1.0
6012,23,1,0,62,62,0.0,1.0
5982,23,1,1,5,6,0.16666666666666666,0.8333333333333334
5948,23,1,0,57,57,0.0,1.0
5974,23,1,2,4,6,0.3333333333333333,0.6666666666666666
6090,23,1,0,4,4,0.0,1.0
6068,23,1,2,1,3,0.6666666666666666,0.3333333333333333
5962,23,1,0,41,41,0.0,1.0
6033,23,1,0,1,1,0.0,1.0
6038,23,1,1,1,2,0.5,0.5
6042,23,1,3,94,97,0.030927835051546393,0.9690721649484536
5924,23,1,1,2,3,0.3333333333333333,0.6666666666666666
6083,23,1,0,27,27,0.0,1.0
6178,23,1,2,16,18,0.1111111111111111,0.8888888888888888
5958,23,1,3,1,4,0.75,0.25
6086,23,1,0,14,14,0.0,1.0
5945,23,1,1,18,19,0.05263157894736842,0.9473684210526315
5935,23,1,0,5,5,0.0,1.0
6073,23,1,2,13,15,0.13333333333333333,0.8666666666666667
5980,23,1,1,44,45,0.022222222222222223,0.9777777777777777
5993,23,1,1,482,483,0.002070393374741201,0.9979296066252588
6037,23,1,0,223,223,0.0,1.0
5979,23,1,2,3,5,0.4,0.6
5966,23,1,0,73,73,0.0,1.0
5985,23,1,0,3,3,0.0,1.0
5967,23,1,0,76,76,0.0,1.0
6188,23,1,0,22,22,0.0,1.0
6041,23,1,0,12,12,0.0,1.0
5972,23,1,6,7,13,0.46153846153846156,0.5384615384615384
6069,23,1,1,3,4,0.25,0.75
5937,23,1,1,0,1,1.0,0.0
6028,23,1,4,27,31,0.12903225806451613,0.8709677419354839
5990,23,1,0,130,130,0.0,1.0
5928,23,1,3,478,481,0.006237006237006237,0.9937629937629938
5992,23,1,4,0,4,1.0,0.0
6058,23,1,4,9,13,0.3076923076923077,0.6923076923076923
6001,23,1,1,28,29,0.034482758620689655,0.9655172413793104
5964,23,1,1,30,31,0.03225806451612903,0.967741935483871
5950,23,1,0,4,4,0.0,1.0
5991,23,1,1,7,8,0.125,0.875
6177,23,1,1,308,309,0.003236245954692557,0.9967637540453075
5961,23,1,0,321,321,0.0,1.0
6176,23,1,0,93,93,0.0,1.0
5956,23,1,0,31,31,0.0,1.0
5938,23,1,0,639,639,0.0,1.0
6179,23,1,1,27,28,0.03571428571428571,0.9642857142857143
5947,23,1,4,56,60,0.06666666666666667,0.9333333333333333
5927,23,1,0,455,455,0.0,1.0
5977,23,1,0,306,306,0.0,1.0
6198,23,1,0,5,5,0.0,1.0
5957,23,1,0,45,45,0.0,1.0
6057,23,1,0,29,29,0.0,1.0
6043,23,1,2,6,8,0.25,0.75
6077,23,1,0,4,4,0.0,1.0
6014,23,1,0,14,14,0.0,1.0
6015,23,1,0,3,3,0.0,1.0
5978,23,1,1,2,3,0.3333333333333333,0.6666666666666666
5986,23,1,1,49,50,0.02,0.98
5959,23,1,1,358,359,0.002785515320334262,0.9972144846796658
6051,23,1,0,38,38,0.0,1.0
6029,23,1,0,3,3,0.0,1.0
6070,23,1,0,1,1,0.0,1.0
5942,23,1,0,145,145,0.0,1.0
5953,23,1,1,3,4,0.25,0.75
6076,23,1,0,7,7,0.0,1.0
5940,23,1,0,10,10,0.0,1.0
6109,23,1,0,93,93,0.0,1.0
6187,23,1,1,2,3,0.3333333333333333,0.6666666666666666
6053,23,1,0,17,17,0.0,1.0
6104,23,1,0,9,9,0.0,1.0
5943,23,1,0,2,2,0.0,1.0
6017,23,1,3,0,3,1.0,0.0
6168,23,1,1,15,16,0.0625,0.9375
5989,23,1,0,6,6,0.0,1.0
5963,23,1,5,1,6,0.8333333333333334,0.16666666666666666
6194,23,1,0,26,26,0.0,1.0
6167,23,1,0,19,19,0.0,1.0
6004,23,1,1,63,64,0.015625,0.984375
6030,23,1,3,4,7,0.42857142857142855,0.5714285714285714
6054,23,1,1,5,6,0.16666666666666666,0.8333333333333334
6032,23,1,3,9,12,0.25,0.75
6170,23,1,2,62,64,0.03125,0.96875
6063,23,1,3,0,3,1.0,0.0
5988,23,1,1,0,1,1.0,0.0
6075,23,1,0,3,3,0.0,1.0
6061,23,1,0,67,67,0.0,1.0
5965,23,1,5,44,49,0.10204081632653061,0.8979591836734694
6040,23,1,1,9,10,0.1,0.9
6059,23,1,0,85,85,0.0,1.0
6106,23,1,1,62,63,0.015873015873015872,0.9841269841269841
6031,23,1,1,13,14,0.07142857142857142,0.9285714285714286
6180,23,1,0,6,6,0.0,1.0
6039,23,1,4,59,63,0.06349206349206349,0.9365079365079365
6189,24,1,0,18,18,0.0,1.0
5936,24,1,2,4,6,0.3333333333333333,0.6666666666666666
6087,24,1,1,10,11,0.09090909090909091,0.9090909090909091
5973,24,1,0,848,848,0.0,1.0
6085,24,1,1,11,12,0.08333333333333333,0.9166666666666666
6012,24,1,0,62,62,0.0,1.0
5982,24,1,1,5,6,0.16666666666666666,0.8333333333333334
5948,24,1,0,57,57,0.0,1.0
5974,24,1,1,5,6,0.16666666666666666,0.8333333333333334
6090,24,1,0,4,4,0.0,1.0
6068,24,1,1,2,3,0.3333333333333333,0.6666666666666666
5962,24,1,1,40,41,0.024390243902439025,0.975609756097561
6033,24,1,0,1,1,0.0,1.0
6038,24,1,2,0,2,1.0,0.0
6042,24,1,1,96,97,0.010309278350515464,0.9896907216494846
5924,24,1,1,2,3,0.3333333333333333,0.6666666666666666
6083,24,1,0,27,27,0.0,1.0
6178,24,1,2,16,18,0.1111111111111111,0.8888888888888888
5958,24,1,0,4,4,0.0,1.0
6086,24,1,0,14,14,0.0,1.0
5945,24,1,1,18,19,0.05263157894736842,0.9473684210526315
5935,24,1,0,5,5,0.0,1.0
6073,24,1,1,14,15,0.06666666666666667,0.9333333333333333
5980,24,1,1,44,45,0.022222222222222223,0.9777777777777777
5993,24,1,1,482,483,0.002070393374741201,0.9979296066252588
6037,24,1,0,223,223,0.0,1.0
5979,24,1,3,2,5,0.6,0.4
5966,24,1,0,73,73,0.0,1.0
5985,24,1,0,3,3,0.0,1.0
5967,24,1,0,76,76,0.0,1.0
6188,24,1,0,22,22,0.0,1.0
6041,24,1,0,12,12,0.0,1.0
5972,24,1,3,10,13,0.23076923076923078,0.7692307692307693
6069,24,1,1,3,4,0.25,0.75
5937,24,1,1,0,1,1.0,0.0
6028,24,1,0,31,31,0.0,1.0
5990,24,1,0,130,130,0.0,1.0
5928,24,1,0,481,481,0.0,1.0
5992,24,1,2,2,4,0.5,0.5
6058,24,1,3,10,13,0.23076923076923078,0.7692307692307693
6001,24,1,3,26,29,0.10344827586206896,0.896551724137931
5964,24,1,2,29,31,0.06451612903225806,0.9354838709677419
5950,24,1,2,2,4,0.5,0.5
5991,24,1,0,8,8,0.0,1.0
6177,24,1,0,309,309,0.0,1.0
5961,24,1,0,321,321,0.0,1.0
6176,24,1,0,93,93,0.0,1.0
5956,24,1,0,31,31,0.0,1.0
5938,24,1,1,638,639,0.001564945226917058,0.9984350547730829
6179,24,1,0,28,28,0.0,1.0
5947,24,1,0,60,60,0.0,1.0
5927,24,1,1,454,455,0.002197802197802198,0.9978021978021978
5977,24,1,0,306,306,0.0,1.0
6198,24,1,0,5,5,0.0,1.0
5957,24,1,0,45,45,0.0,1.0
6057,24,1,0,29,29,0.0,1.0
6043,24,1,3,5,8,0.375,0.625
6077,24,1,0,4,4,0.0,1.0
6014,24,1,1,13,14,0.07142857142857142,0.9285714285714286
6015,24,1,0,3,3,0.0,1.0
5978,24,1,1,2,3,0.3333333333333333,0.6666666666666666
5986,24,1,0,50,50,0.0,1.0
5959,24,1,0,359,359,0.0,1.0
6051,24,1,4,34,38,0.10526315789473684,0.8947368421052632
6029,24,1,0,3,3,0.0,1.0
6070,24,1,0,1,1,0.0,1.0
5942,24,1,0,145,145,0.0,1.0
5953,24,1,1,3,4,0.25,0.75
6076,24,1,0,7,7,0.0,1.0
5940,24,1,2,8,10,0.2,0.8
6109,24,1,1,92,93,0.010752688172043012,0.989247311827957
6187,24,1,0,3,3,0.0,1.0
6053,24,1,0,17,17,0.0,1.0
6104,24,1,0,9,9,0.0,1.0
5943,24,1,0,2,2,0.0,1.0
6017,24,1,2,1,3,0.6666666666666666,0.3333333333333333
6168,24,1,2,14,16,0.125,0.875
5989,24,1,0,6,6,0.0,1.0
5963,24,1,5,1,6,0.8333333333333334,0.16666666666666666
6194,24,1,0,26,26,0.0,1.0
6167,24,1,0,19,19,0.0,1.0
6004,24,1,0,64,64,0.0,1.0
6030,24,1,5,2,7,0.7142857142857143,0.2857142857142857
6054,24,1,0,6,6,0.0,1.0
6032,24,1,6,6,12,0.5,0.5
6170,24,1,0,64,64,0.0,1.0
6063,24,1,1,2,3,0.3333333333333333,0.6666666666666666
5988,24,1,1,0,1,1.0,0.0
6075,24,1,0,3,3,0.0,1.0
6061,24,1,0,67,67,0.0,1.0
5965,24,1,0,49,49,0.0,1.0
6040,24,1,3,7,10,0.3,0.7
6059,24,1,0,85,85,0.0,1.0
6106,24,1,1,62,63,0.015873015873015872,0.9841269841269841
6031,24,1,3,11,14,0.21428571428571427,0.7857142857142857
6180,24,1,0,6,6,0.0,1.0
6039,24,1,2,61,63,0.031746031746031744,0.9682539682539683
6189,25,1,0,18,18,0.0,1.0
5936,25,1,1,5,6,0.16666666666666666,0.8333333333333334
6087,25,1,0,11,11,0.0,1.0
5973,25,1,0,848,848,0.0,1.0
6085,25,1,2,10,12,0.16666666666666666,0.8333333333333334
6012,25,1,0,62,62,0.0,1.0
5982,25,1,1,5,6,0.16666666666666666,0.8333333333333334
5948,25,1,0,57,57,0.0,1.0
5974,25,1,2,4,6,0.3333333333333333,0.6666666666666666
6090,25,1,0,4,4,0.0,1.0
6068,25,1,1,2,3,0.3333333333333333,0.6666666666666666
5962,25,1,1,40,41,0.024390243902439025,0.975609756097561
6033,25,1,0,1,1,0.0,1.0
6038,25,1,1,1,2,0.5,0.5
6042,25,1,3,94,97,0.030927835051546393,0.9690721649484536
5924,25,1,1,2,3,0.3333333333333333,0.6666666666666666
6083,25,1,0,27,27,0.0,1.0
6178,25,1,1,17,18,0.05555555555555555,0.9444444444444444
5958,25,1,1,3,4,0.25,0.75
6086,25,1,0,14,14,0.0,1.0
5945,25,1,0,19,19,0.0,1.0
5935,25,1,1,4,5,0.2,0.8
6073,25,1,1,14,15,0.06666666666666667,0.9333333333333333
5980,25,1,0,45,45,0.0,1.0
5993,25,1,1,482,483,0.002070393374741201,0.9979296066252588
6037,25,1,0,223,223,0.0,1.0
5979,25,1,2,3,5,0.4,0.6
5966,25,1,0,73,73,0.0,1.0
5985,25,1,0,3,3,0.0,1.0
5967,25,1,0,76,76,0.0,1.0
6188,25,1,0,22,22,0.0,1.0
6041,25,1,0,12,12,0.0,1.0
5972,25,1,3,10,13,0.23076923076923078,0.7692307692307693
6069,25,1,1,3,4,0.25,0.75
5937,25,1,1,0,1,1.0,0.0
6028,25,1,2,29,31,0.06451612903225806,0.9354838709677419
5990,25,1,0,130,130,0.0,1.0
5928,25,1,0,481,481,0.0,1.0
5992,25,1,3,1,4,0.75,0.25
6058,25,1,2,11,13,0.15384615384615385,0.8461538461538461
6001,25,1,1,28,29,0.034482758620689655,0.9655172413793104
5964,25,1,2,29,31,0.06451612903225806,0.9354838709677419
5950,25,1,0,4,4,0.0,1.0
5991,25,1,1,7,8,0.125,0.875
6177,25,1,0,309,309,0.0,1.0
5961,25,1,0,321,321,0.0,1.0
6176,25,1,0,93,93,0.0,1.0
5956,25,1,0,31,31,0.0,1.0
5938,25,1,0,639,639,0.0,1.0
6179,25,1,0,28,28,0.0,1.0
5947,25,1,0,60,60,0.0,1.0
5927,25,1,1,454,455,0.002197802197802198,0.9978021978021978
5977,25,1,0,306,306,0.0,1.0
6198,25,1,0,5,5,0.0,1.0
5957,25,1,0,45,45,0.0,1.0
6057,25,1,0,29,29,0.0,1.0
6043,25,1,1,7,8,0.125,0.875
6077,25,1,0,4,4,0.0,1.0
6014,25,1,1,13,14,0.07142857142857142,0.9285714285714286
6015,25,1,0,3,3,0.0,1.0
5978,25,1,1,2,3,0.3333333333333333,0.6666666666666666
5986,25,1,3,47,50,0.06,0.94
5959,25,1,0,359,359,0.0,1.0
6051,25,1,0,38,38,0.0,1.0
6029,25,1,0,3,3,0.0,1.0
6070,25,1,0,1,1,0.0,1.0
5942,25,1,0,145,145,0.0,1.0
5953,25,1,3,1,4,0.75,0.25
6076,25,1,0,7,7,0.0,1.0
5940,25,1,0,10,10,0.0,1.0
6109,25,1,1,92,93,0.010752688172043012,0.989247311827957
6187,25,1,0,3,3,0.0,1.0
6053,25,1,0,17,17,0.0,1.0
6104,25,1,0,9,9,0.0,1.0
5943,25,1,1,1,2,0.5,0.5
6017,25,1,1,2,3,0.3333333333333333,0.6666666666666666
6168,25,1,2,14,16,0.125,0.875
5989,25,1,0,6,6,0.0,1.0
5963,25,1,5,1,6,0.8333333333333334,0.16666666666666666
6194,25,1,0,26,26,0.0,1.0
6167,25,1,0,19,19,0.0,1.0
6004,25,1,1,63,64,0.015625,0.984375
6030,25,1,3,4,7,0.42857142857142855,0.5714285714285714
6054,25,1,0,6,6,0.0,1.0
6032,25,1,1,11,12,0.08333333333333333,0.9166666666666666
6170,25,1,1,63,64,0.015625,0.984375
6063,25,1,1,2,3,0.3333333333333333,0.6666666666666666
5988,25,1,1,0,1,1.0,0.0
6075,25,1,0,3,3,0.0,1.0
6061,25,1,0,67,67,0.0,1.0
5965,25,1,0,49,49,0.0,1.0
6040,25,1,1,9,10,0.1,0.9
6059,25,1,0,85,85,0.0,1.0
6106,25,1,1,62,63,0.015873015873015872,0.9841269841269841
6031,25,1,4,10,14,0.2857142857142857,0.7142857142857143
6180,25,1,0,6,6,0.0,1.0
6039,25,1,2,61,63,0.031746031746031744,0.9682539682539683
6189,26,1,0,18,18,0.0,1.0
5936,26,1,1,5,6,0.16666666666666666,0.8333333333333334
6087,26,1,1,10,11,0.09090909090909091,0.9090909090909091
5973,26,1,1,847,848,0.0011792452830188679,0.9988207547169812
6085,26,1,0,12,12,0.0,1.0
6012,26,1,0,62,62,0.0,1.0
5982,26,1,0,6,6,0.0,1.0
5948,26,1,0,57,57,0.0,1.0
5974,26,1,2,4,6,0.3333333333333333,0.6666666666666666
6090,26,1,0,4,4,0.0,1.0
6068,26,1,1,2,3,0.3333333333333333,0.6666666666666666
5962,26,1,0,41,41,0.0,1.0
6033,26,1,0,1,1,0.0,1.0
6038,26,1,1,1,2,0.5,0.5
6042,26,1,0,97,97,0.0,1.0
5924,26,1,0,3,3,0.0,1.0
6083,26,1,0,27,27,0.0,1.0
6178,26,1,2,16,18,0.1111111111111111,0.8888888888888888
5958,26,1,2,2,4,0.5,0.5
6086,26,1,0,14,14,0.0,1.0
5945,26,1,1,18,19,0.05263157894736842,0.9473684210526315
5935,26,1,2,3,5,0.4,0.6
6073,26,1,0,15,15,0.0,1.0
5980,26,1,1,44,45,0.022222222222222223,0.9777777777777777
5993,26,1,2,481,483,0.004140786749482402,0.9958592132505176
6037,26,1,0,223,223,0.0,1.0
5979,26,1,1,4,5,0.2,0.8
5966,26,1,0,73,73,0.0,1.0
5985,26,1,0,3,3,0.0,1.0
5967,26,1,0,76,76,0.0,1.0
6188,26,1,1,21,22,0.045454545454545456,0.9545454545454546
6041,26,1,0,12,12,0.0,1.0
5972,26,1,3,10,13,0.23076923076923078,0.7692307692307693
6069,26,1,1,3,4,0.25,0.75
5937,26,1,1,0,1,1.0,0.0
6028,26,1,3,28,31,0.0967741935483871,0.9032258064516129
5990,26,1,0,130,130,0.0,1.0
5928,26,1,1,480,481,0.002079002079002079,0.997920997920998
5992,26,1,2,2,4,0.5,0.5
6058,26,1,1,12,13,0.07692307692307693,0.9230769230769231
6001,26,1,1,28,29,0.034482758620689655,0.9655172413793104
5964,26,1,2,29,31,0.06451612903225806,0.9354838709677419
5950,26,1,2,2,4,0.5,0.5
5991,26,1,1,7,8,0.125,0.875
6177,26,1,0,309,309,0.0,1.0
5961,26,1,0,321,321,0.0,1.0
6176,26,1,0,93,93,0.0,1.0
5956,26,1,0,31,31,0.0,1.0
5938,26,1,0,639,639,0.0,1.0
6179,26,1,0,28,28,0.0,1.0
5947,26,1,1,59,60,0.016666666666666666,0.9833333333333333
5927,26,1,0,455,455,0.0,1.0
5977,26,1,0,306,306,0.0,1.0
6198,26,1,0,5,5,0.0,1.0
5957,26,1,0,45,45,0.0,1.0
6057,26,1,0,29,29,0.0,1.0
6043,26,1,1,7,8,0.125,0.875
6077,26,1,0,4,4,0.0,1.0
6014,26,1,0,14,14,0.0,1.0
6015,26,1,0,3,3,0.0,1.0
5978,26,1,2,1,3,0.6666666666666666,0.3333333333333333
5986,26,1,2,48,50,0.04,0.96
5959,26,1,2,357,359,0.005571030640668524,0.9944289693593314
6051,26,1,0,38,38,0.0,1.0
6029,26,1,0,3,3,0.0,1.0
6070,26,1,0,1,1,0.0,1.0
5942,26,1,0,145,145,0.0,1.0
5953,26,1,1,3,4,0.25,0.75
6076,26,1,0,7,7,0.0,1.0
5940,26,1,0,10,10,0.0,1.0
6109,26,1,0,93,93,0.0,1.0
6187,26,1,0,3,3,0.0,1.0
6053,26,1,0,17,17,0.0,1.0
6104,26,1,3,6,9,0.3333333333333333,0.6666666666666666
5943,26,1,1,1,2,0.5,0.5
6017,26,1,1,2,3,0.3333333333333333,0.6666666666666666
6168,26,1,1,15,16,0.0625,0.9375
5989,26,1,0,6,6,0.0,1.0
5963,26,1,6,0,6,1.0,0.0
6194,26,1,0,26,26,0.0,1.0
6167,26,1,1,18,19,0.05263157894736842,0.9473684210526315
6004,26,1,0,64,64,0.0,1.0
6030,26,1,5,2,7,0.7142857142857143,0.2857142857142857
6054,26,1,1,5,6,0.16666666666666666,0.8333333333333334
6032,26,1,1,11,12,0.08333333333333333,0.9166666666666666
6170,26,1,3,61,64,0.046875,0.953125
6063,26,1,2,1,3,0.6666666666666666,0.3333333333333333
5988,26,1,1,0,1,1.0,0.0
6075,26,1,0,3,3,0.0,1.0
6061,26,1,0,67,67,0.0,1.0
5965,26,1,2,47,49,0.04081632653061224,0.9591836734693877
6040,26,1,2,8,10,0.2,0.8
6059,26,1,0,85,85,0.0,1.0
6106,26,1,1,62,63,0.015873015873015872,0.9841269841269841
6031,26,1,3,11,14,0.21428571428571427,0.7857142857142857
6180,26,1,0,6,6,0.0,1.0
6039,26,1,1,62,63,0.015873015873015872,0.9841269841269841
6189,27,1,0,18,18,0.0,1.0
5936,27,1,0,6,6,0.0,1.0
6087,27,1,0,11,11,0.0,1.0
5973,27,1,0,848,848,0.0,1.0
6085,27,1,1,11,12,0.08333333333333333,0.9166666666666666
6012,27,1,0,62,62,0.0,1.0
5982,27,1,0,6,6,0.0,1.0
5948,27,1,0,57,57,0.0,1.0
5974,27,1,1,5,6,0.16666666666666666,0.8333333333333334
6090,27,1,0,4,4,0.0,1.0
6068,27,1,1,2,3,0.3333333333333333,0.6666666666666666
5962,27,1,1,40,41,0.024390243902439025,0.975609756097561
6033,27,1,0,1,1,0.0,1.0
6038,27,1,2,0,2,1.0,0.0
6042,27,1,0,97,97,0.0,1.0
5924,27,1,0,3,3,0.0,1.0
6083,27,1,0,27,27,0.0,1.0
6178,27,1,5,13,18,0.2777777777777778,0.7222222222222222
5958,27,1,2,2,4,0.5,0.5
6086,27,1,0,14,14,0.0,1.0
5945,27,1,0,19,19,0.0,1.0
5935,27,1,1,4,5,0.2,0.8
6073,27,1,0,15,15,0.0,1.0
5980,27,1,1,44,45,0.022222222222222223,0.9777777777777777
5993,27,1,2,481,483,0.004140786749482402,0.9958592132505176
6037,27,1,0,223,223,0.0,1.0
5979,27,1,2,3,5,0.4,0.6
5966,27,1,0,73,73,0.0,1.0
5985,27,1,0,3,3,0.0,1.0
5967,27,1,0,76,76,0.0,1.0
6188,27,1,1,21,22,0.045454545454545456,0.9545454545454546
6041,27,1,0,12,12,0.0,1.0
5972,27,1,3,10,13,0.23076923076923078,0.7692307692307693
6069,27,1,2,2,4,0.5,0.5
5937,27,1,1,0,1,1.0,0.0
6028,27,1,1,30,31,0.03225806451612903,0.967741935483871
5990,27,1,0,130,130,0.0,1.0
5928,27,1,0,481,481,0.0,1.0
5992,27,1,2,2,4,0.5,0.5
6058,27,1,1,12,13,0.07692307692307693,0.9230769230769231
6001,27,1,0,29,29,0.0,1.0
5964,27,1,3,28,31,0.0967741935483871,0.9032258064516129
5950,27,1,0,4,4,0.0,1.0
5991,27,1,0,8,8,0.0,1.0
6177,27,1,0,309,309,0.0,1.0
5961,27,1,0,321,321,0.0,1.0
6176,27,1,0,93,93,0.0,1.0
5956,27,1,0,31,31,0.0,1.0
5938,27,1,0,639,639,0.0,1.0
6179,27,1,1,27,28,0.03571428571428571,0.9642857142857143
5947,27,1,3,57,60,0.05,0.95
5927,27,1,0,455,455,0.0,1.0
5977,27,1,0,306,306,0.0,1.0
6198,27,1,0,5,5,0.0,1.0
5957,27,1,0,45,45,0.0,1.0
6057,27,1,0,29,29,0.0,1.0
6043,27,1,1,7,8,0.125,0.875
6077,27,1,0,4,4,0.0,1.0
6014,27,1,3,11,14,0.21428571428571427,0.7857142857142857
6015,27,1,0,3,3,0.0,1.0
5978,27,1,1,2,3,0.3333333333333333,0.6666666666666666
5986,27,1,0,50,50,0.0,1.0
5959,27,1,0,359,359,0.0,1.0
6051,27,1,0,38,38,0.0,1.0
6029,27,1,0,3,3,0.0,1.0
6070,27,1,0,1,1,0.0,1.0
5942,27,1,0,145,145,0.0,1.0
5953,27,1,1,3,4,0.25,0.75
6076,27,1,0,7,7,0.0,1.0
5940,27,1,0,10,10,0.0,1.0
6109,27,1,0,93,93,0.0,1.0
6187,27,1,0,3,3,0.0,1.0
6053,27,1,0,17,17,0.0,1.0
6104,27,1,1,8,9,0.1111111111111111,0.8888888888888888
5943,27,1,0,2,2,0.0,1.0
6017,27,1,1,2,3,0.3333333333333333,0.6666666666666666
6168,27,1,1,15,16,0.0625,0.9375
5989,27,1,0,6,6,0.0,1.0
5963,27,1,5,1,6,0.8333333333333334,0.16666666666666666
6194,27,1,0,26,26,0.0,1.0
6167,27,1,1,18,19,0.05263157894736842,0.9473684210526315
6004,27,1,0,64,64,0.0,1.0
6030,27,1,4,3,7,0.5714285714285714,0.42857142857142855
6054,27,1,0,6,6,0.0,1.0
6032,27,1,2,10,12,0.16666666666666666,0.8333333333333334
6170,27,1,2,62,64,0.03125,0.96875
6063,27,1,2,1,3,0.6666666666666666,0.3333333333333333
5988,27,1,1,0,1,1.0,0.0
6075,27,1,0,3,3,0.0,1.0
6061,27,1,0,67,67,0.0,1.0
5965,27,1,0,49,49,0.0,1.0
6040,27,1,1,9,10,0.1,0.9
6059,27,1,0,85,85,0.0,1.0
6106,27,1,1,62,63,0.015873015873015872,0.9841269841269841
6031,27,1,3,11,14,0.21428571428571427,0.7857142857142857
6180,27,1,0,6,6,0.0,1.0
6039,27,1,1,62,63,0.015873015873015872,0.9841269841269841
6189,28,1,0,18,18,0.0,1.0
5936,28,1,1,5,6,0.16666666666666666,0.8333333333333334
6087,28,1,1,10,11,0.09090909090909091,0.9090909090909091
5973,28,1,0,848,848,0.0,1.0
6085,28,1,2,10,12,0.16666666666666666,0.8333333333333334
6012,28,1,0,62,62,0.0,1.0
5982,28,1,0,6,6,0.0,1.0
5948,28,1,0,57,57,0.0,1.0
5974,28,1,1,5,6,0.16666666666666666,0.8333333333333334
6090,28,1,0,4,4,0.0,1.0
6068,28,1,3,0,3,1.0,0.0
5962,28,1,0,41,41,0.0,1.0
6033,28,1,0,1,1,0.0,1.0
6038,28,1,2,0,2,1.0,0.0
6042,28,1,3,94,97,0.030927835051546393,0.9690721649484536
5924,28,1,0,3,3,0.0,1.0
6083,28,1,0,27,27,0.0,1.0
6178,28,1,1,17,18,0.05555555555555555,0.9444444444444444
5958,28,1,1,3,4,0.25,0.75
6086,28,1,0,14,14,0.0,1.0
5945,28,1,2,17,19,0.10526315789473684,0.8947368421052632
5935,28,1,1,4,5,0.2,0.8
6073,28,1,2,13,15,0.13333333333333333,0.8666666666666667
5980,28,1,1,44,45,0.022222222222222223,0.9777777777777777
5993,28,1,2,481,483,0.004140786749482402,0.9958592132505176
6037,28,1,0,223,223,0.0,1.0
5979,28,1,1,4,5,0.2,0.8
5966,28,1,0,73,73,0.0,1.0
5985,28,1,0,3,3,0.0,1.0
5967,28,1,0,76,76,0.0,1.0
6188,28,1,0,22,22,0.0,1.0
6041,28,1,0,12,12,0.0,1.0
5972,28,1,7,6,13,0.5384615384615384,0.46153846153846156
6069,28,1,1,3,4,0.25,0.75
5937,28,1,1,0,1,1.0,0.0
6028,28,1,0,31,31,0.0,1.0
5990,28,1,0,130,130,0.0,1.0
5928,28,1,1,480,481,0.002079002079002079,0.997920997920998
5992,28,1,3,1,4,0.75,0.25
6058,28,1,2,11,13,0.15384615384615385,0.8461538461538461
6001,28,1,2,27,29,0.06896551724137931,0.9310344827586207
5964,28,1,2,29,31,0.06451612903225806,0.9354838709677419
5950,28,1,2,2,4,0.5,0.5
5991,28,1,1,7,8,0.125,0.875
6177,28,1,0,309,309,0.0,1.0
5961,28,1,0,321,321,0.0,1.0
6176,28,1,0,93,93,0.0,1.0
5956,28,1,0,31,31,0.0,1.0
5938,28,1,0,639,639,0.0,1.0
6179,28,1,1,27,28,0.03571428571428571,0.9642857142857143
5947,28,1,4,56,60,0.06666666666666667,0.9333333333333333
5927,28,1,0,455,455,0.0,1.0
5977,28,1,0,306,306,0.0,1.0
6198,28,1,0,5,5,0.0,1.0
5957,28,1,0,45,45,0.0,1.0
6057,28,1,0,29,29,0.0,1.0
6043,28,1,1,7,8,0.125,0.875
6077,28,1,0,4,4,0.0,1.0
6014,28,1,0,14,14,0.0,1.0
6015,28,1,0,3,3,0.0,1.0
5978,28,1,1,2,3,0.3333333333333333,0.6666666666666666
5986,28,1,0,50,50,0.0,1.0
5959,28,1,1,358,359,0.002785515320334262,0.9972144846796658
6051,28,1,0,38,38,0.0,1.0
6029,28,1,0,3,3,0.0,1.0
6070,28,1,0,1,1,0.0,1.0
5942,28,1,0,145,145,0.0,1.0
5953,28,1,0,4,4,0.0,1.0
6076,28,1,0,7,7,0.0,1.0
5940,28,1,1,9,10,0.1,0.9
6109,28,1,0,93,93,0.0,1.0
6187,28,1,0,3,3,0.0,1.0
6053,28,1,0,17,17,0.0,1.0
6104,28,1,0,9,9,0.0,1.0
5943,28,1,1,1,2,0.5,0.5
6017,28,1,2,1,3,0.6666666666666666,0.3333333333333333
6168,28,1,1,15,16,0.0625,0.9375
5989,28,1,0,6,6,0.0,1.0
5963,28,1,5,1,6,0.8333333333333334,0.16666666666666666
6194,28,1,0,26,26,0.0,1.0
6167,28,1,0,19,19,0.0,1.0
6004,28,1,0,64,64,0.0,1.0
6030,28,1,5,2,7,0.7142857142857143,0.2857142857142857
6054,28,1,0,6,6,0.0,1.0
6032,28,1,2,10,12,0.16666666666666666,0.8333333333333334
6170,28,1,2,62,64,0.03125,0.96875
6063,28,1,2,1,3,0.6666666666666666,0.3333333333333333
5988,28,1,1,0,1,1.0,0.0
6075,28,1,0,3,3,0.0,1.0
6061,28,1,0,67,67,0.0,1.0
5965,28,1,0,49,49,0.0,1.0
6040,28,1,1,9,10,0.1,0.9
6059,28,1,0,85,85,0.0,1.0
6106,28,1,0,63,63,0.0,1.0
6031,28,1,4,10,14,0.2857142857142857,0.7142857142857143
6180,28,1,0,6,6,0.0,1.0
6039,28,1,2,61,63,0.031746031746031744,0.9682539682539683
6189,29,1,0,18,18,0.0,1.0
5936,29,1,0,6,6,0.0,1.0
6087,29,1,2,9,11,0.18181818181818182,0.8181818181818182
5973,29,1,0,848,848,0.0,1.0
6085,29,1,0,12,12,0.0,1.0
6012,29,1,0,62,62,0.0,1.0
5982,29,1,1,5,6,0.16666666666666666,0.8333333333333334
5948,29,1,0,57,57,0.0,1.0
5974,29,1,1,5,6,0.16666666666666666,0.8333333333333334
6090,29,1,0,4,4,0.0,1.0
6068,29,1,2,1,3,0.6666666666666666,0.3333333333333333
5962,29,1,1,40,41,0.024390243902439025,0.975609756097561
6033,29,1,0,1,1,0.0,1.0
6038,29,1,1,1,2,0.5,0.5
6042,29,1,1,96,97,0.010309278350515464,0.9896907216494846
5924,29,1,1,2,3,0.3333333333333333,0.6666666666666666
6083,29,1,0,27,27,0.0,1.0
6178,29,1,2,16,18,0.1111111111111111,0.8888888888888888
5958,29,1,2,2,4,0.5,0.5
6086,29,1,0,14,14,0.0,1.0
5945,29,1,1,18,19,0.05263157894736842,0.9473684210526315
5935,29,1,0,5,5,0.0,1.0
6073,29,1,1,14,15,0.06666666666666667,0.9333333333333333
5980,29,1,0,45,45,0.0,1.0
5993,29,1,3,480,483,0.006211180124223602,0.9937888198757764
6037,29,1,0,223,223,0.0,1.0
5979,29,1,0,5,5,0.0,1.0
5966,29,1,0,73,73,0.0,1.0
5985,29,1,0,3,3,0.0,1.0
5967,29,1,0,76,76,0.0,1.0
6188,29,1,0,22,22,0.0,1.0
6041,29,1,0,12,12,0.0,1.0
5972,29,1,2,11,13,0.15384615384615385,0.8461538461538461
6069,29,1,1,3,4,0.25,0.75
5937,29,1,1,0,1,1.0,0.0
6028,29,1,1,30,31,0.03225806451612903,0.967741935483871
5990,29,1,0,130,130,0.0,1.0
5928,29,1,1,480,481,0.002079002079002079,0.997920997920998
5992,29,1,1,3,4,0.25,0.75
6058,29,1,1,12,13,0.07692307692307693,0.9230769230769231
6001,29,1,0,29,29,0.0,1.0
5964,29,1,2,29,31,0.06451612903225806,0.9354838709677419
5950,29,1,0,4,4,0.0,1.0
5991,29,1,0,8,8,0.0,1.0
6177,29,1,0,309,309,0.0,1.0
5961,29,1,0,321,321,0.0,1.0
6176,29,1,0,93,93,0.0,1.0
5956,29,1,0,31,31,0.0,1.0
5938,29,1,0,639,639,0.0,1.0
6179,29,1,0,28,28,0.0,1.0
5947,29,1,2,58,60,0.03333333333333333,0.9666666666666667
5927,29,1,0,455,455,0.0,1.0
5977,29,1,0,306,306,0.0,1.0
6198,29,1,0,5,5,0.0,1.0
5957,29,1,0,45,45,0.0,1.0
6057,29,1,0,29,29,0.0,1.0
6043,29,1,2,6,8,0.25,0.75
6077,29,1,0,4,4,0.0,1.0
6014,29,1,1,13,14,0.07142857142857142,0.9285714285714286
6015,29,1,0,3,3,0.0,1.0
5978,29,1,1,2,3,0.3333333333333333,0.6666666666666666
5986,29,1,0,50,50,0.0,1.0
5959,29,1,1,358,359,0.002785515320334262,0.9972144846796658
6051,29,1,0,38,38,0.0,1.0
6029,29,1,0,3,3,0.0,1.0
6070,29,1,0,1,1,0.0,1.0
5942,29,1,0,145,145,0.0,1.0
5953,29,1,1,3,4,0.25,0.75
6076,29,1,0,7,7,0.0,1.0
5940,29,1,0,10,10,0.0,1.0
6109,29,1,0,93,93,0.0,1.0
6187,29,1,0,3,3,0.0,1.0
6053,29,1,0,17,17,0.0,1.0
6104,29,1,0,9,9,0.0,1.0
5943,29,1,1,1,2,0.5,0.5
6017,29,1,2,1,3,0.6666666666666666,0.3333333333333333
6168,29,1,0,16,16,0.0,1.0
5989,29,1,0,6,6,0.0,1.0
5963,29,1,5,1,6,0.8333333333333334,0.16666666666666666
6194,29,1,0,26,26,0.0,1.0
6167,29,1,1,18,19,0.05263157894736842,0.9473684210526315
6004,29,1,0,64,64,0.0,1.0
6030,29,1,5,2,7,0.7142857142857143,0.2857142857142857
6054,29,1,0,6,6,0.0,1.0
6032,29,1,2,10,12,0.16666666666666666,0.8333333333333334
6170,29,1,2,62,64,0.03125,0.96875
6063,29,1,1,2,3,0.3333333333333333,0.6666666666666666
5988,29,1,1,0,1,1.0,0.0
6075,29,1,0,3,3,0.0,1.0
6061,29,1,0,67,67,0.0,1.0
5965,29,1,0,49,49,0.0,1.0
6040,29,1,0,10,10,0.0,1.0
6059,29,1,0,85,85,0.0,1.0
6106,29,1,2,61,63,0.031746031746031744,0.9682539682539683
6031,29,1,3,11,14,0.21428571428571427,0.7857142857142857
6180,29,1,0,6,6,0.0,1.0
6039,29,1,1,62,63,0.015873015873015872,0.9841269841269841
6189,0,2,0,18,18,0.0,1.0
5936,0,2,6,0,6,1.0,0.0
6087,0,2,3,8,11,0.2727272727272727,0.7272727272727273
5973,0,2,2,846,848,0.0023584905660377358,0.9976415094339622
6085,0,2,12,0,12,1.0,0.0
6012,0,2,0,62,62,0.0,1.0
5982,0,2,0,6,6,0.0,1.0
5948,0,2,0,57,57,0.0,1.0
5974,0,2,6,0,6,1.0,0.0
6090,0,2,0,4,4,0.0,1.0
6068,0,2,3,0,3,1.0,0.0
5962,0,2,36,5,41,0.8780487804878049,0.12195121951219512
6033,0,2,1,0,1,1.0,0.0
6038,0,2,2,0,2,1.0,0.0
6042,0,2,85,12,97,0.8762886597938144,0.12371134020618557
5924,0,2,3,0,3,1.0,0.0
6083,0,2,0,27,27,0.0,1.0
6178,0,2,18,0,18,1.0,0.0
5958,0,2,4,0,4,1.0,0.0
6086,0,2,0,14,14,0.0,1.0
5945,0,2,18,1,19,0.9473684210526315,0.05263157894736842
5935,0,2,5,0,5,1.0,0.0
6073,0,2,14,1,15,0.9333333333333333,0.06666666666666667
5980,0,2,45,0,45,1.0,0.0
5993,0,2,163,320,483,0.33747412008281574,0.6625258799171843
6037,0,2,165,58,223,0.7399103139013453,0.2600896860986547
5979,0,2,5,0,5,1.0,0.0
5966,0,2,0,73,73,0.0,1.0
5985,0,2,3,0,3,1.0,0.0
5967,0,2,0,76,76,0.0,1.0
6188,0,2,21,1,22,0.9545454545454546,0.045454545454545456
6041,0,2,0,12,12,0.0,1.0
5972,0,2,13,0,13,1.0,0.0
6069,0,2,1,3,4,0.25,0.75
5937,0,2,1,0,1,1.0,0.0
6028,0,2,31,0,31,1.0,0.0
5990,0,2,0,130,130,0.0,1.0
5928,0,2,239,242,481,0.4968814968814969,0.5031185031185031
5992,0,2,4,0,4,1.0,0.0
6058,0,2,13,0,13,1.0,0.0
6001,0,2,28,1,29,0.9655172413793104,0.034482758620689655
5964,0,2,30,1,31,0.967741935483871,0.03225806451612903
5950,0,2,4,0,4,1.0,0.0
5991,0,2,8,0,8,1.0,0.0
6177,0,2,244,65,309,0.7896440129449838,0.21035598705501618
5961,0,2,0,321,321,0.0,1.0
6176,0,2,0,93,93,0.0,1.0
5956,0,2,0,31,31,0.0,1.0
5938,0,2,66,573,639,0.10328638497652583,0.8967136150234741
6179,0,2,28,0,28,1.0,0.0
5947,0,2,53,7,60,0.8833333333333333,0.11666666666666667
5927,0,2,8,447,455,0.017582417582417582,0.9824175824175824
5977,0,2,7,299,306,0.02287581699346405,0.9771241830065359
6198,0,2,0,5,5,0.0,1.0
5957,0,2,0,45,45,0.0,1.0
6057,0,2,29,0,29,1.0,0.0
6043,0,2,8,0,8,1.0,0.0
6077,0,2,0,4,4,0.0,1.0
6014,0,2,14,0,14,1.0,0.0
6015,0,2,3,0,3,1.0,0.0
5978,0,2,3,0,3,1.0,0.0
5986,0,2,13,37,50,0.26,0.74
5959,0,2,264,95,359,0.7353760445682451,0.2646239554317549
6051,0,2,30,8,38,0.7894736842105263,0.21052631578947367
6029,0,2,3,0,3,1.0,0.0
6070,0,2,1,0,1,1.0,0.0
5942,0,2,0,145,145,0.0,1.0
5953,0,2,4,0,4,1.0,0.0
6076,0,2,7,0,7,1.0,0.0
5940,0,2,10,0,10,1.0,0.0
6109,0,2,82,11,93,0.8817204301075269,0.11827956989247312
6187,0,2,3,0,3,1.0,0.0
6053,0,2,0,17,17,0.0,1.0
6104,0,2,9,0,9,1.0,0.0
5943,0,2,2,0,2,1.0,0.0
6017,0,2,3,0,3,1.0,0.0
6168,0,2,13,3,16,0.8125,0.1875
5989,0,2,5,1,6,0.8333333333333334,0.16666666666666666
5963,0,2,6,0,6,1.0,0.0
6194,0,2,0,26,26,0.0,1.0
6167,0,2,18,1,19,0.9473684210526315,0.05263157894736842
6004,0,2,0,64,64,0.0,1.0
6030,0,2,6,1,7,0.8571428571428571,0.14285714285714285
6054,0,2,6,0,6,1.0,0.0
6032,0,2,12,0,12,1.0,0.0
6170,0,2,61,3,64,0.953125,0.046875
6063,0,2,3,0,3,1.0,0.0
5988,0,2,1,0,1,1.0,0.0
6075,0,2,3,0,3,1.0,0.0
6061,0,2,0,67,67,0.0,1.0
5965,0,2,46,3,49,0.9387755102040817,0.061224489795918366
6040,0,2,10,0,10,1.0,0.0
6059,0,2,0,85,85,0.0,1.0
6106,0,2,59,4,63,0.9365079365079365,0.06349206349206349
6031,0,2,4,10,14,0.2857142857142857,0.7142857142857143
6180,0,2,0,6,6,0.0,1.0
6039,0,2,30,33,63,0.47619047619047616,0.5238095238095238
6189,1,2,0,18,18,0.0,1.0
5936,1,2,6,0,6,1.0,0.0
6087,1,2,2,9,11,0.18181818181818182,0.8181818181818182
5973,1,2,6,842,848,0.007075471698113208,0.9929245283018868
6085,1,2,12,0,12,1.0,0.0
6012,1,2,0,62,62,0.0,1.0
5982,1,2,0,6,6,0.0,1.0
5948,1,2,0,57,57,0.0,1.0
5974,1,2,6,0,6,1.0,0.0
6090,1,2,0,4,4,0.0,1.0
6068,1,2,3,0,3,1.0,0.0
5962,1,2,34,7,41,0.8292682926829268,0.17073170731707318
6033,1,2,1,0,1,1.0,0.0
6038,1,2,2,0,2,1.0,0.0
6042,1,2,71,26,97,0.7319587628865979,0.26804123711340205
5924,1,2,3,0,3,1.0,0.0
6083,1,2,0,27,27,0.0,1.0
6178,1,2,18,0,18,1.0,0.0
5958,1,2,4,0,4,1.0,0.0
6086,1,2,0,14,14,0.0,1.0
5945,1,2,18,1,19,0.9473684210526315,0.05263157894736842
5935,1,2,5,0,5,1.0,0.0
6073,1,2,12,3,15,0.8,0.2
5980,1,2,45,0,45,1.0,0.0
5993,1,2,121,362,483,0.2505175983436853,0.7494824016563147
6037,1,2,97,126,223,0.4349775784753363,0.5650224215246636
5979,1,2,5,0,5,1.0,0.0
5966,1,2,0,73,73,0.0,1.0
5985,1,2,3,0,3,1.0,0.0
5967,1,2,0,76,76,0.0,1.0
6188,1,2,22,0,22,1.0,0.0
6041,1,2,0,12,12,0.0,1.0
5972,1,2,13,0,13,1.0,0.0
6069,1,2,2,2,4,0.5,0.5
5937,1,2,1,0,1,1.0,0.0
6028,1,2,28,3,31,0.9032258064516129,0.0967741935483871
5990,1,2,0,130,130,0.0,1.0
5928,1,2,130,351,481,0.2702702702702703,0.7297297297297297
5992,1,2,4,0,4,1.0,0.0
6058,1,2,13,0,13,1.0,0.0
6001,1,2,27,2,29,0.9310344827586207,0.06896551724137931
5964,1,2,31,0,31,1.0,0.0
5950,1,2,3,1,4,0.75,0.25
5991,1,2,8,0,8,1.0,0.0
6177,1,2,167,142,309,0.540453074433657,0.459546925566343
5961,1,2,0,321,321,0.0,1.0
6176,1,2,0,93,93,0.0,1.0
5956,1,2,0,31,31,0.0,1.0
5938,1,2,55,584,639,0.08607198748043818,0.9139280125195618
6179,1,2,27,1,28,0.9642857142857143,0.03571428571428571
5947,1,2,56,4,60,0.9333333333333333,0.06666666666666667
5927,1,2,15,440,455,0.03296703296703297,0.967032967032967
5977,1,2,5,301,306,0.016339869281045753,0.9836601307189542
6198,1,2,0,5,5,0.0,1.0
5957,1,2,0,45,45,0.0,1.0
6057,1,2,27,2,29,0.9310344827586207,0.06896551724137931
6043,1,2,8,0,8,1.0,0.0
6077,1,2,0,4,4,0.0,1.0
6014,1,2,13,1,14,0.9285714285714286,0.07142857142857142
6015,1,2,3,0,3,1.0,0.0
5978,1,2,3,0,3,1.0,0.0
5986,1,2,13,37,50,0.26,0.74
5959,1,2,185,174,359,0.5153203342618384,0.48467966573816157
6051,1,2,28,10,38,0.7368421052631579,0.2631578947368421
6029,1,2,3,0,3,1.0,0.0
6070,1,2,1,0,1,1.0,0.0
5942,1,2,0,145,145,0.0,1.0
5953,1,2,4,0,4,1.0,0.0
6076,1,2,7,0,7,1.0,0.0
5940,1,2,10,0,10,1.0,0.0
6109,1,2,76,17,93,0.8172043010752689,0.1827956989247312
6187,1,2,3,0,3,1.0,0.0
6053,1,2,0,17,17,0.0,1.0
6104,1,2,9,0,9,1.0,0.0
5943,1,2,2,0,2,1.0,0.0
6017,1,2,3,0,3,1.0,0.0
6168,1,2,11,5,16,0.6875,0.3125
5989,1,2,5,1,6,0.8333333333333334,0.16666666666666666
5963,1,2,6,0,6,1.0,0.0
6194,1,2,0,26,26,0.0,1.0
6167,1,2,19,0,19,1.0,0.0
6004,1,2,0,64,64,0.0,1.0
6030,1,2,6,1,7,0.8571428571428571,0.14285714285714285
6054,1,2,6,0,6,1.0,0.0
6032,1,2,12,0,12,1.0,0.0
6170,1,2,58,6,64,0.90625,0.09375
6063,1,2,3,0,3,1.0,0.0
5988,1,2,1,0,1,1.0,0.0
6075,1,2,3,0,3,1.0,0.0
6061,1,2,0,67,67,0.0,1.0
5965,1,2,39,10,49,0.7959183673469388,0.20408163265306123
6040,1,2,9,1,10,0.9,0.1
6059,1,2,0,85,85,0.0,1.0
6106,1,2,58,5,63,0.9206349206349206,0.07936507936507936
6031,1,2,4,10,14,0.2857142857142857,0.7142857142857143
6180,1,2,0,6,6,0.0,1.0
6039,1,2,22,41,63,0.3492063492063492,0.6507936507936508
6189,2,2,0,18,18,0.0,1.0
5936,2,2,6,0,6,1.0,0.0
6087,2,2,2,9,11,0.18181818181818182,0.8181818181818182
5973,2,2,2,846,848,0.0023584905660377358,0.9976415094339622
6085,2,2,12,0,12,1.0,0.0
6012,2,2,0,62,62,0.0,1.0
5982,2,2,1,5,6,0.16666666666666666,0.8333333333333334
5948,2,2,0,57,57,0.0,1.0
5974,2,2,5,1,6,0.8333333333333334,0.16666666666666666
6090,2,2,0,4,4,0.0,1.0
6068,2,2,3,0,3,1.0,0.0
5962,2,2,28,13,41,0.6829268292682927,0.3170731707317073
6033,2,2,0,1,1,0.0,1.0
6038,2,2,2,0,2,1.0,0.0
6042,2,2,43,54,97,0.44329896907216493,0.5567010309278351
5924,2,2,2,1,3,0.6666666666666666,0.3333333333333333
6083,2,2,0,27,27,0.0,1.0
6178,2,2,17,1,18,0.9444444444444444,0.05555555555555555
5958,2,2,4,0,4,1.0,0.0
6086,2,2,0,14,14,0.0,1.0
5945,2,2,14,5,19,0.7368421052631579,0.2631578947368421
5935,2,2,5,0,5,1.0,0.0
6073,2,2,14,1,15,0.9333333333333333,0.06666666666666667
5980,2,2,43,2,45,0.9555555555555556,0.044444444444444446
5993,2,2,46,437,483,0.09523809523809523,0.9047619047619048
6037,2,2,43,180,223,0.19282511210762332,0.8071748878923767
5979,2,2,5,0,5,1.0,0.0
5966,2,2,0,73,73,0.0,1.0
5985,2,2,3,0,3,1.0,0.0
5967,2,2,0,76,76,0.0,1.0
6188,2,2,18,4,22,0.8181818181818182,0.18181818181818182
6041,2,2,0,12,12,0.0,1.0
5972,2,2,13,0,13,1.0,0.0
6069,2,2,1,3,4,0.25,0.75
5937,2,2,1,0,1,1.0,0.0
6028,2,2,23,8,31,0.7419354838709677,0.25806451612903225
5990,2,2,0,130,130,0.0,1.0
5928,2,2,53,428,481,0.1101871101871102,0.8898128898128899
5992,2,2,4,0,4,1.0,0.0
6058,2,2,12,1,13,0.9230769230769231,0.07692307692307693
6001,2,2,25,4,29,0.8620689655172413,0.13793103448275862
5964,2,2,25,6,31,0.8064516129032258,0.1935483870967742
5950,2,2,4,0,4,1.0,0.0
5991,2,2,6,2,8,0.75,0.25
6177,2,2,68,241,309,0.22006472491909385,0.7799352750809061
5961,2,2,0,321,321,0.0,1.0
6176,2,2,0,93,93,0.0,1.0
5956,2,2,0,31,31,0.0,1.0
5938,2,2,30,609,639,0.046948356807511735,0.9530516431924883
6179,2,2,18,10,28,0.6428571428571429,0.35714285714285715
5947,2,2,42,18,60,0.7,0.3
5927,2,2,2,453,455,0.004395604395604396,0.9956043956043956
5977,2,2,2,304,306,0.006535947712418301,0.9934640522875817
6198,2,2,0,5,5,0.0,1.0
5957,2,2,0,45,45,0.0,1.0
6057,2,2,23,6,29,0.7931034482758621,0.20689655172413793
6043,2,2,8,0,8,1.0,0.0
6077,2,2,0,4,4,0.0,1.0
6014,2,2,13,1,14,0.9285714285714286,0.07142857142857142
6015,2,2,3,0,3,1.0,0.0
5978,2,2,3,0,3,1.0,0.0
5986,2,2,11,39,50,0.22,0.78
5959,2,2,82,277,359,0.22841225626740946,0.7715877437325905
6051,2,2,28,10,38,0.7368421052631579,0.2631578947368421
6029,2,2,2,1,3,0.6666666666666666,0.3333333333333333
6070,2,2,1,0,1,1.0,0.0
5942,2,2,0,145,145,0.0,1.0
5953,2,2,4,0,4,1.0,0.0
6076,2,2,7,0,7,1.0,0.0
5940,2,2,9,1,10,0.9,0.1
6109,2,2,36,57,93,0.3870967741935484,0.6129032258064516
6187,2,2,3,0,3,1.0,0.0
6053,2,2,0,17,17,0.0,1.0
6104,2,2,9,0,9,1.0,0.0
5943,2,2,2,0,2,1.0,0.0
6017,2,2,2,1,3,0.6666666666666666,0.3333333333333333
6168,2,2,11,5,16,0.6875,0.3125
5989,2,2,5,1,6,0.8333333333333334,0.16666666666666666
5963,2,2,6,0,6,1.0,0.0
6194,2,2,0,26,26,0.0,1.0
6167,2,2,17,2,19,0.8947368421052632,0.10526315789473684
6004,2,2,0,64,64,0.0,1.0
6030,2,2,6,1,7,0.8571428571428571,0.14285714285714285
6054,2,2,6,0,6,1.0,0.0
6032,2,2,12,0,12,1.0,0.0
6170,2,2,40,24,64,0.625,0.375
6063,2,2,3,0,3,1.0,0.0
5988,2,2,1,0,1,1.0,0.0
6075,2,2,3,0,3,1.0,0.0
6061,2,2,0,67,67,0.0,1.0
5965,2,2,22,27,49,0.4489795918367347,0.5510204081632653
6040,2,2,9,1,10,0.9,0.1
6059,2,2,0,85,85,0.0,1.0
6106,2,2,36,27,63,0.5714285714285714,0.42857142857142855
6031,2,2,5,9,14,0.35714285714285715,0.6428571428571429
6180,2,2,0,6,6,0.0,1.0
6039,2,2,24,39,63,0.38095238095238093,0.6190476190476191
6189,3,2,0,18,18,0.0,1.0
5936,3,2,6,0,6,1.0,0.0
6087,3,2,4,7,11,0.36363636363636365,0.6363636363636364
5973,3,2,3,845,848,0.003537735849056604,0.9964622641509434
6085,3,2,12,0,12,1.0,0.0
6012,3,2,0,62,62,0.0,1.0
5982,3,2,0,6,6,0.0,1.0
5948,3,2,0,57,57,0.0,1.0
5974,3,2,6,0,6,1.0,0.0
6090,3,2,0,4,4,0.0,1.0
6068,3,2,3,0,3,1.0,0.0
5962,3,2,21,20,41,0.5121951219512195,0.4878048780487805
6033,3,2,0,1,1,0.0,1.0
6038,3,2,2,0,2,1.0,0.0
6042,3,2,32,65,97,0.32989690721649484,0.6701030927835051
5924,3,2,2,1,3,0.6666666666666666,0.3333333333333333
6083,3,2,0,27,27,0.0,1.0
6178,3,2,18,0,18,1.0,0.0
5958,3,2,4,0,4,1.0,0.0
6086,3,2,0,14,14,0.0,1.0
5945,3,2,12,7,19,0.631578947368421,0.3684210526315789
5935,3,2,4,1,5,0.8,0.2
6073,3,2,12,3,15,0.8,0.2
5980,3,2,35,10,45,0.7777777777777778,0.2222222222222222
5993,3,2,44,439,483,0.09109730848861283,0.9089026915113871
6037,3,2,19,204,223,0.08520179372197309,0.9147982062780269
5979,3,2,5,0,5,1.0,0.0
5966,3,2,0,73,73,0.0,1.0
5985,3,2,3,0,3,1.0,0.0
5967,3,2,0,76,76,0.0,1.0
6188,3,2,17,5,22,0.7727272727272727,0.22727272727272727
6041,3,2,0,12,12,0.0,1.0
5972,3,2,13,0,13,1.0,0.0
6069,3,2,0,4,4,0.0,1.0
5937,3,2,1,0,1,1.0,0.0
6028,3,2,20,11,31,0.6451612903225806,0.3548387096774194
5990,3,2,0,130,130,0.0,1.0
5928,3,2,31,450,481,0.06444906444906445,0.9355509355509356
5992,3,2,4,0,4,1.0,0.0
6058,3,2,12,1,13,0.9230769230769231,0.07692307692307693
6001,3,2,20,9,29,0.6896551724137931,0.3103448275862069
5964,3,2,22,9,31,0.7096774193548387,0.2903225806451613
5950,3,2,4,0,4,1.0,0.0
5991,3,2,6,2,8,0.75,0.25
6177,3,2,48,261,309,0.1553398058252427,0.8446601941747572
5961,3,2,0,321,321,0.0,1.0
6176,3,2,0,93,93,0.0,1.0
5956,3,2,0,31,31,0.0,1.0
5938,3,2,17,622,639,0.026604068857589983,0.97339593114241
6179,3,2,16,12,28,0.5714285714285714,0.42857142857142855
5947,3,2,34,26,60,0.5666666666666667,0.43333333333333335
5927,3,2,2,453,455,0.004395604395604396,0.9956043956043956
5977,3,2,5,301,306,0.016339869281045753,0.9836601307189542
6198,3,2,0,5,5,0.0,1.0
5957,3,2,0,45,45,0.0,1.0
6057,3,2,13,16,29,0.4482758620689655,0.5517241379310345
6043,3,2,8,0,8,1.0,0.0
6077,3,2,0,4,4,0.0,1.0
6014,3,2,10,4,14,0.7142857142857143,0.2857142857142857
6015,3,2,3,0,3,1.0,0.0
5978,3,2,2,1,3,0.6666666666666666,0.3333333333333333
5986,3,2,10,40,50,0.2,0.8
5959,3,2,45,314,359,0.12534818941504178,0.8746518105849582
6051,3,2,28,10,38,0.7368421052631579,0.2631578947368421
6029,3,2,2,1,3,0.6666666666666666,0.3333333333333333
6070,3,2,1,0,1,1.0,0.0
5942,3,2,0,145,145,0.0,1.0
5953,3,2,4,0,4,1.0,0.0
6076,3,2,6,1,7,0.8571428571428571,0.14285714285714285
5940,3,2,7,3,10,0.7,0.3
6109,3,2,30,63,93,0.3225806451612903,0.6774193548387096
6187,3,2,3,0,3,1.0,0.0
6053,3,2,0,17,17,0.0,1.0
6104,3,2,8,1,9,0.8888888888888888,0.1111111111111111
5943,3,2,2,0,2,1.0,0.0
6017,3,2,2,1,3,0.6666666666666666,0.3333333333333333
6168,3,2,9,7,16,0.5625,0.4375
5989,3,2,6,0,6,1.0,0.0
5963,3,2,6,0,6,1.0,0.0
6194,3,2,0,26,26,0.0,1.0
6167,3,2,17,2,19,0.8947368421052632,0.10526315789473684
6004,3,2,1,63,64,0.015625,0.984375
6030,3,2,7,0,7,1.0,0.0
6054,3,2,6,0,6,1.0,0.0
6032,3,2,12,0,12,1.0,0.0
6170,3,2,30,34,64,0.46875,0.53125
6063,3,2,3,0,3,1.0,0.0
5988,3,2,1,0,1,1.0,0.0
6075,3,2,3,0,3,1.0,0.0
6061,3,2,0,67,67,0.0,1.0
5965,3,2,21,28,49,0.42857142857142855,0.5714285714285714
6040,3,2,9,1,10,0.9,0.1
6059,3,2,0,85,85,0.0,1.0
6106,3,2,17,46,63,0.2698412698412698,0.7301587301587301
6031,3,2,7,7,14,0.5,0.5
6180,3,2,0,6,6,0.0,1.0
6039,3,2,22,41,63,0.3492063492063492,0.6507936507936508
6189,4,2,0,18,18,0.0,1.0
5936,4,2,6,0,6,1.0,0.0
6087,4,2,2,9,11,0.18181818181818182,0.8181818181818182
5973,4,2,4,844,848,0.0047169811320754715,0.9952830188679245
6085,4,2,10,2,12,0.8333333333333334,0.16666666666666666
6012,4,2,0,62,62,0.0,1.0
5982,4,2,0,6,6,0.0,1.0
5948,4,2,0,57,57,0.0,1.0
5974,4,2,5,1,6,0.8333333333333334,0.16666666666666666
6090,4,2,0,4,4,0.0,1.0
6068,4,2,3,0,3,1.0,0.0
5962,4,2,20,21,41,0.4878048780487805,0.5121951219512195
6033,4,2,0,1,1,0.0,1.0
6038,4,2,2,0,2,1.0,0.0
6042,4,2,25,72,97,0.25773195876288657,0.7422680412371134
5924,4,2,2,1,3,0.6666666666666666,0.3333333333333333
6083,4,2,0,27,27,0.0,1.0
6178,4,2,13,5,18,0.7222222222222222,0.2777777777777778
5958,4,2,4,0,4,1.0,0.0
6086,4,2,0,14,14,0.0,1.0
5945,4,2,7,12,19,0.3684210526315789,0.631578947368421
5935,4,2,5,0,5,1.0,0.0
6073,4,2,12,3,15,0.8,0.2
5980,4,2,26,19,45,0.5777777777777777,0.4222222222222222
5993,4,2,20,463,483,0.041407867494824016,0.9585921325051759
6037,4,2,13,210,223,0.05829596412556054,0.9417040358744395
5979,4,2,5,0,5,1.0,0.0
5966,4,2,0,73,73,0.0,1.0
5985,4,2,3,0,3,1.0,0.0
5967,4,2,0,76,76,0.0,1.0
6188,4,2,9,13,22,0.4090909090909091,0.5909090909090909
6041,4,2,0,12,12,0.0,1.0
5972,4,2,12,1,13,0.9230769230769231,0.07692307692307693
6069,4,2,0,4,4,0.0,1.0
5937,4,2,1,0,1,1.0,0.0
6028,4,2,11,20,31,0.3548387096774194,0.6451612903225806
5990,4,2,0,130,130,0.0,1.0
5928,4,2,27,454,481,0.056133056133056136,0.9438669438669439
5992,4,2,4,0,4,1.0,0.0
6058,4,2,12,1,13,0.9230769230769231,0.07692307692307693
6001,4,2,16,13,29,0.5517241379310345,0.4482758620689655
5964,4,2,22,9,31,0.7096774193548387,0.2903225806451613
5950,4,2,4,0,4,1.0,0.0
5991,4,2,5,3,8,0.625,0.375
6177,4,2,25,284,309,0.08090614886731391,0.919093851132686
5961,4,2,0,321,321,0.0,1.0
6176,4,2,0,93,93,0.0,1.0
5956,4,2,0,31,31,0.0,1.0
5938,4,2,16,623,639,0.025039123630672927,0.974960876369327
6179,4,2,9,19,28,0.32142857142857145,0.6785714285714286
5947,4,2,28,32,60,0.4666666666666667,0.5333333333333333
5927,4,2,1,454,455,0.002197802197802198,0.9978021978021978
5977,4,2,2,304,306,0.006535947712418301,0.9934640522875817
6198,4,2,0,5,5,0.0,1.0
5957,4,2,0,45,45,0.0,1.0
6057,4,2,11,18,29,0.3793103448275862,0.6206896551724138
6043,4,2,8,0,8,1.0,0.0
6077,4,2,0,4,4,0.0,1.0
6014,4,2,10,4,14,0.7142857142857143,0.2857142857142857
6015,4,2,2,1,3,0.6666666666666666,0.3333333333333333
5978,4,2,3,0,3,1.0,0.0
5986,4,2,7,43,50,0.14,0.86
5959,4,2,26,333,359,0.07242339832869081,0.9275766016713092
6051,4,2,22,16,38,0.5789473684210527,0.42105263157894735
6029,4,2,1,2,3,0.3333333333333333,0.6666666666666666
6070,4,2,1,0,1,1.0,0.0
5942,4,2,0,145,145,0.0,1.0
5953,4,2,4,0,4,1.0,0.0
6076,4,2,5,2,7,0.7142857142857143,0.2857142857142857
5940,4,2,7,3,10,0.7,0.3
6109,4,2,12,81,93,0.12903225806451613,0.8709677419354839
6187,4,2,2,1,3,0.6666666666666666,0.3333333333333333
6053,4,2,0,17,17,0.0,1.0
6104,4,2,9,0,9,1.0,0.0
5943,4,2,2,0,2,1.0,0.0
6017,4,2,2,1,3,0.6666666666666666,0.3333333333333333
6168,4,2,10,6,16,0.625,0.375
5989,4,2,6,0,6,1.0,0.0
5963,4,2,6,0,6,1.0,0.0
6194,4,2,0,26,26,0.0,1.0
6167,4,2,16,3,19,0.8421052631578947,0.15789473684210525
6004,4,2,1,63,64,0.015625,0.984375
6030,4,2,6,1,7,0.8571428571428571,0.14285714285714285
6054,4,2,6,0,6,1.0,0.0
6032,4,2,10,2,12,0.8333333333333334,0.16666666666666666
6170,4,2,19,45,64,0.296875,0.703125
6063,4,2,3,0,3,1.0,0.0
5988,4,2,1,0,1,1.0,0.0
6075,4,2,3,0,3,1.0,0.0
6061,4,2,0,67,67,0.0,1.0
5965,4,2,12,37,49,0.24489795918367346,0.7551020408163265
6040,4,2,9,1,10,0.9,0.1
6059,4,2,0,85,85,0.0,1.0
6106,4,2,11,52,63,0.1746031746031746,0.8253968253968254
6031,4,2,4,10,14,0.2857142857142857,0.7142857142857143
6180,4,2,0,6,6,0.0,1.0
6039,4,2,17,46,63,0.2698412698412698,0.7301587301587301
6189,5,2,0,18,18,0.0,1.0
5936,5,2,5,1,6,0.8333333333333334,0.16666666666666666
6087,5,2,4,7,11,0.36363636363636365,0.6363636363636364
5973,5,2,1,847,848,0.0011792452830188679,0.9988207547169812
6085,5,2,9,3,12,0.75,0.25
6012,5,2,0,62,62,0.0,1.0
5982,5,2,1,5,6,0.16666666666666666,0.8333333333333334
5948,5,2,0,57,57,0.0,1.0
5974,5,2,4,2,6,0.6666666666666666,0.3333333333333333
6090,5,2,0,4,4,0.0,1.0
6068,5,2,3,0,3,1.0,0.0
5962,5,2,11,30,41,0.2682926829268293,0.7317073170731707
6033,5,2,0,1,1,0.0,1.0
6038,5,2,2,0,2,1.0,0.0
6042,5,2,16,81,97,0.16494845360824742,0.8350515463917526
5924,5,2,1,2,3,0.3333333333333333,0.6666666666666666
6083,5,2,0,27,27,0.0,1.0
6178,5,2,12,6,18,0.6666666666666666,0.3333333333333333
5958,5,2,3,1,4,0.75,0.25
6086,5,2,0,14,14,0.0,1.0
5945,5,2,4,15,19,0.21052631578947367,0.7894736842105263
5935,5,2,5,0,5,1.0,0.0
6073,5,2,9,6,15,0.6,0.4
5980,5,2,27,18,45,0.6,0.4
5993,5,2,18,465,483,0.037267080745341616,0.9627329192546584
6037,5,2,7,216,223,0.03139013452914798,0.968609865470852
5979,5,2,5,0,5,1.0,0.0
5966,5,2,0,73,73,0.0,1.0
5985,5,2,3,0,3,1.0,0.0
5967,5,2,0,76,76,0.0,1.0
6188,5,2,8,14,22,0.36363636363636365,0.6363636363636364
6041,5,2,0,12,12,0.0,1.0
5972,5,2,11,2,13,0.8461538461538461,0.15384615384615385
6069,5,2,1,3,4,0.25,0.75
5937,5,2,1,0,1,1.0,0.0
6028,5,2,7,24,31,0.22580645161290322,0.7741935483870968
5990,5,2,0,130,130,0.0,1.0
5928,5,2,10,471,481,0.02079002079002079,0.9792099792099792
5992,5,2,4,0,4,1.0,0.0
6058,5,2,11,2,13,0.8461538461538461,0.15384615384615385
6001,5,2,11,18,29,0.3793103448275862,0.6206896551724138
5964,5,2,14,17,31,0.45161290322580644,0.5483870967741935
5950,5,2,3,1,4,0.75,0.25
5991,5,2,5,3,8,0.625,0.375
6177,5,2,22,287,309,0.07119741100323625,0.9288025889967637
5961,5,2,0,321,321,0.0,1.0
6176,5,2,0,93,93,0.0,1.0
5956,5,2,0,31,31,0.0,1.0
5938,5,2,6,633,639,0.009389671361502348,0.9906103286384976
6179,5,2,10,18,28,0.35714285714285715,0.6428571428571429
5947,5,2,20,40,60,0.3333333333333333,0.6666666666666666
5927,5,2,2,453,455,0.004395604395604396,0.9956043956043956
5977,5,2,2,304,306,0.006535947712418301,0.9934640522875817
6198,5,2,0,5,5,0.0,1.0
5957,5,2,0,45,45,0.0,1.0
6057,5,2,12,17,29,0.41379310344827586,0.5862068965517241
6043,5,2,8,0,8,1.0,0.0
6077,5,2,0,4,4,0.0,1.0
6014,5,2,11,3,14,0.7857142857142857,0.21428571428571427
6015,5,2,1,2,3,0.3333333333333333,0.6666666666666666
5978,5,2,2,1,3,0.6666666666666666,0.3333333333333333
5986,5,2,1,49,50,0.02,0.98
5959,5,2,12,347,359,0.033426183844011144,0.9665738161559888
6051,5,2,20,18,38,0.5263157894736842,0.47368421052631576
6029,5,2,2,1,3,0.6666666666666666,0.3333333333333333
6070,5,2,1,0,1,1.0,0.0
5942,5,2,0,145,145,0.0,1.0
5953,5,2,4,0,4,1.0,0.0
6076,5,2,4,3,7,0.5714285714285714,0.42857142857142855
5940,5,2,3,7,10,0.3,0.7
6109,5,2,10,83,93,0.10752688172043011,0.8924731182795699
6187,5,2,3,0,3,1.0,0.0
6053,5,2,0,17,17,0.0,1.0
6104,5,2,7,2,9,0.7777777777777778,0.2222222222222222
5943,5,2,2,0,2,1.0,0.0
6017,5,2,3,0,3,1.0,0.0
6168,5,2,6,10,16,0.375,0.625
5989,5,2,6,0,6,1.0,0.0
5963,5,2,6,0,6,1.0,0.0
6194,5,2,0,26,26,0.0,1.0
6167,5,2,13,6,19,0.6842105263157895,0.3157894736842105
6004,5,2,0,64,64,0.0,1.0
6030,5,2,6,1,7,0.8571428571428571,0.14285714285714285
6054,5,2,6,0,6,1.0,0.0
6032,5,2,10,2,12,0.8333333333333334,0.16666666666666666
6170,5,2,11,53,64,0.171875,0.828125
6063,5,2,3,0,3,1.0,0.0
5988,5,2,1,0,1,1.0,0.0
6075,5,2,3,0,3,1.0,0.0
6061,5,2,0,67,67,0.0,1.0
5965,5,2,14,35,49,0.2857142857142857,0.7142857142857143
6040,5,2,8,2,10,0.8,0.2
6059,5,2,0,85,85,0.0,1.0
6106,5,2,7,56,63,0.1111111111111111,0.8888888888888888
6031,5,2,4,10,14,0.2857142857142857,0.7142857142857143
6180,5,2,0,6,6,0.0,1.0
6039,5,2,15,48,63,0.23809523809523808,0.7619047619047619
6189,6,2,0,18,18,0.0,1.0
5936,6,2,5,1,6,0.8333333333333334,0.16666666666666666
6087,6,2,1,10,11,0.09090909090909091,0.9090909090909091
5973,6,2,1,847,848,0.0011792452830188679,0.9988207547169812
6085,6,2,6,6,12,0.5,0.5
6012,6,2,0,62,62,0.0,1.0
5982,6,2,1,5,6,0.16666666666666666,0.8333333333333334
5948,6,2,0,57,57,0.0,1.0
5974,6,2,3,3,6,0.5,0.5
6090,6,2,0,4,4,0.0,1.0
6068,6,2,3,0,3,1.0,0.0
5962,6,2,9,32,41,0.21951219512195122,0.7804878048780488
6033,6,2,0,1,1,0.0,1.0
6038,6,2,2,0,2,1.0,0.0
6042,6,2,17,80,97,0.17525773195876287,0.8247422680412371
5924,6,2,1,2,3,0.3333333333333333,0.6666666666666666
6083,6,2,0,27,27,0.0,1.0
6178,6,2,10,8,18,0.5555555555555556,0.4444444444444444
5958,6,2,4,0,4,1.0,0.0
6086,6,2,0,14,14,0.0,1.0
5945,6,2,3,16,19,0.15789473684210525,0.8421052631578947
5935,6,2,5,0,5,1.0,0.0
6073,6,2,9,6,15,0.6,0.4
5980,6,2,13,32,45,0.28888888888888886,0.7111111111111111
5993,6,2,8,475,483,0.016563146997929608,0.9834368530020704
6037,6,2,9,214,223,0.04035874439461883,0.9596412556053812
5979,6,2,5,0,5,1.0,0.0
5966,6,2,0,73,73,0.0,1.0
5985,6,2,2,1,3,0.6666666666666666,0.3333333333333333
5967,6,2,0,76,76,0.0,1.0
6188,6,2,10,12,22,0.45454545454545453,0.5454545454545454
6041,6,2,0,12,12,0.0,1.0
5972,6,2,8,5,13,0.6153846153846154,0.38461538461538464
6069,6,2,2,2,4,0.5,0.5
5937,6,2,1,0,1,1.0,0.0
6028,6,2,6,25,31,0.1935483870967742,0.8064516129032258
5990,6,2,0,130,130,0.0,1.0
5928,6,2,14,467,481,0.029106029106029108,0.9708939708939709
5992,6,2,3,1,4,0.75,0.25
6058,6,2,11,2,13,0.8461538461538461,0.15384615384615385
6001,6,2,9,20,29,0.3103448275862069,0.6896551724137931
5964,6,2,12,19,31,0.3870967741935484,0.6129032258064516
5950,6,2,3,1,4,0.75,0.25
5991,6,2,5,3,8,0.625,0.375
6177,6,2,15,294,309,0.04854368932038835,0.9514563106796117
5961,6,2,0,321,321,0.0,1.0
6176,6,2,0,93,93,0.0,1.0
5956,6,2,0,31,31,0.0,1.0
5938,6,2,5,634,639,0.00782472613458529,0.9921752738654147
6179,6,2,8,20,28,0.2857142857142857,0.7142857142857143
5947,6,2,15,45,60,0.25,0.75
5927,6,2,5,450,455,0.01098901098901099,0.989010989010989
5977,6,2,3,303,306,0.00980392156862745,0.9901960784313726
6198,6,2,0,5,5,0.0,1.0
5957,6,2,0,45,45,0.0,1.0
6057,6,2,6,23,29,0.20689655172413793,0.7931034482758621
6043,6,2,8,0,8,1.0,0.0
6077,6,2,0,4,4,0.0,1.0
6014,6,2,7,7,14,0.5,0.5
6015,6,2,1,2,3,0.3333333333333333,0.6666666666666666
5978,6,2,2,1,3,0.6666666666666666,0.3333333333333333
5986,6,2,4,46,50,0.08,0.92
5959,6,2,16,343,359,0.04456824512534819,0.9554317548746518
6051,6,2,16,22,38,0.42105263157894735,0.5789473684210527
6029,6,2,1,2,3,0.3333333333333333,0.6666666666666666
6070,6,2,1,0,1,1.0,0.0
5942,6,2,0,145,145,0.0,1.0
5953,6,2,4,0,4,1.0,0.0
6076,6,2,4,3,7,0.5714285714285714,0.42857142857142855
5940,6,2,3,7,10,0.3,0.7
6109,6,2,8,85,93,0.08602150537634409,0.9139784946236559
6187,6,2,3,0,3,1.0,0.0
6053,6,2,0,17,17,0.0,1.0
6104,6,2,8,1,9,0.8888888888888888,0.1111111111111111
5943,6,2,2,0,2,1.0,0.0
6017,6,2,2,1,3,0.6666666666666666,0.3333333333333333
6168,6,2,6,10,16,0.375,0.625
5989,6,2,4,2,6,0.6666666666666666,0.3333333333333333
5963,6,2,6,0,6,1.0,0.0
6194,6,2,0,26,26,0.0,1.0
6167,6,2,10,9,19,0.5263157894736842,0.47368421052631576
6004,6,2,0,64,64,0.0,1.0
6030,6,2,7,0,7,1.0,0.0
6054,6,2,5,1,6,0.8333333333333334,0.16666666666666666
6032,6,2,9,3,12,0.75,0.25
6170,6,2,15,49,64,0.234375,0.765625
6063,6,2,3,0,3,1.0,0.0
5988,6,2,1,0,1,1.0,0.0
6075,6,2,2,1,3,0.6666666666666666,0.3333333333333333
6061,6,2,0,67,67,0.0,1.0
5965,6,2,12,37,49,0.24489795918367346,0.7551020408163265
6040,6,2,7,3,10,0.7,0.3
6059,6,2,0,85,85,0.0,1.0
6106,6,2,4,59,63,0.06349206349206349,0.9365079365079365
6031,6,2,5,9,14,0.35714285714285715,0.6428571428571429
6180,6,2,0,6,6,0.0,1.0
6039,6,2,8,55,63,0.12698412698412698,0.873015873015873
6189,7,2,0,18,18,0.0,1.0
5936,7,2,5,1,6,0.8333333333333334,0.16666666666666666
6087,7,2,1,10,11,0.09090909090909091,0.9090909090909091
5973,7,2,0,848,848,0.0,1.0
6085,7,2,7,5,12,0.5833333333333334,0.4166666666666667
6012,7,2,0,62,62,0.0,1.0
5982,7,2,1,5,6,0.16666666666666666,0.8333333333333334
5948,7,2,0,57,57,0.0,1.0
5974,7,2,3,3,6,0.5,0.5
6090,7,2,0,4,4,0.0,1.0
6068,7,2,3,0,3,1.0,0.0
5962,7,2,7,34,41,0.17073170731707318,0.8292682926829268
6033,7,2,0,1,1,0.0,1.0
6038,7,2,2,0,2,1.0,0.0
6042,7,2,7,90,97,0.07216494845360824,0.9278350515463918
5924,7,2,0,3,3,0.0,1.0
6083,7,2,0,27,27,0.0,1.0
6178,7,2,9,9,18,0.5,0.5
5958,7,2,3,1,4,0.75,0.25
6086,7,2,0,14,14,0.0,1.0
5945,7,2,3,16,19,0.15789473684210525,0.8421052631578947
5935,7,2,4,1,5,0.8,0.2
6073,7,2,10,5,15,0.6666666666666666,0.3333333333333333
5980,7,2,10,35,45,0.2222222222222222,0.7777777777777778
5993,7,2,10,473,483,0.020703933747412008,0.979296066252588
6037,7,2,6,217,223,0.026905829596412557,0.9730941704035875
5979,7,2,5,0,5,1.0,0.0
5966,7,2,0,73,73,0.0,1.0
5985,7,2,2,1,3,0.6666666666666666,0.3333333333333333
5967,7,2,0,76,76,0.0,1.0
6188,7,2,6,16,22,0.2727272727272727,0.7272727272727273
6041,7,2,0,12,12,0.0,1.0
5972,7,2,9,4,13,0.6923076923076923,0.3076923076923077
6069,7,2,2,2,4,0.5,0.5
5937,7,2,1,0,1,1.0,0.0
6028,7,2,8,23,31,0.25806451612903225,0.7419354838709677
5990,7,2,0,130,130,0.0,1.0
5928,7,2,10,471,481,0.02079002079002079,0.9792099792099792
5992,7,2,2,2,4,0.5,0.5
6058,7,2,8,5,13,0.6153846153846154,0.38461538461538464
6001,7,2,9,20,29,0.3103448275862069,0.6896551724137931
5964,7,2,12,19,31,0.3870967741935484,0.6129032258064516
5950,7,2,4,0,4,1.0,0.0
5991,7,2,2,6,8,0.25,0.75
6177,7,2,9,300,309,0.02912621359223301,0.970873786407767
5961,7,2,0,321,321,0.0,1.0
6176,7,2,0,93,93,0.0,1.0
5956,7,2,0,31,31,0.0,1.0
5938,7,2,5,634,639,0.00782472613458529,0.9921752738654147
6179,7,2,7,21,28,0.25,0.75
5947,7,2,18,42,60,0.3,0.7
5927,7,2,0,455,455,0.0,1.0
5977,7,2,0,306,306,0.0,1.0
6198,7,2,0,5,5,0.0,1.0
5957,7,2,0,45,45,0.0,1.0
6057,7,2,5,24,29,0.1724137931034483,0.8275862068965517
6043,7,2,8,0,8,1.0,0.0
6077,7,2,0,4,4,0.0,1.0
6014,7,2,8,6,14,0.5714285714285714,0.42857142857142855
6015,7,2,2,1,3,0.6666666666666666,0.3333333333333333
5978,7,2,1,2,3,0.3333333333333333,0.6666666666666666
5986,7,2,7,43,50,0.14,0.86
5959,7,2,10,349,359,0.027855153203342618,0.9721448467966574
6051,7,2,7,31,38,0.18421052631578946,0.8157894736842105
6029,7,2,2,1,3,0.6666666666666666,0.3333333333333333
6070,7,2,1,0,1,1.0,0.0
5942,7,2,0,145,145,0.0,1.0
5953,7,2,4,0,4,1.0,0.0
6076,7,2,3,4,7,0.42857142857142855,0.5714285714285714
5940,7,2,4,6,10,0.4,0.6
6109,7,2,6,87,93,0.06451612903225806,0.9354838709677419
6187,7,2,2,1,3,0.6666666666666666,0.3333333333333333
6053,7,2,0,17,17,0.0,1.0
6104,7,2,7,2,9,0.7777777777777778,0.2222222222222222
5943,7,2,2,0,2,1.0,0.0
6017,7,2,2,1,3,0.6666666666666666,0.3333333333333333
6168,7,2,3,13,16,0.1875,0.8125
5989,7,2,5,1,6,0.8333333333333334,0.16666666666666666
5963,7,2,6,0,6,1.0,0.0
6194,7,2,0,26,26,0.0,1.0
6167,7,2,4,15,19,0.21052631578947367,0.7894736842105263
6004,7,2,0,64,64,0.0,1.0
6030,7,2,7,0,7,1.0,0.0
6054,7,2,4,2,6,0.6666666666666666,0.3333333333333333
6032,7,2,8,4,12,0.6666666666666666,0.3333333333333333
6170,7,2,14,50,64,0.21875,0.78125
6063,7,2,3,0,3,1.0,0.0
5988,7,2,1,0,1,1.0,0.0
6075,7,2,2,1,3,0.6666666666666666,0.3333333333333333
6061,7,2,0,67,67,0.0,1.0
5965,7,2,5,44,49,0.10204081632653061,0.8979591836734694
6040,7,2,9,1,10,0.9,0.1
6059,7,2,0,85,85,0.0,1.0
6106,7,2,2,61,63,0.031746031746031744,0.9682539682539683
6031,7,2,5,9,14,0.35714285714285715,0.6428571428571429
6180,7,2,0,6,6,0.0,1.0
6039,7,2,9,54,63,0.14285714285714285,0.8571428571428571
6189,8,2,0,18,18,0.0,1.0
5936,8,2,4,2,6,0.6666666666666666,0.3333333333333333
6087,8,2,1,10,11,0.09090909090909091,0.9090909090909091
5973,8,2,0,848,848,0.0,1.0
6085,8,2,7,5,12,0.5833333333333334,0.4166666666666667
6012,8,2,0,62,62,0.0,1.0
5982,8,2,1,5,6,0.16666666666666666,0.8333333333333334
5948,8,2,0,57,57,0.0,1.0
5974,8,2,3,3,6,0.5,0.5
6090,8,2,0,4,4,0.0,1.0
6068,8,2,3,0,3,1.0,0.0
5962,8,2,3,38,41,0.07317073170731707,0.926829268292683
6033,8,2,0,1,1,0.0,1.0
6038,8,2,2,0,2,1.0,0.0
6042,8,2,7,90,97,0.07216494845360824,0.9278350515463918
5924,8,2,0,3,3,0.0,1.0
6083,8,2,0,27,27,0.0,1.0
6178,8,2,8,10,18,0.4444444444444444,0.5555555555555556
5958,8,2,3,1,4,0.75,0.25
6086,8,2,0,14,14,0.0,1.0
5945,8,2,3,16,19,0.15789473684210525,0.8421052631578947
5935,8,2,4,1,5,0.8,0.2
6073,8,2,5,10,15,0.3333333333333333,0.6666666666666666
5980,8,2,11,34,45,0.24444444444444444,0.7555555555555555
5993,8,2,6,477,483,0.012422360248447204,0.9875776397515528
6037,8,2,7,216,223,0.03139013452914798,0.968609865470852
5979,8,2,4,1,5,0.8,0.2
5966,8,2,0,73,73,0.0,1.0
5985,8,2,1,2,3,0.3333333333333333,0.6666666666666666
5967,8,2,0,76,76,0.0,1.0
6188,8,2,3,19,22,0.13636363636363635,0.8636363636363636
6041,8,2,0,12,12,0.0,1.0
5972,8,2,10,3,13,0.7692307692307693,0.23076923076923078
6069,8,2,1,3,4,0.25,0.75
5937,8,2,1,0,1,1.0,0.0
6028,8,2,5,26,31,0.16129032258064516,0.8387096774193549
5990,8,2,0,130,130,0.0,1.0
5928,8,2,4,477,481,0.008316008316008316,0.9916839916839917
5992,8,2,4,0,4,1.0,0.0
6058,8,2,9,4,13,0.6923076923076923,0.3076923076923077
6001,8,2,3,26,29,0.10344827586206896,0.896551724137931
5964,8,2,11,20,31,0.3548387096774194,0.6451612903225806
5950,8,2,3,1,4,0.75,0.25
5991,8,2,4,4,8,0.5,0.5
6177,8,2,11,298,309,0.03559870550161812,0.9644012944983819
5961,8,2,0,321,321,0.0,1.0
6176,8,2,0,93,93,0.0,1.0
5956,8,2,0,31,31,0.0,1.0
5938,8,2,5,634,639,0.00782472613458529,0.9921752738654147
6179,8,2,3,25,28,0.10714285714285714,0.8928571428571429
5947,8,2,12,48,60,0.2,0.8
5927,8,2,1,454,455,0.002197802197802198,0.9978021978021978
5977,8,2,1,305,306,0.0032679738562091504,0.9967320261437909
6198,8,2,0,5,5,0.0,1.0
5957,8,2,0,45,45,0.0,1.0
6057,8,2,3,26,29,0.10344827586206896,0.896551724137931
6043,8,2,8,0,8,1.0,0.0
6077,8,2,0,4,4,0.0,1.0
6014,8,2,5,9,14,0.35714285714285715,0.6428571428571429
6015,8,2,1,2,3,0.3333333333333333,0.6666666666666666
5978,8,2,2,1,3,0.6666666666666666,0.3333333333333333
5986,8,2,4,46,50,0.08,0.92
5959,8,2,10,349,359,0.027855153203342618,0.9721448467966574
6051,8,2,7,31,38,0.18421052631578946,0.8157894736842105
6029,8,2,1,2,3,0.3333333333333333,0.6666666666666666
6070,8,2,1,0,1,1.0,0.0
5942,8,2,0,145,145,0.0,1.0
5953,8,2,4,0,4,1.0,0.0
6076,8,2,5,2,7,0.7142857142857143,0.2857142857142857
5940,8,2,4,6,10,0.4,0.6
6109,8,2,6,87,93,0.06451612903225806,0.9354838709677419
6187,8,2,2,1,3,0.6666666666666666,0.3333333333333333
6053,8,2,0,17,17,0.0,1.0
6104,8,2,7,2,9,0.7777777777777778,0.2222222222222222
5943,8,2,2,0,2,1.0,0.0
6017,8,2,3,0,3,1.0,0.0
6168,8,2,8,8,16,0.5,0.5
5989,8,2,4,2,6,0.6666666666666666,0.3333333333333333
5963,8,2,6,0,6,1.0,0.0
6194,8,2,0,26,26,0.0,1.0
6167,8,2,9,10,19,0.47368421052631576,0.5263157894736842
6004,8,2,1,63,64,0.015625,0.984375
6030,8,2,6,1,7,0.8571428571428571,0.14285714285714285
6054,8,2,3,3,6,0.5,0.5
6032,8,2,8,4,12,0.6666666666666666,0.3333333333333333
6170,8,2,7,57,64,0.109375,0.890625
6063,8,2,3,0,3,1.0,0.0
5988,8,2,1,0,1,1.0,0.0
6075,8,2,0,3,3,0.0,1.0
6061,8,2,0,67,67,0.0,1.0
5965,8,2,5,44,49,0.10204081632653061,0.8979591836734694
6040,8,2,8,2,10,0.8,0.2
6059,8,2,0,85,85,0.0,1.0
6106,8,2,2,61,63,0.031746031746031744,0.9682539682539683
6031,8,2,6,8,14,0.42857142857142855,0.5714285714285714
6180,8,2,0,6,6,0.0,1.0
6039,8,2,2,61,63,0.031746031746031744,0.9682539682539683
6189,9,2,0,18,18,0.0,1.0
5936,9,2,4,2,6,0.6666666666666666,0.3333333333333333
6087,9,2,4,7,11,0.36363636363636365,0.6363636363636364
5973,9,2,1,847,848,0.0011792452830188679,0.9988207547169812
6085,9,2,5,7,12,0.4166666666666667,0.5833333333333334
6012,9,2,0,62,62,0.0,1.0
5982,9,2,0,6,6,0.0,1.0
5948,9,2,0,57,57,0.0,1.0
5974,9,2,3,3,6,0.5,0.5
6090,9,2,0,4,4,0.0,1.0
6068,9,2,3,0,3,1.0,0.0
5962,9,2,5,36,41,0.12195121951219512,0.8780487804878049
6033,9,2,0,1,1,0.0,1.0
6038,9,2,2,0,2,1.0,0.0
6042,9,2,11,86,97,0.1134020618556701,0.8865979381443299
5924,9,2,1,2,3,0.3333333333333333,0.6666666666666666
6083,9,2,0,27,27,0.0,1.0
6178,9,2,6,12,18,0.3333333333333333,0.6666666666666666
5958,9,2,3,1,4,0.75,0.25
6086,9,2,0,14,14,0.0,1.0
5945,9,2,3,16,19,0.15789473684210525,0.8421052631578947
5935,9,2,5,0,5,1.0,0.0
6073,9,2,6,9,15,0.4,0.6
5980,9,2,9,36,45,0.2,0.8
5993,9,2,9,474,483,0.018633540372670808,0.9813664596273292
6037,9,2,5,218,223,0.02242152466367713,0.9775784753363229
5979,9,2,4,1,5,0.8,0.2
5966,9,2,0,73,73,0.0,1.0
5985,9,2,2,1,3,0.6666666666666666,0.3333333333333333
5967,9,2,0,76,76,0.0,1.0
6188,9,2,2,20,22,0.09090909090909091,0.9090909090909091
6041,9,2,0,12,12,0.0,1.0
5972,9,2,7,6,13,0.5384615384615384,0.46153846153846156
6069,9,2,0,4,4,0.0,1.0
5937,9,2,1,0,1,1.0,0.0
6028,9,2,9,22,31,0.2903225806451613,0.7096774193548387
5990,9,2,0,130,130,0.0,1.0
5928,9,2,12,469,481,0.02494802494802495,0.975051975051975
5992,9,2,4,0,4,1.0,0.0
6058,9,2,6,7,13,0.46153846153846156,0.5384615384615384
6001,9,2,2,27,29,0.06896551724137931,0.9310344827586207
5964,9,2,8,23,31,0.25806451612903225,0.7419354838709677
5950,9,2,2,2,4,0.5,0.5
5991,9,2,2,6,8,0.25,0.75
6177,9,2,4,305,309,0.012944983818770227,0.9870550161812298
5961,9,2,0,321,321,0.0,1.0
6176,9,2,0,93,93,0.0,1.0
5956,9,2,0,31,31,0.0,1.0
5938,9,2,3,636,639,0.004694835680751174,0.9953051643192489
6179,9,2,3,25,28,0.10714285714285714,0.8928571428571429
5947,9,2,15,45,60,0.25,0.75
5927,9,2,1,454,455,0.002197802197802198,0.9978021978021978
5977,9,2,0,306,306,0.0,1.0
6198,9,2,0,5,5,0.0,1.0
5957,9,2,0,45,45,0.0,1.0
6057,9,2,2,27,29,0.06896551724137931,0.9310344827586207
6043,9,2,8,0,8,1.0,0.0
6077,9,2,0,4,4,0.0,1.0
6014,9,2,7,7,14,0.5,0.5
6015,9,2,1,2,3,0.3333333333333333,0.6666666666666666
5978,9,2,2,1,3,0.6666666666666666,0.3333333333333333
5986,9,2,2,48,50,0.04,0.96
5959,9,2,6,353,359,0.016713091922005572,0.9832869080779945
6051,9,2,8,30,38,0.21052631578947367,0.7894736842105263
6029,9,2,2,1,3,0.6666666666666666,0.3333333333333333
6070,9,2,1,0,1,1.0,0.0
5942,9,2,0,145,145,0.0,1.0
5953,9,2,3,1,4,0.75,0.25
6076,9,2,4,3,7,0.5714285714285714,0.42857142857142855
5940,9,2,3,7,10,0.3,0.7
6109,9,2,6,87,93,0.06451612903225806,0.9354838709677419
6187,9,2,2,1,3,0.6666666666666666,0.3333333333333333
6053,9,2,0,17,17,0.0,1.0
6104,9,2,8,1,9,0.8888888888888888,0.1111111111111111
5943,9,2,1,1,2,0.5,0.5
6017,9,2,3,0,3,1.0,0.0
6168,9,2,5,11,16,0.3125,0.6875
5989,9,2,2,4,6,0.3333333333333333,0.6666666666666666
5963,9,2,6,0,6,1.0,0.0
6194,9,2,0,26,26,0.0,1.0
6167,9,2,7,12,19,0.3684210526315789,0.631578947368421
6004,9,2,1,63,64,0.015625,0.984375
6030,9,2,6,1,7,0.8571428571428571,0.14285714285714285
6054,9,2,4,2,6,0.6666666666666666,0.3333333333333333
6032,9,2,6,6,12,0.5,0.5
6170,9,2,11,53,64,0.171875,0.828125
6063,9,2,3,0,3,1.0,0.0
5988,9,2,1,0,1,1.0,0.0
6075,9,2,0,3,3,0.0,1.0
6061,9,2,0,67,67,0.0,1.0
5965,9,2,5,44,49,0.10204081632653061,0.8979591836734694
6040,9,2,9,1,10,0.9,0.1
6059,9,2,0,85,85,0.0,1.0
6106,9,2,3,60,63,0.047619047619047616,0.9523809523809523
6031,9,2,2,12,14,0.14285714285714285,0.8571428571428571
6180,9,2,0,6,6,0.0,1.0
6039,9,2,4,59,63,0.06349206349206349,0.9365079365079365
6189,10,2,0,18,18,0.0,1.0
5936,10,2,4,2,6,0.6666666666666666,0.3333333333333333
6087,10,2,3,8,11,0.2727272727272727,0.7272727272727273
5973,10,2,1,847,848,0.0011792452830188679,0.9988207547169812
6085,10,2,8,4,12,0.6666666666666666,0.3333333333333333
6012,10,2,0,62,62,0.0,1.0
5982,10,2,1,5,6,0.16666666666666666,0.8333333333333334
5948,10,2,0,57,57,0.0,1.0
5974,10,2,3,3,6,0.5,0.5
6090,10,2,0,4,4,0.0,1.0
6068,10,2,3,0,3,1.0,0.0
5962,10,2,2,39,41,0.04878048780487805,0.9512195121951219
6033,10,2,0,1,1,0.0,1.0
6038,10,2,2,0,2,1.0,0.0
6042,10,2,5,92,97,0.05154639175257732,0.9484536082474226
5924,10,2,2,1,3,0.6666666666666666,0.3333333333333333
6083,10,2,0,27,27,0.0,1.0
6178,10,2,11,7,18,0.6111111111111112,0.3888888888888889
5958,10,2,2,2,4,0.5,0.5
6086,10,2,0,14,14,0.0,1.0
5945,10,2,2,17,19,0.10526315789473684,0.8947368421052632
5935,10,2,3,2,5,0.6,0.4
6073,10,2,6,9,15,0.4,0.6
5980,10,2,11,34,45,0.24444444444444444,0.7555555555555555
5993,10,2,2,481,483,0.004140786749482402,0.9958592132505176
6037,10,2,1,222,223,0.004484304932735426,0.9955156950672646
5979,10,2,4,1,5,0.8,0.2
5966,10,2,0,73,73,0.0,1.0
5985,10,2,2,1,3,0.6666666666666666,0.3333333333333333
5967,10,2,0,76,76,0.0,1.0
6188,10,2,4,18,22,0.18181818181818182,0.8181818181818182
6041,10,2,0,12,12,0.0,1.0
5972,10,2,6,7,13,0.46153846153846156,0.5384615384615384
6069,10,2,2,2,4,0.5,0.5
5937,10,2,1,0,1,1.0,0.0
6028,10,2,5,26,31,0.16129032258064516,0.8387096774193549
5990,10,2,0,130,130,0.0,1.0
5928,10,2,11,470,481,0.02286902286902287,0.9771309771309772
5992,10,2,2,2,4,0.5,0.5
6058,10,2,6,7,13,0.46153846153846156,0.5384615384615384
6001,10,2,2,27,29,0.06896551724137931,0.9310344827586207
5964,10,2,9,22,31,0.2903225806451613,0.7096774193548387
5950,10,2,2,2,4,0.5,0.5
5991,10,2,1,7,8,0.125,0.875
6177,10,2,6,303,309,0.019417475728155338,0.9805825242718447
5961,10,2,0,321,321,0.0,1.0
6176,10,2,0,93,93,0.0,1.0
5956,10,2,0,31,31,0.0,1.0
5938,10,2,2,637,639,0.003129890453834116,0.9968701095461658
6179,10,2,6,22,28,0.21428571428571427,0.7857142857142857
5947,10,2,6,54,60,0.1,0.9
5927,10,2,2,453,455,0.004395604395604396,0.9956043956043956
5977,10,2,0,306,306,0.0,1.0
6198,10,2,0,5,5,0.0,1.0
5957,10,2,0,45,45,0.0,1.0
6057,10,2,4,25,29,0.13793103448275862,0.8620689655172413
6043,10,2,7,1,8,0.875,0.125
6077,10,2,0,4,4,0.0,1.0
6014,10,2,5,9,14,0.35714285714285715,0.6428571428571429
6015,10,2,1,2,3,0.3333333333333333,0.6666666666666666
5978,10,2,2,1,3,0.6666666666666666,0.3333333333333333
5986,10,2,2,48,50,0.04,0.96
5959,10,2,4,355,359,0.011142061281337047,0.9888579387186629
6051,10,2,7,31,38,0.18421052631578946,0.8157894736842105
6029,10,2,0,3,3,0.0,1.0
6070,10,2,1,0,1,1.0,0.0
5942,10,2,0,145,145,0.0,1.0
5953,10,2,4,0,4,1.0,0.0
6076,10,2,1,6,7,0.14285714285714285,0.8571428571428571
5940,10,2,4,6,10,0.4,0.6
6109,10,2,8,85,93,0.08602150537634409,0.9139784946236559
6187,10,2,2,1,3,0.6666666666666666,0.3333333333333333
6053,10,2,0,17,17,0.0,1.0
6104,10,2,7,2,9,0.7777777777777778,0.2222222222222222
5943,10,2,1,1,2,0.5,0.5
6017,10,2,3,0,3,1.0,0.0
6168,10,2,5,11,16,0.3125,0.6875
5989,10,2,1,5,6,0.16666666666666666,0.8333333333333334
5963,10,2,6,0,6,1.0,0.0
6194,10,2,0,26,26,0.0,1.0
6167,10,2,5,14,19,0.2631578947368421,0.7368421052631579
6004,10,2,0,64,64,0.0,1.0
6030,10,2,5,2,7,0.7142857142857143,0.2857142857142857
6054,10,2,2,4,6,0.3333333333333333,0.6666666666666666
6032,10,2,7,5,12,0.5833333333333334,0.4166666666666667
6170,10,2,12,52,64,0.1875,0.8125
6063,10,2,3,0,3,1.0,0.0
5988,10,2,1,0,1,1.0,0.0
6075,10,2,3,0,3,1.0,0.0
6061,10,2,0,67,67,0.0,1.0
5965,10,2,6,43,49,0.12244897959183673,0.8775510204081632
6040,10,2,7,3,10,0.7,0.3
6059,10,2,0,85,85,0.0,1.0
6106,10,2,0,63,63,0.0,1.0
6031,10,2,1,13,14,0.07142857142857142,0.9285714285714286
6180,10,2,0,6,6,0.0,1.0
6039,10,2,6,57,63,0.09523809523809523,0.9047619047619048
6189,11,2,0,18,18,0.0,1.0
5936,11,2,5,1,6,0.8333333333333334,0.16666666666666666
6087,11,2,2,9,11,0.18181818181818182,0.8181818181818182
5973,11,2,1,847,848,0.0011792452830188679,0.9988207547169812
6085,11,2,4,8,12,0.3333333333333333,0.6666666666666666
6012,11,2,0,62,62,0.0,1.0
5982,11,2,1,5,6,0.16666666666666666,0.8333333333333334
5948,11,2,0,57,57,0.0,1.0
5974,11,2,4,2,6,0.6666666666666666,0.3333333333333333
6090,11,2,0,4,4,0.0,1.0
6068,11,2,3,0,3,1.0,0.0
5962,11,2,2,39,41,0.04878048780487805,0.9512195121951219
6033,11,2,0,1,1,0.0,1.0
6038,11,2,2,0,2,1.0,0.0
6042,11,2,11,86,97,0.1134020618556701,0.8865979381443299
5924,11,2,1,2,3,0.3333333333333333,0.6666666666666666
6083,11,2,0,27,27,0.0,1.0
6178,11,2,10,8,18,0.5555555555555556,0.4444444444444444
5958,11,2,3,1,4,0.75,0.25
6086,11,2,0,14,14,0.0,1.0
5945,11,2,2,17,19,0.10526315789473684,0.8947368421052632
5935,11,2,3,2,5,0.6,0.4
6073,11,2,6,9,15,0.4,0.6
5980,11,2,6,39,45,0.13333333333333333,0.8666666666666667
5993,11,2,0,483,483,0.0,1.0
6037,11,2,4,219,223,0.017937219730941704,0.9820627802690582
5979,11,2,5,0,5,1.0,0.0
5966,11,2,0,73,73,0.0,1.0
5985,11,2,1,2,3,0.3333333333333333,0.6666666666666666
5967,11,2,0,76,76,0.0,1.0
6188,11,2,3,19,22,0.13636363636363635,0.8636363636363636
6041,11,2,0,12,12,0.0,1.0
5972,11,2,5,8,13,0.38461538461538464,0.6153846153846154
6069,11,2,1,3,4,0.25,0.75
5937,11,2,1,0,1,1.0,0.0
6028,11,2,8,23,31,0.25806451612903225,0.7419354838709677
5990,11,2,0,130,130,0.0,1.0
5928,11,2,7,474,481,0.014553014553014554,0.9854469854469855
5992,11,2,3,1,4,0.75,0.25
6058,11,2,6,7,13,0.46153846153846156,0.5384615384615384
6001,11,2,0,29,29,0.0,1.0
5964,11,2,13,18,31,0.41935483870967744,0.5806451612903226
5950,11,2,3,1,4,0.75,0.25
5991,11,2,2,6,8,0.25,0.75
6177,11,2,6,303,309,0.019417475728155338,0.9805825242718447
5961,11,2,0,321,321,0.0,1.0
6176,11,2,0,93,93,0.0,1.0
5956,11,2,0,31,31,0.0,1.0
5938,11,2,2,637,639,0.003129890453834116,0.9968701095461658
6179,11,2,4,24,28,0.14285714285714285,0.8571428571428571
5947,11,2,10,50,60,0.16666666666666666,0.8333333333333334
5927,11,2,1,454,455,0.002197802197802198,0.9978021978021978
5977,11,2,1,305,306,0.0032679738562091504,0.9967320261437909
6198,11,2,0,5,5,0.0,1.0
5957,11,2,0,45,45,0.0,1.0
6057,11,2,2,27,29,0.06896551724137931,0.9310344827586207
6043,11,2,8,0,8,1.0,0.0
6077,11,2,0,4,4,0.0,1.0
6014,11,2,4,10,14,0.2857142857142857,0.7142857142857143
6015,11,2,1,2,3,0.3333333333333333,0.6666666666666666
5978,11,2,2,1,3,0.6666666666666666,0.3333333333333333
5986,11,2,3,47,50,0.06,0.94
5959,11,2,3,356,359,0.008356545961002786,0.9916434540389972
6051,11,2,2,36,38,0.05263157894736842,0.9473684210526315
6029,11,2,0,3,3,0.0,1.0
6070,11,2,1,0,1,1.0,0.0
5942,11,2,0,145,145,0.0,1.0
5953,11,2,4,0,4,1.0,0.0
6076,11,2,2,5,7,0.2857142857142857,0.7142857142857143
5940,11,2,2,8,10,0.2,0.8
6109,11,2,4,89,93,0.043010752688172046,0.956989247311828
6187,11,2,1,2,3,0.3333333333333333,0.6666666666666666
6053,11,2,0,17,17,0.0,1.0
6104,11,2,4,5,9,0.4444444444444444,0.5555555555555556
5943,11,2,0,2,2,0.0,1.0
6017,11,2,2,1,3,0.6666666666666666,0.3333333333333333
6168,11,2,5,11,16,0.3125,0.6875
5989,11,2,1,5,6,0.16666666666666666,0.8333333333333334
5963,11,2,5,1,6,0.8333333333333334,0.16666666666666666
6194,11,2,0,26,26,0.0,1.0
6167,11,2,4,15,19,0.21052631578947367,0.7894736842105263
6004,11,2,0,64,64,0.0,1.0
6030,11,2,5,2,7,0.7142857142857143,0.2857142857142857
6054,11,2,3,3,6,0.5,0.5
6032,11,2,4,8,12,0.3333333333333333,0.6666666666666666
6170,11,2,5,59,64,0.078125,0.921875
6063,11,2,3,0,3,1.0,0.0
5988,11,2,1,0,1,1.0,0.0
6075,11,2,1,2,3,0.3333333333333333,0.6666666666666666
6061,11,2,0,67,67,0.0,1.0
5965,11,2,0,49,49,0.0,1.0
6040,11,2,7,3,10,0.7,0.3
6059,11,2,0,85,85,0.0,1.0
6106,11,2,0,63,63,0.0,1.0
6031,11,2,3,11,14,0.21428571428571427,0.7857142857142857
6180,11,2,0,6,6,0.0,1.0
6039,11,2,7,56,63,0.1111111111111111,0.8888888888888888
6189,12,2,0,18,18,0.0,1.0
5936,12,2,4,2,6,0.6666666666666666,0.3333333333333333
6087,12,2,1,10,11,0.09090909090909091,0.9090909090909091
5973,12,2,0,848,848,0.0,1.0
6085,12,2,2,10,12,0.16666666666666666,0.8333333333333334
6012,12,2,0,62,62,0.0,1.0
5982,12,2,0,6,6,0.0,1.0
5948,12,2,0,57,57,0.0,1.0
5974,12,2,2,4,6,0.3333333333333333,0.6666666666666666
6090,12,2,0,4,4,0.0,1.0
6068,12,2,3,0,3,1.0,0.0
5962,12,2,4,37,41,0.0975609756097561,0.9024390243902439
6033,12,2,0,1,1,0.0,1.0
6038,12,2,2,0,2,1.0,0.0
6042,12,2,3,94,97,0.030927835051546393,0.9690721649484536
5924,12,2,1,2,3,0.3333333333333333,0.6666666666666666
6083,12,2,0,27,27,0.0,1.0
6178,12,2,10,8,18,0.5555555555555556,0.4444444444444444
5958,12,2,2,2,4,0.5,0.5
6086,12,2,0,14,14,0.0,1.0
5945,12,2,2,17,19,0.10526315789473684,0.8947368421052632
5935,12,2,3,2,5,0.6,0.4
6073,12,2,2,13,15,0.13333333333333333,0.8666666666666667
5980,12,2,1,44,45,0.022222222222222223,0.9777777777777777
5993,12,2,1,482,483,0.002070393374741201,0.9979296066252588
6037,12,2,1,222,223,0.004484304932735426,0.9955156950672646
5979,12,2,3,2,5,0.6,0.4
5966,12,2,0,73,73,0.0,1.0
5985,12,2,1,2,3,0.3333333333333333,0.6666666666666666
5967,12,2,0,76,76,0.0,1.0
6188,12,2,2,20,22,0.09090909090909091,0.9090909090909091
6041,12,2,0,12,12,0.0,1.0
5972,12,2,8,5,13,0.6153846153846154,0.38461538461538464
6069,12,2,1,3,4,0.25,0.75
5937,12,2,1,0,1,1.0,0.0
6028,12,2,7,24,31,0.22580645161290322,0.7741935483870968
5990,12,2,0,130,130,0.0,1.0
5928,12,2,3,478,481,0.006237006237006237,0.9937629937629938
5992,12,2,2,2,4,0.5,0.5
6058,12,2,4,9,13,0.3076923076923077,0.6923076923076923
6001,12,2,0,29,29,0.0,1.0
5964,12,2,9,22,31,0.2903225806451613,0.7096774193548387
5950,12,2,1,3,4,0.25,0.75
5991,12,2,1,7,8,0.125,0.875
6177,12,2,6,303,309,0.019417475728155338,0.9805825242718447
5961,12,2,0,321,321,0.0,1.0
6176,12,2,0,93,93,0.0,1.0
5956,12,2,0,31,31,0.0,1.0
5938,12,2,1,638,639,0.001564945226917058,0.9984350547730829
6179,12,2,3,25,28,0.10714285714285714,0.8928571428571429
5947,12,2,2,58,60,0.03333333333333333,0.9666666666666667
5927,12,2,1,454,455,0.002197802197802198,0.9978021978021978
5977,12,2,1,305,306,0.0032679738562091504,0.9967320261437909
6198,12,2,0,5,5,0.0,1.0
5957,12,2,0,45,45,0.0,1.0
6057,12,2,2,27,29,0.06896551724137931,0.9310344827586207
6043,12,2,7,1,8,0.875,0.125
6077,12,2,0,4,4,0.0,1.0
6014,12,2,4,10,14,0.2857142857142857,0.7142857142857143
6015,12,2,1,2,3,0.3333333333333333,0.6666666666666666
5978,12,2,1,2,3,0.3333333333333333,0.6666666666666666
5986,12,2,3,47,50,0.06,0.94
5959,12,2,5,354,359,0.013927576601671309,0.9860724233983287
6051,12,2,5,33,38,0.13157894736842105,0.868421052631579
6029,12,2,1,2,3,0.3333333333333333,0.6666666666666666
6070,12,2,1,0,1,1.0,0.0
5942,12,2,0,145,145,0.0,1.0
5953,12,2,3,1,4,0.75,0.25
6076,12,2,3,4,7,0.42857142857142855,0.5714285714285714
5940,12,2,3,7,10,0.3,0.7
6109,12,2,8,85,93,0.08602150537634409,0.9139784946236559
6187,12,2,1,2,3,0.3333333333333333,0.6666666666666666
6053,12,2,0,17,17,0.0,1.0
6104,12,2,5,4,9,0.5555555555555556,0.4444444444444444
5943,12,2,1,1,2,0.5,0.5
6017,12,2,2,1,3,0.6666666666666666,0.3333333333333333
6168,12,2,9,7,16,0.5625,0.4375
5989,12,2,1,5,6,0.16666666666666666,0.8333333333333334
5963,12,2,5,1,6,0.8333333333333334,0.16666666666666666
6194,12,2,0,26,26,0.0,1.0
6167,12,2,2,17,19,0.10526315789473684,0.8947368421052632
6004,12,2,1,63,64,0.015625,0.984375
6030,12,2,7,0,7,1.0,0.0
6054,12,2,1,5,6,0.16666666666666666,0.8333333333333334
6032,12,2,5,7,12,0.4166666666666667,0.5833333333333334
6170,12,2,7,57,64,0.109375,0.890625
6063,12,2,3,0,3,1.0,0.0
5988,12,2,1,0,1,1.0,0.0
6075,12,2,0,3,3,0.0,1.0
6061,12,2,0,67,67,0.0,1.0
5965,12,2,5,44,49,0.10204081632653061,0.8979591836734694
6040,12,2,4,6,10,0.4,0.6
6059,12,2,0,85,85,0.0,1.0
6106,12,2,0,63,63,0.0,1.0
6031,12,2,3,11,14,0.21428571428571427,0.7857142857142857
6180,12,2,0,6,6,0.0,1.0
6039,12,2,2,61,63,0.031746031746031744,0.9682539682539683
6189,13,2,0,18,18,0.0,1.0
5936,13,2,3,3,6,0.5,0.5
6087,13,2,1,10,11,0.09090909090909091,0.9090909090909091
5973,13,2,0,848,848,0.0,1.0
6085,13,2,4,8,12,0.3333333333333333,0.6666666666666666
6012,13,2,0,62,62,0.0,1.0
5982,13,2,0,6,6,0.0,1.0
5948,13,2,0,57,57,0.0,1.0
5974,13,2,2,4,6,0.3333333333333333,0.6666666666666666
6090,13,2,0,4,4,0.0,1.0
6068,13,2,3,0,3,1.0,0.0
5962,13,2,7,34,41,0.17073170731707318,0.8292682926829268
6033,13,2,0,1,1,0.0,1.0
6038,13,2,2,0,2,1.0,0.0
6042,13,2,5,92,97,0.05154639175257732,0.9484536082474226
5924,13,2,0,3,3,0.0,1.0
6083,13,2,0,27,27,0.0,1.0
6178,13,2,6,12,18,0.3333333333333333,0.6666666666666666
5958,13,2,3,1,4,0.75,0.25
6086,13,2,0,14,14,0.0,1.0
5945,13,2,2,17,19,0.10526315789473684,0.8947368421052632
5935,13,2,2,3,5,0.4,0.6
6073,13,2,3,12,15,0.2,0.8
5980,13,2,2,43,45,0.044444444444444446,0.9555555555555556
5993,13,2,4,479,483,0.008281573498964804,0.9917184265010351
6037,13,2,1,222,223,0.004484304932735426,0.9955156950672646
5979,13,2,3,2,5,0.6,0.4
5966,13,2,0,73,73,0.0,1.0
5985,13,2,1,2,3,0.3333333333333333,0.6666666666666666
5967,13,2,0,76,76,0.0,1.0
6188,13,2,2,20,22,0.09090909090909091,0.9090909090909091
6041,13,2,0,12,12,0.0,1.0
5972,13,2,7,6,13,0.5384615384615384,0.46153846153846156
6069,13,2,2,2,4,0.5,0.5
5937,13,2,1,0,1,1.0,0.0
6028,13,2,6,25,31,0.1935483870967742,0.8064516129032258
5990,13,2,0,130,130,0.0,1.0
5928,13,2,2,479,481,0.004158004158004158,0.9958419958419958
5992,13,2,2,2,4,0.5,0.5
6058,13,2,3,10,13,0.23076923076923078,0.7692307692307693
6001,13,2,2,27,29,0.06896551724137931,0.9310344827586207
5964,13,2,6,25,31,0.1935483870967742,0.8064516129032258
5950,13,2,1,3,4,0.25,0.75
5991,13,2,1,7,8,0.125,0.875
6177,13,2,4,305,309,0.012944983818770227,0.9870550161812298
5961,13,2,0,321,321,0.0,1.0
6176,13,2,0,93,93,0.0,1.0
5956,13,2,0,31,31,0.0,1.0
5938,13,2,2,637,639,0.003129890453834116,0.9968701095461658
6179,13,2,1,27,28,0.03571428571428571,0.9642857142857143
5947,13,2,3,57,60,0.05,0.95
5927,13,2,0,455,455,0.0,1.0
5977,13,2,0,306,306,0.0,1.0
6198,13,2,0,5,5,0.0,1.0
5957,13,2,0,45,45,0.0,1.0
6057,13,2,1,28,29,0.034482758620689655,0.9655172413793104
6043,13,2,6,2,8,0.75,0.25
6077,13,2,0,4,4,0.0,1.0
6014,13,2,5,9,14,0.35714285714285715,0.6428571428571429
6015,13,2,2,1,3,0.6666666666666666,0.3333333333333333
5978,13,2,1,2,3,0.3333333333333333,0.6666666666666666
5986,13,2,5,45,50,0.1,0.9
5959,13,2,2,357,359,0.005571030640668524,0.9944289693593314
6051,13,2,2,36,38,0.05263157894736842,0.9473684210526315
6029,13,2,1,2,3,0.3333333333333333,0.6666666666666666
6070,13,2,1,0,1,1.0,0.0
5942,13,2,0,145,145,0.0,1.0
5953,13,2,3,1,4,0.75,0.25
6076,13,2,1,6,7,0.14285714285714285,0.8571428571428571
5940,13,2,1,9,10,0.1,0.9
6109,13,2,2,91,93,0.021505376344086023,0.978494623655914
6187,13,2,1,2,3,0.3333333333333333,0.6666666666666666
6053,13,2,0,17,17,0.0,1.0
6104,13,2,3,6,9,0.3333333333333333,0.6666666666666666
5943,13,2,1,1,2,0.5,0.5
6017,13,2,2,1,3,0.6666666666666666,0.3333333333333333
6168,13,2,3,13,16,0.1875,0.8125
5989,13,2,1,5,6,0.16666666666666666,0.8333333333333334
5963,13,2,5,1,6,0.8333333333333334,0.16666666666666666
6194,13,2,0,26,26,0.0,1.0
6167,13,2,2,17,19,0.10526315789473684,0.8947368421052632
6004,13,2,0,64,64,0.0,1.0
6030,13,2,5,2,7,0.7142857142857143,0.2857142857142857
6054,13,2,3,3,6,0.5,0.5
6032,13,2,5,7,12,0.4166666666666667,0.5833333333333334
6170,13,2,8,56,64,0.125,0.875
6063,13,2,3,0,3,1.0,0.0
5988,13,2,1,0,1,1.0,0.0
6075,13,2,0,3,3,0.0,1.0
6061,13,2,0,67,67,0.0,1.0
5965,13,2,5,44,49,0.10204081632653061,0.8979591836734694
6040,13,2,4,6,10,0.4,0.6
6059,13,2,0,85,85,0.0,1.0
6106,13,2,0,63,63,0.0,1.0
6031,13,2,4,10,14,0.2857142857142857,0.7142857142857143
6180,13,2,0,6,6,0.0,1.0
6039,13,2,4,59,63,0.06349206349206349,0.9365079365079365
6189,14,2,0,18,18,0.0,1.0
5936,14,2,4,2,6,0.6666666666666666,0.3333333333333333
6087,14,2,2,9,11,0.18181818181818182,0.8181818181818182
5973,14,2,3,845,848,0.003537735849056604,0.9964622641509434
6085,14,2,2,10,12,0.16666666666666666,0.8333333333333334
6012,14,2,0,62,62,0.0,1.0
5982,14,2,0,6,6,0.0,1.0
5948,14,2,0,57,57,0.0,1.0
5974,14,2,2,4,6,0.3333333333333333,0.6666666666666666
6090,14,2,0,4,4,0.0,1.0
6068,14,2,3,0,3,1.0,0.0
5962,14,2,2,39,41,0.04878048780487805,0.9512195121951219
6033,14,2,0,1,1,0.0,1.0
6038,14,2,1,1,2,0.5,0.5
6042,14,2,6,91,97,0.061855670103092786,0.9381443298969072
5924,14,2,1,2,3,0.3333333333333333,0.6666666666666666
6083,14,2,0,27,27,0.0,1.0
6178,14,2,4,14,18,0.2222222222222222,0.7777777777777778
5958,14,2,4,0,4,1.0,0.0
6086,14,2,0,14,14,0.0,1.0
5945,14,2,1,18,19,0.05263157894736842,0.9473684210526315
5935,14,2,1,4,5,0.2,0.8
6073,14,2,4,11,15,0.26666666666666666,0.7333333333333333
5980,14,2,4,41,45,0.08888888888888889,0.9111111111111111
5993,14,2,2,481,483,0.004140786749482402,0.9958592132505176
6037,14,2,0,223,223,0.0,1.0
5979,14,2,2,3,5,0.4,0.6
5966,14,2,0,73,73,0.0,1.0
5985,14,2,0,3,3,0.0,1.0
5967,14,2,0,76,76,0.0,1.0
6188,14,2,1,21,22,0.045454545454545456,0.9545454545454546
6041,14,2,0,12,12,0.0,1.0
5972,14,2,5,8,13,0.38461538461538464,0.6153846153846154
6069,14,2,2,2,4,0.5,0.5
5937,14,2,1,0,1,1.0,0.0
6028,14,2,3,28,31,0.0967741935483871,0.9032258064516129
5990,14,2,0,130,130,0.0,1.0
5928,14,2,7,474,481,0.014553014553014554,0.9854469854469855
5992,14,2,2,2,4,0.5,0.5
6058,14,2,1,12,13,0.07692307692307693,0.9230769230769231
6001,14,2,2,27,29,0.06896551724137931,0.9310344827586207
5964,14,2,5,26,31,0.16129032258064516,0.8387096774193549
5950,14,2,3,1,4,0.75,0.25
5991,14,2,0,8,8,0.0,1.0
6177,14,2,1,308,309,0.003236245954692557,0.9967637540453075
5961,14,2,0,321,321,0.0,1.0
6176,14,2,0,93,93,0.0,1.0
5956,14,2,0,31,31,0.0,1.0
5938,14,2,1,638,639,0.001564945226917058,0.9984350547730829
6179,14,2,1,27,28,0.03571428571428571,0.9642857142857143
5947,14,2,7,53,60,0.11666666666666667,0.8833333333333333
5927,14,2,0,455,455,0.0,1.0
5977,14,2,0,306,306,0.0,1.0
6198,14,2,0,5,5,0.0,1.0
5957,14,2,0,45,45,0.0,1.0
6057,14,2,4,25,29,0.13793103448275862,0.8620689655172413
6043,14,2,7,1,8,0.875,0.125
6077,14,2,0,4,4,0.0,1.0
6014,14,2,7,7,14,0.5,0.5
6015,14,2,1,2,3,0.3333333333333333,0.6666666666666666
5978,14,2,1,2,3,0.3333333333333333,0.6666666666666666
5986,14,2,2,48,50,0.04,0.96
5959,14,2,4,355,359,0.011142061281337047,0.9888579387186629
6051,14,2,1,37,38,0.02631578947368421,0.9736842105263158
6029,14,2,1,2,3,0.3333333333333333,0.6666666666666666
6070,14,2,1,0,1,1.0,0.0
5942,14,2,0,145,145,0.0,1.0
5953,14,2,2,2,4,0.5,0.5
6076,14,2,0,7,7,0.0,1.0
5940,14,2,1,9,10,0.1,0.9
6109,14,2,4,89,93,0.043010752688172046,0.956989247311828
6187,14,2,1,2,3,0.3333333333333333,0.6666666666666666
6053,14,2,0,17,17,0.0,1.0
6104,14,2,2,7,9,0.2222222222222222,0.7777777777777778
5943,14,2,1,1,2,0.5,0.5
6017,14,2,2,1,3,0.6666666666666666,0.3333333333333333
6168,14,2,3,13,16,0.1875,0.8125
5989,14,2,0,6,6,0.0,1.0
5963,14,2,5,1,6,0.8333333333333334,0.16666666666666666
6194,14,2,0,26,26,0.0,1.0
6167,14,2,1,18,19,0.05263157894736842,0.9473684210526315
6004,14,2,0,64,64,0.0,1.0
6030,14,2,5,2,7,0.7142857142857143,0.2857142857142857
6054,14,2,1,5,6,0.16666666666666666,0.8333333333333334
6032,14,2,3,9,12,0.25,0.75
6170,14,2,4,60,64,0.0625,0.9375
6063,14,2,3,0,3,1.0,0.0
5988,14,2,1,0,1,1.0,0.0
6075,14,2,0,3,3,0.0,1.0
6061,14,2,0,67,67,0.0,1.0
5965,14,2,7,42,49,0.14285714285714285,0.8571428571428571
6040,14,2,2,8,10,0.2,0.8
6059,14,2,0,85,85,0.0,1.0
6106,14,2,2,61,63,0.031746031746031744,0.9682539682539683
6031,14,2,3,11,14,0.21428571428571427,0.7857142857142857
6180,14,2,0,6,6,0.0,1.0
6039,14,2,6,57,63,0.09523809523809523,0.9047619047619048
6189,15,2,0,18,18,0.0,1.0
5936,15,2,1,5,6,0.16666666666666666,0.8333333333333334
6087,15,2,4,7,11,0.36363636363636365,0.6363636363636364
5973,15,2,0,848,848,0.0,1.0
6085,15,2,1,11,12,0.08333333333333333,0.9166666666666666
6012,15,2,0,62,62,0.0,1.0
5982,15,2,1,5,6,0.16666666666666666,0.8333333333333334
5948,15,2,0,57,57,0.0,1.0
5974,15,2,3,3,6,0.5,0.5
6090,15,2,0,4,4,0.0,1.0
6068,15,2,2,1,3,0.6666666666666666,0.3333333333333333
5962,15,2,0,41,41,0.0,1.0
6033,15,2,0,1,1,0.0,1.0
6038,15,2,2,0,2,1.0,0.0
6042,15,2,5,92,97,0.05154639175257732,0.9484536082474226
5924,15,2,1,2,3,0.3333333333333333,0.6666666666666666
6083,15,2,0,27,27,0.0,1.0
6178,15,2,7,11,18,0.3888888888888889,0.6111111111111112
5958,15,2,2,2,4,0.5,0.5
6086,15,2,0,14,14,0.0,1.0
5945,15,2,0,19,19,0.0,1.0
5935,15,2,2,3,5,0.4,0.6
6073,15,2,5,10,15,0.3333333333333333,0.6666666666666666
5980,15,2,3,42,45,0.06666666666666667,0.9333333333333333
5993,15,2,1,482,483,0.002070393374741201,0.9979296066252588
6037,15,2,0,223,223,0.0,1.0
5979,15,2,3,2,5,0.6,0.4
5966,15,2,0,73,73,0.0,1.0
5985,15,2,0,3,3,0.0,1.0
5967,15,2,0,76,76,0.0,1.0
6188,15,2,2,20,22,0.09090909090909091,0.9090909090909091
6041,15,2,0,12,12,0.0,1.0
5972,15,2,5,8,13,0.38461538461538464,0.6153846153846154
6069,15,2,1,3,4,0.25,0.75
5937,15,2,1,0,1,1.0,0.0
6028,15,2,6,25,31,0.1935483870967742,0.8064516129032258
5990,15,2,0,130,130,0.0,1.0
5928,15,2,3,478,481,0.006237006237006237,0.9937629937629938
5992,15,2,2,2,4,0.5,0.5
6058,15,2,0,13,13,0.0,1.0
6001,15,2,2,27,29,0.06896551724137931,0.9310344827586207
5964,15,2,3,28,31,0.0967741935483871,0.9032258064516129
5950,15,2,2,2,4,0.5,0.5
5991,15,2,2,6,8,0.25,0.75
6177,15,2,0,309,309,0.0,1.0
5961,15,2,0,321,321,0.0,1.0
6176,15,2,0,93,93,0.0,1.0
5956,15,2,0,31,31,0.0,1.0
5938,15,2,0,639,639,0.0,1.0
6179,15,2,3,25,28,0.10714285714285714,0.8928571428571429
5947,15,2,2,58,60,0.03333333333333333,0.9666666666666667
5927,15,2,0,455,455,0.0,1.0
5977,15,2,0,306,306,0.0,1.0
6198,15,2,0,5,5,0.0,1.0
5957,15,2,0,45,45,0.0,1.0
6057,15,2,0,29,29,0.0,1.0
6043,15,2,6,2,8,0.75,0.25
6077,15,2,0,4,4,0.0,1.0
6014,15,2,4,10,14,0.2857142857142857,0.7142857142857143
6015,15,2,0,3,3,0.0,1.0
5978,15,2,0,3,3,0.0,1.0
5986,15,2,1,49,50,0.02,0.98
5959,15,2,2,357,359,0.005571030640668524,0.9944289693593314
6051,15,2,2,36,38,0.05263157894736842,0.9473684210526315
6029,15,2,1,2,3,0.3333333333333333,0.6666666666666666
6070,15,2,0,1,1,0.0,1.0
5942,15,2,0,145,145,0.0,1.0
5953,15,2,1,3,4,0.25,0.75
6076,15,2,3,4,7,0.42857142857142855,0.5714285714285714
5940,15,2,1,9,10,0.1,0.9
6109,15,2,3,90,93,0.03225806451612903,0.967741935483871
6187,15,2,1,2,3,0.3333333333333333,0.6666666666666666
6053,15,2,0,17,17,0.0,1.0
6104,15,2,2,7,9,0.2222222222222222,0.7777777777777778
5943,15,2,1,1,2,0.5,0.5
6017,15,2,2,1,3,0.6666666666666666,0.3333333333333333
6168,15,2,3,13,16,0.1875,0.8125
5989,15,2,0,6,6,0.0,1.0
5963,15,2,6,0,6,1.0,0.0
6194,15,2,0,26,26,0.0,1.0
6167,15,2,0,19,19,0.0,1.0
6004,15,2,1,63,64,0.015625,0.984375
6030,15,2,5,2,7,0.7142857142857143,0.2857142857142857
6054,15,2,1,5,6,0.16666666666666666,0.8333333333333334
6032,15,2,2,10,12,0.16666666666666666,0.8333333333333334
6170,15,2,4,60,64,0.0625,0.9375
6063,15,2,3,0,3,1.0,0.0
5988,15,2,1,0,1,1.0,0.0
6075,15,2,0,3,3,0.0,1.0
6061,15,2,0,67,67,0.0,1.0
5965,15,2,1,48,49,0.02040816326530612,0.9795918367346939
6040,15,2,3,7,10,0.3,0.7
6059,15,2,0,85,85,0.0,1.0
6106,15,2,1,62,63,0.015873015873015872,0.9841269841269841
6031,15,2,3,11,14,0.21428571428571427,0.7857142857142857
6180,15,2,0,6,6,0.0,1.0
6039,15,2,3,60,63,0.047619047619047616,0.9523809523809523
6189,16,2,0,18,18,0.0,1.0
5936,16,2,0,6,6,0.0,1.0
6087,16,2,2,9,11,0.18181818181818182,0.8181818181818182
5973,16,2,1,847,848,0.0011792452830188679,0.9988207547169812
6085,16,2,3,9,12,0.25,0.75
6012,16,2,0,62,62,0.0,1.0
5982,16,2,1,5,6,0.16666666666666666,0.8333333333333334
5948,16,2,0,57,57,0.0,1.0
5974,16,2,4,2,6,0.6666666666666666,0.3333333333333333
6090,16,2,0,4,4,0.0,1.0
6068,16,2,2,1,3,0.6666666666666666,0.3333333333333333
5962,16,2,0,41,41,0.0,1.0
6033,16,2,0,1,1,0.0,1.0
6038,16,2,2,0,2,1.0,0.0
6042,16,2,2,95,97,0.020618556701030927,0.979381443298969
5924,16,2,0,3,3,0.0,1.0
6083,16,2,0,27,27,0.0,1.0
6178,16,2,3,15,18,0.16666666666666666,0.8333333333333334
5958,16,2,2,2,4,0.5,0.5
6086,16,2,0,14,14,0.0,1.0
5945,16,2,0,19,19,0.0,1.0
5935,16,2,2,3,5,0.4,0.6
6073,16,2,3,12,15,0.2,0.8
5980,16,2,1,44,45,0.022222222222222223,0.9777777777777777
5993,16,2,2,481,483,0.004140786749482402,0.9958592132505176
6037,16,2,0,223,223,0.0,1.0
5979,16,2,2,3,5,0.4,0.6
5966,16,2,0,73,73,0.0,1.0
5985,16,2,0,3,3,0.0,1.0
5967,16,2,0,76,76,0.0,1.0
6188,16,2,1,21,22,0.045454545454545456,0.9545454545454546
6041,16,2,0,12,12,0.0,1.0
5972,16,2,1,12,13,0.07692307692307693,0.9230769230769231
6069,16,2,1,3,4,0.25,0.75
5937,16,2,1,0,1,1.0,0.0
6028,16,2,5,26,31,0.16129032258064516,0.8387096774193549
5990,16,2,0,130,130,0.0,1.0
5928,16,2,3,478,481,0.006237006237006237,0.9937629937629938
5992,16,2,2,2,4,0.5,0.5
6058,16,2,2,11,13,0.15384615384615385,0.8461538461538461
6001,16,2,1,28,29,0.034482758620689655,0.9655172413793104
5964,16,2,2,29,31,0.06451612903225806,0.9354838709677419
5950,16,2,1,3,4,0.25,0.75
5991,16,2,2,6,8,0.25,0.75
6177,16,2,1,308,309,0.003236245954692557,0.9967637540453075
5961,16,2,0,321,321,0.0,1.0
6176,16,2,0,93,93,0.0,1.0
5956,16,2,0,31,31,0.0,1.0
5938,16,2,2,637,639,0.003129890453834116,0.9968701095461658
6179,16,2,1,27,28,0.03571428571428571,0.9642857142857143
5947,16,2,5,55,60,0.08333333333333333,0.9166666666666666
5927,16,2,0,455,455,0.0,1.0
5977,16,2,0,306,306,0.0,1.0
6198,16,2,0,5,5,0.0,1.0
5957,16,2,0,45,45,0.0,1.0
6057,16,2,2,27,29,0.06896551724137931,0.9310344827586207
6043,16,2,7,1,8,0.875,0.125
6077,16,2,0,4,4,0.0,1.0
6014,16,2,0,14,14,0.0,1.0
6015,16,2,3,0,3,1.0,0.0
5978,16,2,2,1,3,0.6666666666666666,0.3333333333333333
5986,16,2,3,47,50,0.06,0.94
5959,16,2,1,358,359,0.002785515320334262,0.9972144846796658
6051,16,2,0,38,38,0.0,1.0
6029,16,2,1,2,3,0.3333333333333333,0.6666666666666666
6070,16,2,0,1,1,0.0,1.0
5942,16,2,0,145,145,0.0,1.0
5953,16,2,2,2,4,0.5,0.5
6076,16,2,0,7,7,0.0,1.0
5940,16,2,2,8,10,0.2,0.8
6109,16,2,1,92,93,0.010752688172043012,0.989247311827957
6187,16,2,1,2,3,0.3333333333333333,0.6666666666666666
6053,16,2,0,17,17,0.0,1.0
6104,16,2,3,6,9,0.3333333333333333,0.6666666666666666
5943,16,2,1,1,2,0.5,0.5
6017,16,2,2,1,3,0.6666666666666666,0.3333333333333333
6168,16,2,2,14,16,0.125,0.875
5989,16,2,0,6,6,0.0,1.0
5963,16,2,5,1,6,0.8333333333333334,0.16666666666666666
6194,16,2,0,26,26,0.0,1.0
6167,16,2,6,13,19,0.3157894736842105,0.6842105263157895
6004,16,2,1,63,64,0.015625,0.984375
6030,16,2,5,2,7,0.7142857142857143,0.2857142857142857
6054,16,2,2,4,6,0.3333333333333333,0.6666666666666666
6032,16,2,2,10,12,0.16666666666666666,0.8333333333333334
6170,16,2,3,61,64,0.046875,0.953125
6063,16,2,3,0,3,1.0,0.0
5988,16,2,1,0,1,1.0,0.0
6075,16,2,0,3,3,0.0,1.0
6061,16,2,0,67,67,0.0,1.0
5965,16,2,2,47,49,0.04081632653061224,0.9591836734693877
6040,16,2,1,9,10,0.1,0.9
6059,16,2,0,85,85,0.0,1.0
6106,16,2,2,61,63,0.031746031746031744,0.9682539682539683
6031,16,2,1,13,14,0.07142857142857142,0.9285714285714286
6180,16,2,0,6,6,0.0,1.0
6039,16,2,2,61,63,0.031746031746031744,0.9682539682539683
6189,17,2,0,18,18,0.0,1.0
5936,17,2,2,4,6,0.3333333333333333,0.6666666666666666
6087,17,2,1,10,11,0.09090909090909091,0.9090909090909091
5973,17,2,0,848,848,0.0,1.0
6085,17,2,0,12,12,0.0,1.0
6012,17,2,0,62,62,0.0,1.0
5982,17,2,1,5,6,0.16666666666666666,0.8333333333333334
5948,17,2,0,57,57,0.0,1.0
5974,17,2,1,5,6,0.16666666666666666,0.8333333333333334
6090,17,2,0,4,4,0.0,1.0
6068,17,2,3,0,3,1.0,0.0
5962,17,2,2,39,41,0.04878048780487805,0.9512195121951219
6033,17,2,0,1,1,0.0,1.0
6038,17,2,1,1,2,0.5,0.5
6042,17,2,1,96,97,0.010309278350515464,0.9896907216494846
5924,17,2,1,2,3,0.3333333333333333,0.6666666666666666
6083,17,2,0,27,27,0.0,1.0
6178,17,2,7,11,18,0.3888888888888889,0.6111111111111112
5958,17,2,2,2,4,0.5,0.5
6086,17,2,0,14,14,0.0,1.0
5945,17,2,0,19,19,0.0,1.0
5935,17,2,1,4,5,0.2,0.8
6073,17,2,2,13,15,0.13333333333333333,0.8666666666666667
5980,17,2,2,43,45,0.044444444444444446,0.9555555555555556
5993,17,2,1,482,483,0.002070393374741201,0.9979296066252588
6037,17,2,0,223,223,0.0,1.0
5979,17,2,3,2,5,0.6,0.4
5966,17,2,0,73,73,0.0,1.0
5985,17,2,1,2,3,0.3333333333333333,0.6666666666666666
5967,17,2,0,76,76,0.0,1.0
6188,17,2,2,20,22,0.09090909090909091,0.9090909090909091
6041,17,2,0,12,12,0.0,1.0
5972,17,2,7,6,13,0.5384615384615384,0.46153846153846156
6069,17,2,1,3,4,0.25,0.75
5937,17,2,1,0,1,1.0,0.0
6028,17,2,3,28,31,0.0967741935483871,0.9032258064516129
5990,17,2,0,130,130,0.0,1.0
5928,17,2,3,478,481,0.006237006237006237,0.9937629937629938
5992,17,2,3,1,4,0.75,0.25
6058,17,2,1,12,13,0.07692307692307693,0.9230769230769231
6001,17,2,0,29,29,0.0,1.0
5964,17,2,5,26,31,0.16129032258064516,0.8387096774193549
5950,17,2,0,4,4,0.0,1.0
5991,17,2,1,7,8,0.125,0.875
6177,17,2,0,309,309,0.0,1.0
5961,17,2,0,321,321,0.0,1.0
6176,17,2,0,93,93,0.0,1.0
5956,17,2,0,31,31,0.0,1.0
5938,17,2,1,638,639,0.001564945226917058,0.9984350547730829
6179,17,2,0,28,28,0.0,1.0
5947,17,2,2,58,60,0.03333333333333333,0.9666666666666667
5927,17,2,0,455,455,0.0,1.0
5977,17,2,0,306,306,0.0,1.0
6198,17,2,0,5,5,0.0,1.0
5957,17,2,0,45,45,0.0,1.0
6057,17,2,0,29,29,0.0,1.0
6043,17,2,5,3,8,0.625,0.375
6077,17,2,0,4,4,0.0,1.0
6014,17,2,3,11,14,0.21428571428571427,0.7857142857142857
6015,17,2,1,2,3,0.3333333333333333,0.6666666666666666
5978,17,2,2,1,3,0.6666666666666666,0.3333333333333333
5986,17,2,1,49,50,0.02,0.98
5959,17,2,2,357,359,0.005571030640668524,0.9944289693593314
6051,17,2,0,38,38,0.0,1.0
6029,17,2,0,3,3,0.0,1.0
6070,17,2,0,1,1,0.0,1.0
5942,17,2,0,145,145,0.0,1.0
5953,17,2,1,3,4,0.25,0.75
6076,17,2,0,7,7,0.0,1.0
5940,17,2,1,9,10,0.1,0.9
6109,17,2,2,91,93,0.021505376344086023,0.978494623655914
6187,17,2,0,3,3,0.0,1.0
6053,17,2,0,17,17,0.0,1.0
6104,17,2,2,7,9,0.2222222222222222,0.7777777777777778
5943,17,2,1,1,2,0.5,0.5
6017,17,2,2,1,3,0.6666666666666666,0.3333333333333333
6168,17,2,0,16,16,0.0,1.0
5989,17,2,0,6,6,0.0,1.0
5963,17,2,5,1,6,0.8333333333333334,0.16666666666666666
6194,17,2,0,26,26,0.0,1.0
6167,17,2,1,18,19,0.05263157894736842,0.9473684210526315
6004,17,2,1,63,64,0.015625,0.984375
6030,17,2,6,1,7,0.8571428571428571,0.14285714285714285
6054,17,2,2,4,6,0.3333333333333333,0.6666666666666666
6032,17,2,5,7,12,0.4166666666666667,0.5833333333333334
6170,17,2,1,63,64,0.015625,0.984375
6063,17,2,3,0,3,1.0,0.0
5988,17,2,1,0,1,1.0,0.0
6075,17,2,0,3,3,0.0,1.0
6061,17,2,0,67,67,0.0,1.0
5965,17,2,0,49,49,0.0,1.0
6040,17,2,3,7,10,0.3,0.7
6059,17,2,0,85,85,0.0,1.0
6106,17,2,1,62,63,0.015873015873015872,0.9841269841269841
6031,17,2,3,11,14,0.21428571428571427,0.7857142857142857
6180,17,2,0,6,6,0.0,1.0
6039,17,2,1,62,63,0.015873015873015872,0.9841269841269841
6189,18,2,0,18,18,0.0,1.0
5936,18,2,1,5,6,0.16666666666666666,0.8333333333333334
6087,18,2,2,9,11,0.18181818181818182,0.8181818181818182
5973,18,2,0,848,848,0.0,1.0
6085,18,2,2,10,12,0.16666666666666666,0.8333333333333334
6012,18,2,0,62,62,0.0,1.0
5982,18,2,0,6,6,0.0,1.0
5948,18,2,0,57,57,0.0,1.0
5974,18,2,2,4,6,0.3333333333333333,0.6666666666666666
6090,18,2,0,4,4,0.0,1.0
6068,18,2,3,0,3,1.0,0.0
5962,18,2,2,39,41,0.04878048780487805,0.9512195121951219
6033,18,2,0,1,1,0.0,1.0
6038,18,2,1,1,2,0.5,0.5
6042,18,2,4,93,97,0.041237113402061855,0.9587628865979382
5924,18,2,0,3,3,0.0,1.0
6083,18,2,0,27,27,0.0,1.0
6178,18,2,4,14,18,0.2222222222222222,0.7777777777777778
5958,18,2,2,2,4,0.5,0.5
6086,18,2,0,14,14,0.0,1.0
5945,18,2,5,14,19,0.2631578947368421,0.7368421052631579
5935,18,2,4,1,5,0.8,0.2
6073,18,2,1,14,15,0.06666666666666667,0.9333333333333333
5980,18,2,5,40,45,0.1111111111111111,0.8888888888888888
5993,18,2,3,480,483,0.006211180124223602,0.9937888198757764
6037,18,2,0,223,223,0.0,1.0
5979,18,2,2,3,5,0.4,0.6
5966,18,2,0,73,73,0.0,1.0
5985,18,2,0,3,3,0.0,1.0
5967,18,2,0,76,76,0.0,1.0
6188,18,2,5,17,22,0.22727272727272727,0.7727272727272727
6041,18,2,0,12,12,0.0,1.0
5972,18,2,3,10,13,0.23076923076923078,0.7692307692307693
6069,18,2,0,4,4,0.0,1.0
5937,18,2,1,0,1,1.0,0.0
6028,18,2,3,28,31,0.0967741935483871,0.9032258064516129
5990,18,2,0,130,130,0.0,1.0
5928,18,2,4,477,481,0.008316008316008316,0.9916839916839917
5992,18,2,2,2,4,0.5,0.5
6058,18,2,2,11,13,0.15384615384615385,0.8461538461538461
6001,18,2,0,29,29,0.0,1.0
5964,18,2,1,30,31,0.03225806451612903,0.967741935483871
5950,18,2,0,4,4,0.0,1.0
5991,18,2,1,7,8,0.125,0.875
6177,18,2,1,308,309,0.003236245954692557,0.9967637540453075
5961,18,2,0,321,321,0.0,1.0
6176,18,2,0,93,93,0.0,1.0
5956,18,2,0,31,31,0.0,1.0
5938,18,2,1,638,639,0.001564945226917058,0.9984350547730829
6179,18,2,1,27,28,0.03571428571428571,0.9642857142857143
5947,18,2,2,58,60,0.03333333333333333,0.9666666666666667
5927,18,2,1,454,455,0.002197802197802198,0.9978021978021978
5977,18,2,0,306,306,0.0,1.0
6198,18,2,0,5,5,0.0,1.0
5957,18,2,0,45,45,0.0,1.0
6057,18,2,1,28,29,0.034482758620689655,0.9655172413793104
6043,18,2,4,4,8,0.5,0.5
6077,18,2,0,4,4,0.0,1.0
6014,18,2,4,10,14,0.2857142857142857,0.7142857142857143
6015,18,2,2,1,3,0.6666666666666666,0.3333333333333333
5978,18,2,1,2,3,0.3333333333333333,0.6666666666666666
5986,18,2,1,49,50,0.02,0.98
5959,18,2,2,357,359,0.005571030640668524,0.9944289693593314
6051,18,2,0,38,38,0.0,1.0
6029,18,2,0,3,3,0.0,1.0
6070,18,2,0,1,1,0.0,1.0
5942,18,2,0,145,145,0.0,1.0
5953,18,2,2,2,4,0.5,0.5
6076,18,2,1,6,7,0.14285714285714285,0.8571428571428571
5940,18,2,1,9,10,0.1,0.9
6109,18,2,1,92,93,0.010752688172043012,0.989247311827957
6187,18,2,0,3,3,0.0,1.0
6053,18,2,0,17,17,0.0,1.0
6104,18,2,3,6,9,0.3333333333333333,0.6666666666666666
5943,18,2,1,1,2,0.5,0.5
6017,18,2,3,0,3,1.0,0.0
6168,18,2,5,11,16,0.3125,0.6875
5989,18,2,0,6,6,0.0,1.0
5963,18,2,5,1,6,0.8333333333333334,0.16666666666666666
6194,18,2,0,26,26,0.0,1.0
6167,18,2,0,19,19,0.0,1.0
6004,18,2,0,64,64,0.0,1.0
6030,18,2,5,2,7,0.7142857142857143,0.2857142857142857
6054,18,2,1,5,6,0.16666666666666666,0.8333333333333334
6032,18,2,3,9,12,0.25,0.75
6170,18,2,0,64,64,0.0,1.0
6063,18,2,3,0,3,1.0,0.0
5988,18,2,1,0,1,1.0,0.0
6075,18,2,0,3,3,0.0,1.0
6061,18,2,0,67,67,0.0,1.0
5965,18,2,0,49,49,0.0,1.0
6040,18,2,0,10,10,0.0,1.0
6059,18,2,0,85,85,0.0,1.0
6106,18,2,3,60,63,0.047619047619047616,0.9523809523809523
6031,18,2,4,10,14,0.2857142857142857,0.7142857142857143
6180,18,2,0,6,6,0.0,1.0
6039,18,2,2,61,63,0.031746031746031744,0.9682539682539683
6189,19,2,0,18,18,0.0,1.0
5936,19,2,1,5,6,0.16666666666666666,0.8333333333333334
6087,19,2,2,9,11,0.18181818181818182,0.8181818181818182
5973,19,2,0,848,848,0.0,1.0
6085,19,2,3,9,12,0.25,0.75
6012,19,2,0,62,62,0.0,1.0
5982,19,2,1,5,6,0.16666666666666666,0.8333333333333334
5948,19,2,0,57,57,0.0,1.0
5974,19,2,0,6,6,0.0,1.0
6090,19,2,0,4,4,0.0,1.0
6068,19,2,3,0,3,1.0,0.0
5962,19,2,1,40,41,0.024390243902439025,0.975609756097561
6033,19,2,0,1,1,0.0,1.0
6038,19,2,1,1,2,0.5,0.5
6042,19,2,3,94,97,0.030927835051546393,0.9690721649484536
5924,19,2,0,3,3,0.0,1.0
6083,19,2,0,27,27,0.0,1.0
6178,19,2,3,15,18,0.16666666666666666,0.8333333333333334
5958,19,2,2,2,4,0.5,0.5
6086,19,2,0,14,14,0.0,1.0
5945,19,2,0,19,19,0.0,1.0
5935,19,2,2,3,5,0.4,0.6
6073,19,2,2,13,15,0.13333333333333333,0.8666666666666667
5980,19,2,1,44,45,0.022222222222222223,0.9777777777777777
5993,19,2,0,483,483,0.0,1.0
6037,19,2,1,222,223,0.004484304932735426,0.9955156950672646
5979,19,2,4,1,5,0.8,0.2
5966,19,2,0,73,73,0.0,1.0
5985,19,2,0,3,3,0.0,1.0
5967,19,2,0,76,76,0.0,1.0
6188,19,2,1,21,22,0.045454545454545456,0.9545454545454546
6041,19,2,0,12,12,0.0,1.0
5972,19,2,5,8,13,0.38461538461538464,0.6153846153846154
6069,19,2,0,4,4,0.0,1.0
5937,19,2,1,0,1,1.0,0.0
6028,19,2,3,28,31,0.0967741935483871,0.9032258064516129
5990,19,2,0,130,130,0.0,1.0
5928,19,2,2,479,481,0.004158004158004158,0.9958419958419958
5992,19,2,3,1,4,0.75,0.25
6058,19,2,1,12,13,0.07692307692307693,0.9230769230769231
6001,19,2,2,27,29,0.06896551724137931,0.9310344827586207
5964,19,2,4,27,31,0.12903225806451613,0.8709677419354839
5950,19,2,0,4,4,0.0,1.0
5991,19,2,2,6,8,0.25,0.75
6177,19,2,2,307,309,0.006472491909385114,0.9935275080906149
5961,19,2,0,321,321,0.0,1.0
6176,19,2,0,93,93,0.0,1.0
5956,19,2,0,31,31,0.0,1.0
5938,19,2,1,638,639,0.001564945226917058,0.9984350547730829
6179,19,2,2,26,28,0.07142857142857142,0.9285714285714286
5947,19,2,2,58,60,0.03333333333333333,0.9666666666666667
5927,19,2,1,454,455,0.002197802197802198,0.9978021978021978
5977,19,2,0,306,306,0.0,1.0
6198,19,2,0,5,5,0.0,1.0
5957,19,2,0,45,45,0.0,1.0
6057,19,2,1,28,29,0.034482758620689655,0.9655172413793104
6043,19,2,5,3,8,0.625,0.375
6077,19,2,0,4,4,0.0,1.0
6014,19,2,4,10,14,0.2857142857142857,0.7142857142857143
6015,19,2,0,3,3,0.0,1.0
5978,19,2,0,3,3,0.0,1.0
5986,19,2,1,49,50,0.02,0.98
5959,19,2,1,358,359,0.002785515320334262,0.9972144846796658
6051,19,2,1,37,38,0.02631578947368421,0.9736842105263158
6029,19,2,1,2,3,0.3333333333333333,0.6666666666666666
6070,19,2,0,1,1,0.0,1.0
5942,19,2,0,145,145,0.0,1.0
5953,19,2,4,0,4,1.0,0.0
6076,19,2,0,7,7,0.0,1.0
5940,19,2,3,7,10,0.3,0.7
6109,19,2,3,90,93,0.03225806451612903,0.967741935483871
6187,19,2,0,3,3,0.0,1.0
6053,19,2,0,17,17,0.0,1.0
6104,19,2,0,9,9,0.0,1.0
5943,19,2,1,1,2,0.5,0.5
6017,19,2,2,1,3,0.6666666666666666,0.3333333333333333
6168,19,2,0,16,16,0.0,1.0
5989,19,2,0,6,6,0.0,1.0
5963,19,2,6,0,6,1.0,0.0
6194,19,2,0,26,26,0.0,1.0
6167,19,2,2,17,19,0.10526315789473684,0.8947368421052632
6004,19,2,1,63,64,0.015625,0.984375
6030,19,2,5,2,7,0.7142857142857143,0.2857142857142857
6054,19,2,1,5,6,0.16666666666666666,0.8333333333333334
6032,19,2,4,8,12,0.3333333333333333,0.6666666666666666
6170,19,2,3,61,64,0.046875,0.953125
6063,19,2,3,0,3,1.0,0.0
5988,19,2,1,0,1,1.0,0.0
6075,19,2,0,3,3,0.0,1.0
6061,19,2,0,67,67,0.0,1.0
5965,19,2,0,49,49,0.0,1.0
6040,19,2,6,4,10,0.6,0.4
6059,19,2,0,85,85,0.0,1.0
6106,19,2,1,62,63,0.015873015873015872,0.9841269841269841
6031,19,2,3,11,14,0.21428571428571427,0.7857142857142857
6180,19,2,0,6,6,0.0,1.0
6039,19,2,2,61,63,0.031746031746031744,0.9682539682539683
6189,20,2,0,18,18,0.0,1.0
5936,20,2,1,5,6,0.16666666666666666,0.8333333333333334
6087,20,2,3,8,11,0.2727272727272727,0.7272727272727273
5973,20,2,0,848,848,0.0,1.0
6085,20,2,2,10,12,0.16666666666666666,0.8333333333333334
6012,20,2,0,62,62,0.0,1.0
5982,20,2,0,6,6,0.0,1.0
5948,20,2,0,57,57,0.0,1.0
5974,20,2,3,3,6,0.5,0.5
6090,20,2,0,4,4,0.0,1.0
6068,20,2,2,1,3,0.6666666666666666,0.3333333333333333
5962,20,2,1,40,41,0.024390243902439025,0.975609756097561
6033,20,2,0,1,1,0.0,1.0
6038,20,2,2,0,2,1.0,0.0
6042,20,2,1,96,97,0.010309278350515464,0.9896907216494846
5924,20,2,0,3,3,0.0,1.0
6083,20,2,0,27,27,0.0,1.0
6178,20,2,4,14,18,0.2222222222222222,0.7777777777777778
5958,20,2,2,2,4,0.5,0.5
6086,20,2,0,14,14,0.0,1.0
5945,20,2,0,19,19,0.0,1.0
5935,20,2,0,5,5,0.0,1.0
6073,20,2,2,13,15,0.13333333333333333,0.8666666666666667
5980,20,2,2,43,45,0.044444444444444446,0.9555555555555556
5993,20,2,4,479,483,0.008281573498964804,0.9917184265010351
6037,20,2,1,222,223,0.004484304932735426,0.9955156950672646
5979,20,2,3,2,5,0.6,0.4
5966,20,2,0,73,73,0.0,1.0
5985,20,2,0,3,3,0.0,1.0
5967,20,2,0,76,76,0.0,1.0
6188,20,2,1,21,22,0.045454545454545456,0.9545454545454546
6041,20,2,0,12,12,0.0,1.0
5972,20,2,3,10,13,0.23076923076923078,0.7692307692307693
6069,20,2,1,3,4,0.25,0.75
5937,20,2,1,0,1,1.0,0.0
6028,20,2,3,28,31,0.0967741935483871,0.9032258064516129
5990,20,2,0,130,130,0.0,1.0
5928,20,2,3,478,481,0.006237006237006237,0.9937629937629938
5992,20,2,2,2,4,0.5,0.5
6058,20,2,1,12,13,0.07692307692307693,0.9230769230769231
6001,20,2,0,29,29,0.0,1.0
5964,20,2,2,29,31,0.06451612903225806,0.9354838709677419
5950,20,2,3,1,4,0.75,0.25
5991,20,2,1,7,8,0.125,0.875
6177,20,2,0,309,309,0.0,1.0
5961,20,2,0,321,321,0.0,1.0
6176,20,2,0,93,93,0.0,1.0
5956,20,2,0,31,31,0.0,1.0
5938,20,2,0,639,639,0.0,1.0
6179,20,2,2,26,28,0.07142857142857142,0.9285714285714286
5947,20,2,2,58,60,0.03333333333333333,0.9666666666666667
5927,20,2,1,454,455,0.002197802197802198,0.9978021978021978
5977,20,2,0,306,306,0.0,1.0
6198,20,2,0,5,5,0.0,1.0
5957,20,2,0,45,45,0.0,1.0
6057,20,2,0,29,29,0.0,1.0
6043,20,2,4,4,8,0.5,0.5
6077,20,2,0,4,4,0.0,1.0
6014,20,2,3,11,14,0.21428571428571427,0.7857142857142857
6015,20,2,0,3,3,0.0,1.0
5978,20,2,1,2,3,0.3333333333333333,0.6666666666666666
5986,20,2,2,48,50,0.04,0.96
5959,20,2,1,358,359,0.002785515320334262,0.9972144846796658
6051,20,2,1,37,38,0.02631578947368421,0.9736842105263158
6029,20,2,1,2,3,0.3333333333333333,0.6666666666666666
6070,20,2,0,1,1,0.0,1.0
5942,20,2,0,145,145,0.0,1.0
5953,20,2,2,2,4,0.5,0.5
6076,20,2,0,7,7,0.0,1.0
5940,20,2,1,9,10,0.1,0.9
6109,20,2,1,92,93,0.010752688172043012,0.989247311827957
6187,20,2,0,3,3,0.0,1.0
6053,20,2,0,17,17,0.0,1.0
6104,20,2,0,9,9,0.0,1.0
5943,20,2,1,1,2,0.5,0.5
6017,20,2,2,1,3,0.6666666666666666,0.3333333333333333
6168,20,2,3,13,16,0.1875,0.8125
5989,20,2,2,4,6,0.3333333333333333,0.6666666666666666
5963,20,2,5,1,6,0.8333333333333334,0.16666666666666666
6194,20,2,0,26,26,0.0,1.0
6167,20,2,1,18,19,0.05263157894736842,0.9473684210526315
6004,20,2,0,64,64,0.0,1.0
6030,20,2,5,2,7,0.7142857142857143,0.2857142857142857
6054,20,2,0,6,6,0.0,1.0
6032,20,2,2,10,12,0.16666666666666666,0.8333333333333334
6170,20,2,1,63,64,0.015625,0.984375
6063,20,2,3,0,3,1.0,0.0
5988,20,2,1,0,1,1.0,0.0
6075,20,2,0,3,3,0.0,1.0
6061,20,2,0,67,67,0.0,1.0
5965,20,2,7,42,49,0.14285714285714285,0.8571428571428571
6040,20,2,2,8,10,0.2,0.8
6059,20,2,0,85,85,0.0,1.0
6106,20,2,1,62,63,0.015873015873015872,0.9841269841269841
6031,20,2,4,10,14,0.2857142857142857,0.7142857142857143
6180,20,2,0,6,6,0.0,1.0
6039,20,2,2,61,63,0.031746031746031744,0.9682539682539683
6189,21,2,0,18,18,0.0,1.0
5936,21,2,0,6,6,0.0,1.0
6087,21,2,3,8,11,0.2727272727272727,0.7272727272727273
5973,21,2,0,848,848,0.0,1.0
6085,21,2,1,11,12,0.08333333333333333,0.9166666666666666
6012,21,2,0,62,62,0.0,1.0
5982,21,2,1,5,6,0.16666666666666666,0.8333333333333334
5948,21,2,0,57,57,0.0,1.0
5974,21,2,4,2,6,0.6666666666666666,0.3333333333333333
6090,21,2,0,4,4,0.0,1.0
6068,21,2,3,0,3,1.0,0.0
5962,21,2,1,40,41,0.024390243902439025,0.975609756097561
6033,21,2,0,1,1,0.0,1.0
6038,21,2,2,0,2,1.0,0.0
6042,21,2,1,96,97,0.010309278350515464,0.9896907216494846
5924,21,2,1,2,3,0.3333333333333333,0.6666666666666666
6083,21,2,0,27,27,0.0,1.0
6178,21,2,3,15,18,0.16666666666666666,0.8333333333333334
5958,21,2,2,2,4,0.5,0.5
6086,21,2,0,14,14,0.0,1.0
5945,21,2,1,18,19,0.05263157894736842,0.9473684210526315
5935,21,2,0,5,5,0.0,1.0
6073,21,2,1,14,15,0.06666666666666667,0.9333333333333333
5980,21,2,1,44,45,0.022222222222222223,0.9777777777777777
5993,21,2,0,483,483,0.0,1.0
6037,21,2,0,223,223,0.0,1.0
5979,21,2,1,4,5,0.2,0.8
5966,21,2,0,73,73,0.0,1.0
5985,21,2,1,2,3,0.3333333333333333,0.6666666666666666
5967,21,2,0,76,76,0.0,1.0
6188,21,2,1,21,22,0.045454545454545456,0.9545454545454546
6041,21,2,0,12,12,0.0,1.0
5972,21,2,4,9,13,0.3076923076923077,0.6923076923076923
6069,21,2,1,3,4,0.25,0.75
5937,21,2,1,0,1,1.0,0.0
6028,21,2,3,28,31,0.0967741935483871,0.9032258064516129
5990,21,2,0,130,130,0.0,1.0
5928,21,2,2,479,481,0.004158004158004158,0.9958419958419958
5992,21,2,4,0,4,1.0,0.0
6058,21,2,1,12,13,0.07692307692307693,0.9230769230769231
6001,21,2,3,26,29,0.10344827586206896,0.896551724137931
5964,21,2,5,26,31,0.16129032258064516,0.8387096774193549
5950,21,2,0,4,4,0.0,1.0
5991,21,2,2,6,8,0.25,0.75
6177,21,2,1,308,309,0.003236245954692557,0.9967637540453075
5961,21,2,0,321,321,0.0,1.0
6176,21,2,0,93,93,0.0,1.0
5956,21,2,0,31,31,0.0,1.0
5938,21,2,1,638,639,0.001564945226917058,0.9984350547730829
6179,21,2,1,27,28,0.03571428571428571,0.9642857142857143
5947,21,2,4,56,60,0.06666666666666667,0.9333333333333333
5927,21,2,0,455,455,0.0,1.0
5977,21,2,0,306,306,0.0,1.0
6198,21,2,0,5,5,0.0,1.0
5957,21,2,0,45,45,0.0,1.0
6057,21,2,0,29,29,0.0,1.0
6043,21,2,3,5,8,0.375,0.625
6077,21,2,0,4,4,0.0,1.0
6014,21,2,4,10,14,0.2857142857142857,0.7142857142857143
6015,21,2,0,3,3,0.0,1.0
5978,21,2,1,2,3,0.3333333333333333,0.6666666666666666
5986,21,2,1,49,50,0.02,0.98
5959,21,2,1,358,359,0.002785515320334262,0.9972144846796658
6051,21,2,2,36,38,0.05263157894736842,0.9473684210526315
6029,21,2,1,2,3,0.3333333333333333,0.6666666666666666
6070,21,2,0,1,1,0.0,1.0
5942,21,2,0,145,145,0.0,1.0
5953,21,2,1,3,4,0.25,0.75
6076,21,2,0,7,7,0.0,1.0
5940,21,2,1,9,10,0.1,0.9
6109,21,2,1,92,93,0.010752688172043012,0.989247311827957
6187,21,2,1,2,3,0.3333333333333333,0.6666666666666666
6053,21,2,0,17,17,0.0,1.0
6104,21,2,2,7,9,0.2222222222222222,0.7777777777777778
5943,21,2,0,2,2,0.0,1.0
6017,21,2,2,1,3,0.6666666666666666,0.3333333333333333
6168,21,2,2,14,16,0.125,0.875
5989,21,2,2,4,6,0.3333333333333333,0.6666666666666666
5963,21,2,6,0,6,1.0,0.0
6194,21,2,0,26,26,0.0,1.0
6167,21,2,0,19,19,0.0,1.0
6004,21,2,0,64,64,0.0,1.0
6030,21,2,4,3,7,0.5714285714285714,0.42857142857142855
6054,21,2,1,5,6,0.16666666666666666,0.8333333333333334
6032,21,2,1,11,12,0.08333333333333333,0.9166666666666666
6170,21,2,0,64,64,0.0,1.0
6063,21,2,3,0,3,1.0,0.0
5988,21,2,1,0,1,1.0,0.0
6075,21,2,0,3,3,0.0,1.0
6061,21,2,0,67,67,0.0,1.0
5965,21,2,0,49,49,0.0,1.0
6040,21,2,1,9,10,0.1,0.9
6059,21,2,0,85,85,0.0,1.0
6106,21,2,1,62,63,0.015873015873015872,0.9841269841269841
6031,21,2,1,13,14,0.07142857142857142,0.9285714285714286
6180,21,2,0,6,6,0.0,1.0
6039,21,2,1,62,63,0.015873015873015872,0.9841269841269841
6189,22,2,0,18,18,0.0,1.0
5936,22,2,0,6,6,0.0,1.0
6087,22,2,3,8,11,0.2727272727272727,0.7272727272727273
5973,22,2,0,848,848,0.0,1.0
6085,22,2,3,9,12,0.25,0.75
6012,22,2,0,62,62,0.0,1.0
5982,22,2,0,6,6,0.0,1.0
5948,22,2,0,57,57,0.0,1.0
5974,22,2,2,4,6,0.3333333333333333,0.6666666666666666
6090,22,2,0,4,4,0.0,1.0
6068,22,2,3,0,3,1.0,0.0
5962,22,2,2,39,41,0.04878048780487805,0.9512195121951219
6033,22,2,0,1,1,0.0,1.0
6038,22,2,2,0,2,1.0,0.0
6042,22,2,5,92,97,0.05154639175257732,0.9484536082474226
5924,22,2,0,3,3,0.0,1.0
6083,22,2,0,27,27,0.0,1.0
6178,22,2,2,16,18,0.1111111111111111,0.8888888888888888
5958,22,2,3,1,4,0.75,0.25
6086,22,2,0,14,14,0.0,1.0
5945,22,2,0,19,19,0.0,1.0
5935,22,2,4,1,5,0.8,0.2
6073,22,2,0,15,15,0.0,1.0
5980,22,2,1,44,45,0.022222222222222223,0.9777777777777777
5993,22,2,4,479,483,0.008281573498964804,0.9917184265010351
6037,22,2,0,223,223,0.0,1.0
5979,22,2,2,3,5,0.4,0.6
5966,22,2,0,73,73,0.0,1.0
5985,22,2,0,3,3,0.0,1.0
5967,22,2,0,76,76,0.0,1.0
6188,22,2,0,22,22,0.0,1.0
6041,22,2,0,12,12,0.0,1.0
5972,22,2,3,10,13,0.23076923076923078,0.7692307692307693
6069,22,2,1,3,4,0.25,0.75
5937,22,2,1,0,1,1.0,0.0
6028,22,2,2,29,31,0.06451612903225806,0.9354838709677419
5990,22,2,0,130,130,0.0,1.0
5928,22,2,2,479,481,0.004158004158004158,0.9958419958419958
5992,22,2,3,1,4,0.75,0.25
6058,22,2,2,11,13,0.15384615384615385,0.8461538461538461
6001,22,2,2,27,29,0.06896551724137931,0.9310344827586207
5964,22,2,4,27,31,0.12903225806451613,0.8709677419354839
5950,22,2,2,2,4,0.5,0.5
5991,22,2,1,7,8,0.125,0.875
6177,22,2,1,308,309,0.003236245954692557,0.9967637540453075
5961,22,2,0,321,321,0.0,1.0
6176,22,2,0,93,93,0.0,1.0
5956,22,2,0,31,31,0.0,1.0
5938,22,2,0,639,639,0.0,1.0
6179,22,2,1,27,28,0.03571428571428571,0.9642857142857143
5947,22,2,0,60,60,0.0,1.0
5927,22,2,1,454,455,0.002197802197802198,0.9978021978021978
5977,22,2,0,306,306,0.0,1.0
6198,22,2,0,5,5,0.0,1.0
5957,22,2,0,45,45,0.0,1.0
6057,22,2,1,28,29,0.034482758620689655,0.9655172413793104
6043,22,2,2,6,8,0.25,0.75
6077,22,2,0,4,4,0.0,1.0
6014,22,2,2,12,14,0.14285714285714285,0.8571428571428571
6015,22,2,0,3,3,0.0,1.0
5978,22,2,2,1,3,0.6666666666666666,0.3333333333333333
5986,22,2,1,49,50,0.02,0.98
5959,22,2,2,357,359,0.005571030640668524,0.9944289693593314
6051,22,2,0,38,38,0.0,1.0
6029,22,2,1,2,3,0.3333333333333333,0.6666666666666666
6070,22,2,0,1,1,0.0,1.0
5942,22,2,0,145,145,0.0,1.0
5953,22,2,0,4,4,0.0,1.0
6076,22,2,0,7,7,0.0,1.0
5940,22,2,3,7,10,0.3,0.7
6109,22,2,1,92,93,0.010752688172043012,0.989247311827957
6187,22,2,0,3,3,0.0,1.0
6053,22,2,0,17,17,0.0,1.0
6104,22,2,2,7,9,0.2222222222222222,0.7777777777777778
5943,22,2,1,1,2,0.5,0.5
6017,22,2,3,0,3,1.0,0.0
6168,22,2,2,14,16,0.125,0.875
5989,22,2,2,4,6,0.3333333333333333,0.6666666666666666
5963,22,2,6,0,6,1.0,0.0
6194,22,2,0,26,26,0.0,1.0
6167,22,2,0,19,19,0.0,1.0
6004,22,2,1,63,64,0.015625,0.984375
6030,22,2,6,1,7,0.8571428571428571,0.14285714285714285
6054,22,2,0,6,6,0.0,1.0
6032,22,2,1,11,12,0.08333333333333333,0.9166666666666666
6170,22,2,1,63,64,0.015625,0.984375
6063,22,2,3,0,3,1.0,0.0
5988,22,2,1,0,1,1.0,0.0
6075,22,2,0,3,3,0.0,1.0
6061,22,2,0,67,67,0.0,1.0
5965,22,2,0,49,49,0.0,1.0
6040,22,2,2,8,10,0.2,0.8
6059,22,2,0,85,85,0.0,1.0
6106,22,2,2,61,63,0.031746031746031744,0.9682539682539683
6031,22,2,2,12,14,0.14285714285714285,0.8571428571428571
6180,22,2,0,6,6,0.0,1.0
6039,22,2,2,61,63,0.031746031746031744,0.9682539682539683
6189,23,2,0,18,18,0.0,1.0
5936,23,2,1,5,6,0.16666666666666666,0.8333333333333334
6087,23,2,2,9,11,0.18181818181818182,0.8181818181818182
5973,23,2,0,848,848,0.0,1.0
6085,23,2,3,9,12,0.25,0.75
6012,23,2,0,62,62,0.0,1.0
5982,23,2,0,6,6,0.0,1.0
5948,23,2,0,57,57,0.0,1.0
5974,23,2,3,3,6,0.5,0.5
6090,23,2,0,4,4,0.0,1.0
6068,23,2,2,1,3,0.6666666666666666,0.3333333333333333
5962,23,2,0,41,41,0.0,1.0
6033,23,2,0,1,1,0.0,1.0
6038,23,2,1,1,2,0.5,0.5
6042,23,2,2,95,97,0.020618556701030927,0.979381443298969
5924,23,2,0,3,3,0.0,1.0
6083,23,2,0,27,27,0.0,1.0
6178,23,2,2,16,18,0.1111111111111111,0.8888888888888888
5958,23,2,2,2,4,0.5,0.5
6086,23,2,0,14,14,0.0,1.0
5945,23,2,5,14,19,0.2631578947368421,0.7368421052631579
5935,23,2,1,4,5,0.2,0.8
6073,23,2,0,15,15,0.0,1.0
5980,23,2,1,44,45,0.022222222222222223,0.9777777777777777
5993,23,2,3,480,483,0.006211180124223602,0.9937888198757764
6037,23,2,1,222,223,0.004484304932735426,0.9955156950672646
5979,23,2,3,2,5,0.6,0.4
5966,23,2,0,73,73,0.0,1.0
5985,23,2,0,3,3,0.0,1.0
5967,23,2,0,76,76,0.0,1.0
6188,23,2,0,22,22,0.0,1.0
6041,23,2,0,12,12,0.0,1.0
5972,23,2,2,11,13,0.15384615384615385,0.8461538461538461
6069,23,2,1,3,4,0.25,0.75
5937,23,2,1,0,1,1.0,0.0
6028,23,2,2,29,31,0.06451612903225806,0.9354838709677419
5990,23,2,0,130,130,0.0,1.0
5928,23,2,1,480,481,0.002079002079002079,0.997920997920998
5992,23,2,3,1,4,0.75,0.25
6058,23,2,1,12,13,0.07692307692307693,0.9230769230769231
6001,23,2,1,28,29,0.034482758620689655,0.9655172413793104
5964,23,2,3,28,31,0.0967741935483871,0.9032258064516129
5950,23,2,0,4,4,0.0,1.0
5991,23,2,2,6,8,0.25,0.75
6177,23,2,0,309,309,0.0,1.0
5961,23,2,0,321,321,0.0,1.0
6176,23,2,0,93,93,0.0,1.0
5956,23,2,0,31,31,0.0,1.0
5938,23,2,0,639,639,0.0,1.0
6179,23,2,0,28,28,0.0,1.0
5947,23,2,1,59,60,0.016666666666666666,0.9833333333333333
5927,23,2,1,454,455,0.002197802197802198,0.9978021978021978
5977,23,2,0,306,306,0.0,1.0
6198,23,2,0,5,5,0.0,1.0
5957,23,2,0,45,45,0.0,1.0
6057,23,2,0,29,29,0.0,1.0
6043,23,2,0,8,8,0.0,1.0
6077,23,2,0,4,4,0.0,1.0
6014,23,2,2,12,14,0.14285714285714285,0.8571428571428571
6015,23,2,0,3,3,0.0,1.0
5978,23,2,1,2,3,0.3333333333333333,0.6666666666666666
5986,23,2,0,50,50,0.0,1.0
5959,23,2,1,358,359,0.002785515320334262,0.9972144846796658
6051,23,2,2,36,38,0.05263157894736842,0.9473684210526315
6029,23,2,0,3,3,0.0,1.0
6070,23,2,0,1,1,0.0,1.0
5942,23,2,0,145,145,0.0,1.0
5953,23,2,1,3,4,0.25,0.75
6076,23,2,0,7,7,0.0,1.0
5940,23,2,1,9,10,0.1,0.9
6109,23,2,1,92,93,0.010752688172043012,0.989247311827957
6187,23,2,1,2,3,0.3333333333333333,0.6666666666666666
6053,23,2,0,17,17,0.0,1.0
6104,23,2,0,9,9,0.0,1.0
5943,23,2,1,1,2,0.5,0.5
6017,23,2,2,1,3,0.6666666666666666,0.3333333333333333
6168,23,2,4,12,16,0.25,0.75
5989,23,2,0,6,6,0.0,1.0
5963,23,2,5,1,6,0.8333333333333334,0.16666666666666666
6194,23,2,0,26,26,0.0,1.0
6167,23,2,0,19,19,0.0,1.0
6004,23,2,1,63,64,0.015625,0.984375
6030,23,2,3,4,7,0.42857142857142855,0.5714285714285714
6054,23,2,2,4,6,0.3333333333333333,0.6666666666666666
6032,23,2,3,9,12,0.25,0.75
6170,23,2,3,61,64,0.046875,0.953125
6063,23,2,3,0,3,1.0,0.0
5988,23,2,1,0,1,1.0,0.0
6075,23,2,0,3,3,0.0,1.0
6061,23,2,0,67,67,0.0,1.0
5965,23,2,1,48,49,0.02040816326530612,0.9795918367346939
6040,23,2,3,7,10,0.3,0.7
6059,23,2,0,85,85,0.0,1.0
6106,23,2,1,62,63,0.015873015873015872,0.9841269841269841
6031,23,2,4,10,14,0.2857142857142857,0.7142857142857143
6180,23,2,0,6,6,0.0,1.0
6039,23,2,2,61,63,0.031746031746031744,0.9682539682539683
6189,24,2,0,18,18,0.0,1.0
5936,24,2,1,5,6,0.16666666666666666,0.8333333333333334
6087,24,2,1,10,11,0.09090909090909091,0.9090909090909091
5973,24,2,0,848,848,0.0,1.0
6085,24,2,3,9,12,0.25,0.75
6012,24,2,0,62,62,0.0,1.0
5982,24,2,1,5,6,0.16666666666666666,0.8333333333333334
5948,24,2,0,57,57,0.0,1.0
5974,24,2,1,5,6,0.16666666666666666,0.8333333333333334
6090,24,2,0,4,4,0.0,1.0
6068,24,2,2,1,3,0.6666666666666666,0.3333333333333333
5962,24,2,1,40,41,0.024390243902439025,0.975609756097561
6033,24,2,0,1,1,0.0,1.0
6038,24,2,1,1,2,0.5,0.5
6042,24,2,1,96,97,0.010309278350515464,0.9896907216494846
5924,24,2,0,3,3,0.0,1.0
6083,24,2,0,27,27,0.0,1.0
6178,24,2,3,15,18,0.16666666666666666,0.8333333333333334
5958,24,2,2,2,4,0.5,0.5
6086,24,2,0,14,14,0.0,1.0
5945,24,2,0,19,19,0.0,1.0
5935,24,2,1,4,5,0.2,0.8
6073,24,2,0,15,15,0.0,1.0
5980,24,2,1,44,45,0.022222222222222223,0.9777777777777777
5993,24,2,0,483,483,0.0,1.0
6037,24,2,0,223,223,0.0,1.0
5979,24,2,1,4,5,0.2,0.8
5966,24,2,0,73,73,0.0,1.0
5985,24,2,0,3,3,0.0,1.0
5967,24,2,0,76,76,0.0,1.0
6188,24,2,2,20,22,0.09090909090909091,0.9090909090909091
6041,24,2,0,12,12,0.0,1.0
5972,24,2,2,11,13,0.15384615384615385,0.8461538461538461
6069,24,2,1,3,4,0.25,0.75
5937,24,2,1,0,1,1.0,0.0
6028,24,2,2,29,31,0.06451612903225806,0.9354838709677419
5990,24,2,0,130,130,0.0,1.0
5928,24,2,1,480,481,0.002079002079002079,0.997920997920998
5992,24,2,2,2,4,0.5,0.5
6058,24,2,1,12,13,0.07692307692307693,0.9230769230769231
6001,24,2,1,28,29,0.034482758620689655,0.9655172413793104
5964,24,2,0,31,31,0.0,1.0
5950,24,2,0,4,4,0.0,1.0
5991,24,2,0,8,8,0.0,1.0
6177,24,2,0,309,309,0.0,1.0
5961,24,2,0,321,321,0.0,1.0
6176,24,2,0,93,93,0.0,1.0
5956,24,2,0,31,31,0.0,1.0
5938,24,2,1,638,639,0.001564945226917058,0.9984350547730829
6179,24,2,0,28,28,0.0,1.0
5947,24,2,3,57,60,0.05,0.95
5927,24,2,1,454,455,0.002197802197802198,0.9978021978021978
5977,24,2,0,306,306,0.0,1.0
6198,24,2,0,5,5,0.0,1.0
5957,24,2,0,45,45,0.0,1.0
6057,24,2,1,28,29,0.034482758620689655,0.9655172413793104
6043,24,2,2,6,8,0.25,0.75
6077,24,2,0,4,4,0.0,1.0
6014,24,2,3,11,14,0.21428571428571427,0.7857142857142857
6015,24,2,0,3,3,0.0,1.0
5978,24,2,1,2,3,0.3333333333333333,0.6666666666666666
5986,24,2,1,49,50,0.02,0.98
5959,24,2,0,359,359,0.0,1.0
6051,24,2,1,37,38,0.02631578947368421,0.9736842105263158
6029,24,2,0,3,3,0.0,1.0
6070,24,2,0,1,1,0.0,1.0
5942,24,2,0,145,145,0.0,1.0
5953,24,2,1,3,4,0.25,0.75
6076,24,2,0,7,7,0.0,1.0
5940,24,2,0,10,10,0.0,1.0
6109,24,2,1,92,93,0.010752688172043012,0.989247311827957
6187,24,2,0,3,3,0.0,1.0
6053,24,2,0,17,17,0.0,1.0
6104,24,2,0,9,9,0.0,1.0
5943,24,2,1,1,2,0.5,0.5
6017,24,2,2,1,3,0.6666666666666666,0.3333333333333333
6168,24,2,1,15,16,0.0625,0.9375
5989,24,2,2,4,6,0.3333333333333333,0.6666666666666666
5963,24,2,5,1,6,0.8333333333333334,0.16666666666666666
6194,24,2,0,26,26,0.0,1.0
6167,24,2,0,19,19,0.0,1.0
6004,24,2,1,63,64,0.015625,0.984375
6030,24,2,5,2,7,0.7142857142857143,0.2857142857142857
6054,24,2,0,6,6,0.0,1.0
6032,24,2,3,9,12,0.25,0.75
6170,24,2,1,63,64,0.015625,0.984375
6063,24,2,1,2,3,0.3333333333333333,0.6666666666666666
5988,24,2,1,0,1,1.0,0.0
6075,24,2,0,3,3,0.0,1.0
6061,24,2,0,67,67,0.0,1.0
5965,24,2,1,48,49,0.02040816326530612,0.9795918367346939
6040,24,2,0,10,10,0.0,1.0
6059,24,2,0,85,85,0.0,1.0
6106,24,2,0,63,63,0.0,1.0
6031,24,2,1,13,14,0.07142857142857142,0.9285714285714286
6180,24,2,0,6,6,0.0,1.0
6039,24,2,5,58,63,0.07936507936507936,0.9206349206349206
6189,25,2,0,18,18,0.0,1.0
5936,25,2,1,5,6,0.16666666666666666,0.8333333333333334
6087,25,2,2,9,11,0.18181818181818182,0.8181818181818182
5973,25,2,0,848,848,0.0,1.0
6085,25,2,1,11,12,0.08333333333333333,0.9166666666666666
6012,25,2,0,62,62,0.0,1.0
5982,25,2,1,5,6,0.16666666666666666,0.8333333333333334
5948,25,2,0,57,57,0.0,1.0
5974,25,2,3,3,6,0.5,0.5
6090,25,2,0,4,4,0.0,1.0
6068,25,2,2,1,3,0.6666666666666666,0.3333333333333333
5962,25,2,0,41,41,0.0,1.0
6033,25,2,0,1,1,0.0,1.0
6038,25,2,1,1,2,0.5,0.5
6042,25,2,0,97,97,0.0,1.0
5924,25,2,0,3,3,0.0,1.0
6083,25,2,0,27,27,0.0,1.0
6178,25,2,2,16,18,0.1111111111111111,0.8888888888888888
5958,25,2,3,1,4,0.75,0.25
6086,25,2,0,14,14,0.0,1.0
5945,25,2,1,18,19,0.05263157894736842,0.9473684210526315
5935,25,2,4,1,5,0.8,0.2
6073,25,2,0,15,15,0.0,1.0
5980,25,2,1,44,45,0.022222222222222223,0.9777777777777777
5993,25,2,2,481,483,0.004140786749482402,0.9958592132505176
6037,25,2,0,223,223,0.0,1.0
5979,25,2,2,3,5,0.4,0.6
5966,25,2,0,73,73,0.0,1.0
5985,25,2,0,3,3,0.0,1.0
5967,25,2,0,76,76,0.0,1.0
6188,25,2,1,21,22,0.045454545454545456,0.9545454545454546
6041,25,2,0,12,12,0.0,1.0
5972,25,2,3,10,13,0.23076923076923078,0.7692307692307693
6069,25,2,1,3,4,0.25,0.75
5937,25,2,1,0,1,1.0,0.0
6028,25,2,3,28,31,0.0967741935483871,0.9032258064516129
5990,25,2,0,130,130,0.0,1.0
5928,25,2,1,480,481,0.002079002079002079,0.997920997920998
5992,25,2,3,1,4,0.75,0.25
6058,25,2,0,13,13,0.0,1.0
6001,25,2,2,27,29,0.06896551724137931,0.9310344827586207
5964,25,2,2,29,31,0.06451612903225806,0.9354838709677419
5950,25,2,0,4,4,0.0,1.0
5991,25,2,1,7,8,0.125,0.875
6177,25,2,0,309,309,0.0,1.0
5961,25,2,0,321,321,0.0,1.0
6176,25,2,0,93,93,0.0,1.0
5956,25,2,0,31,31,0.0,1.0
5938,25,2,1,638,639,0.001564945226917058,0.9984350547730829
6179,25,2,1,27,28,0.03571428571428571,0.9642857142857143
5947,25,2,0,60,60,0.0,1.0
5927,25,2,0,455,455,0.0,1.0
5977,25,2,0,306,306,0.0,1.0
6198,25,2,0,5,5,0.0,1.0
5957,25,2,0,45,45,0.0,1.0
6057,25,2,0,29,29,0.0,1.0
6043,25,2,0,8,8,0.0,1.0
6077,25,2,0,4,4,0.0,1.0
6014,25,2,0,14,14,0.0,1.0
6015,25,2,0,3,3,0.0,1.0
5978,25,2,2,1,3,0.6666666666666666,0.3333333333333333
5986,25,2,1,49,50,0.02,0.98
5959,25,2,1,358,359,0.002785515320334262,0.9972144846796658
6051,25,2,0,38,38,0.0,1.0
6029,25,2,0,3,3,0.0,1.0
6070,25,2,0,1,1,0.0,1.0
5942,25,2,0,145,145,0.0,1.0
5953,25,2,0,4,4,0.0,1.0
6076,25,2,0,7,7,0.0,1.0
5940,25,2,2,8,10,0.2,0.8
6109,25,2,1,92,93,0.010752688172043012,0.989247311827957
6187,25,2,0,3,3,0.0,1.0
6053,25,2,0,17,17,0.0,1.0
6104,25,2,0,9,9,0.0,1.0
5943,25,2,0,2,2,0.0,1.0
6017,25,2,3,0,3,1.0,0.0
6168,25,2,2,14,16,0.125,0.875
5989,25,2,0,6,6,0.0,1.0
5963,25,2,5,1,6,0.8333333333333334,0.16666666666666666
6194,25,2,0,26,26,0.0,1.0
6167,25,2,1,18,19,0.05263157894736842,0.9473684210526315
6004,25,2,0,64,64,0.0,1.0
6030,25,2,3,4,7,0.42857142857142855,0.5714285714285714
6054,25,2,1,5,6,0.16666666666666666,0.8333333333333334
6032,25,2,2,10,12,0.16666666666666666,0.8333333333333334
6170,25,2,1,63,64,0.015625,0.984375
6063,25,2,2,1,3,0.6666666666666666,0.3333333333333333
5988,25,2,1,0,1,1.0,0.0
6075,25,2,0,3,3,0.0,1.0
6061,25,2,0,67,67,0.0,1.0
5965,25,2,1,48,49,0.02040816326530612,0.9795918367346939
6040,25,2,1,9,10,0.1,0.9
6059,25,2,0,85,85,0.0,1.0
6106,25,2,0,63,63,0.0,1.0
6031,25,2,3,11,14,0.21428571428571427,0.7857142857142857
6180,25,2,0,6,6,0.0,1.0
6039,25,2,3,60,63,0.047619047619047616,0.9523809523809523
6189,26,2,0,18,18,0.0,1.0
5936,26,2,0,6,6,0.0,1.0
6087,26,2,1,10,11,0.09090909090909091,0.9090909090909091
5973,26,2,0,848,848,0.0,1.0
6085,26,2,1,11,12,0.08333333333333333,0.9166666666666666
6012,26,2,0,62,62,0.0,1.0
5982,26,2,1,5,6,0.16666666666666666,0.8333333333333334
5948,26,2,0,57,57,0.0,1.0
5974,26,2,1,5,6,0.16666666666666666,0.8333333333333334
6090,26,2,0,4,4,0.0,1.0
6068,26,2,2,1,3,0.6666666666666666,0.3333333333333333
5962,26,2,0,41,41,0.0,1.0
6033,26,2,0,1,1,0.0,1.0
6038,26,2,1,1,2,0.5,0.5
6042,26,2,1,96,97,0.010309278350515464,0.9896907216494846
5924,26,2,0,3,3,0.0,1.0
6083,26,2,0,27,27,0.0,1.0
6178,26,2,2,16,18,0.1111111111111111,0.8888888888888888
5958,26,2,1,3,4,0.25,0.75
6086,26,2,0,14,14,0.0,1.0
5945,26,2,0,19,19,0.0,1.0
5935,26,2,1,4,5,0.2,0.8
6073,26,2,1,14,15,0.06666666666666667,0.9333333333333333
5980,26,2,1,44,45,0.022222222222222223,0.9777777777777777
5993,26,2,1,482,483,0.002070393374741201,0.9979296066252588
6037,26,2,0,223,223,0.0,1.0
5979,26,2,2,3,5,0.4,0.6
5966,26,2,0,73,73,0.0,1.0
5985,26,2,0,3,3,0.0,1.0
5967,26,2,0,76,76,0.0,1.0
6188,26,2,1,21,22,0.045454545454545456,0.9545454545454546
6041,26,2,0,12,12,0.0,1.0
5972,26,2,0,13,13,0.0,1.0
6069,26,2,1,3,4,0.25,0.75
5937,26,2,1,0,1,1.0,0.0
6028,26,2,2,29,31,0.06451612903225806,0.9354838709677419
5990,26,2,0,130,130,0.0,1.0
5928,26,2,1,480,481,0.002079002079002079,0.997920997920998
5992,26,2,2,2,4,0.5,0.5
6058,26,2,0,13,13,0.0,1.0
6001,26,2,1,28,29,0.034482758620689655,0.9655172413793104
5964,26,2,3,28,31,0.0967741935483871,0.9032258064516129
5950,26,2,1,3,4,0.25,0.75
5991,26,2,0,8,8,0.0,1.0
6177,26,2,0,309,309,0.0,1.0
5961,26,2,0,321,321,0.0,1.0
6176,26,2,0,93,93,0.0,1.0
5956,26,2,0,31,31,0.0,1.0
5938,26,2,0,639,639,0.0,1.0
6179,26,2,0,28,28,0.0,1.0
5947,26,2,0,60,60,0.0,1.0
5927,26,2,1,454,455,0.002197802197802198,0.9978021978021978
5977,26,2,0,306,306,0.0,1.0
6198,26,2,0,5,5,0.0,1.0
5957,26,2,0,45,45,0.0,1.0
6057,26,2,0,29,29,0.0,1.0
6043,26,2,1,7,8,0.125,0.875
6077,26,2,0,4,4,0.0,1.0
6014,26,2,2,12,14,0.14285714285714285,0.8571428571428571
6015,26,2,0,3,3,0.0,1.0
5978,26,2,1,2,3,0.3333333333333333,0.6666666666666666
5986,26,2,0,50,50,0.0,1.0
5959,26,2,2,357,359,0.005571030640668524,0.9944289693593314
6051,26,2,0,38,38,0.0,1.0
6029,26,2,0,3,3,0.0,1.0
6070,26,2,0,1,1,0.0,1.0
5942,26,2,0,145,145,0.0,1.0
5953,26,2,0,4,4,0.0,1.0
6076,26,2,0,7,7,0.0,1.0
5940,26,2,0,10,10,0.0,1.0
6109,26,2,0,93,93,0.0,1.0
6187,26,2,1,2,3,0.3333333333333333,0.6666666666666666
6053,26,2,0,17,17,0.0,1.0
6104,26,2,1,8,9,0.1111111111111111,0.8888888888888888
5943,26,2,0,2,2,0.0,1.0
6017,26,2,3,0,3,1.0,0.0
6168,26,2,1,15,16,0.0625,0.9375
5989,26,2,2,4,6,0.3333333333333333,0.6666666666666666
5963,26,2,5,1,6,0.8333333333333334,0.16666666666666666
6194,26,2,0,26,26,0.0,1.0
6167,26,2,1,18,19,0.05263157894736842,0.9473684210526315
6004,26,2,1,63,64,0.015625,0.984375
6030,26,2,5,2,7,0.7142857142857143,0.2857142857142857
6054,26,2,1,5,6,0.16666666666666666,0.8333333333333334
6032,26,2,5,7,12,0.4166666666666667,0.5833333333333334
6170,26,2,1,63,64,0.015625,0.984375
6063,26,2,1,2,3,0.3333333333333333,0.6666666666666666
5988,26,2,1,0,1,1.0,0.0
6075,26,2,0,3,3,0.0,1.0
6061,26,2,0,67,67,0.0,1.0
5965,26,2,1,48,49,0.02040816326530612,0.9795918367346939
6040,26,2,1,9,10,0.1,0.9
6059,26,2,0,85,85,0.0,1.0
6106,26,2,2,61,63,0.031746031746031744,0.9682539682539683
6031,26,2,1,13,14,0.07142857142857142,0.9285714285714286
6180,26,2,0,6,6,0.0,1.0
6039,26,2,3,60,63,0.047619047619047616,0.9523809523809523
6189,27,2,0,18,18,0.0,1.0
5936,27,2,0,6,6,0.0,1.0
6087,27,2,0,11,11,0.0,1.0
5973,27,2,0,848,848,0.0,1.0
6085,27,2,2,10,12,0.16666666666666666,0.8333333333333334
6012,27,2,0,62,62,0.0,1.0
5982,27,2,0,6,6,0.0,1.0
5948,27,2,0,57,57,0.0,1.0
5974,27,2,2,4,6,0.3333333333333333,0.6666666666666666
6090,27,2,0,4,4,0.0,1.0
6068,27,2,1,2,3,0.3333333333333333,0.6666666666666666
5962,27,2,1,40,41,0.024390243902439025,0.975609756097561
6033,27,2,0,1,1,0.0,1.0
6038,27,2,1,1,2,0.5,0.5
6042,27,2,0,97,97,0.0,1.0
5924,27,2,0,3,3,0.0,1.0
6083,27,2,0,27,27,0.0,1.0
6178,27,2,1,17,18,0.05555555555555555,0.9444444444444444
5958,27,2,0,4,4,0.0,1.0
6086,27,2,0,14,14,0.0,1.0
5945,27,2,0,19,19,0.0,1.0
5935,27,2,0,5,5,0.0,1.0
6073,27,2,0,15,15,0.0,1.0
5980,27,2,1,44,45,0.022222222222222223,0.9777777777777777
5993,27,2,2,481,483,0.004140786749482402,0.9958592132505176
6037,27,2,0,223,223,0.0,1.0
5979,27,2,2,3,5,0.4,0.6
5966,27,2,0,73,73,0.0,1.0
5985,27,2,0,3,3,0.0,1.0
5967,27,2,0,76,76,0.0,1.0
6188,27,2,0,22,22,0.0,1.0
6041,27,2,0,12,12,0.0,1.0
5972,27,2,2,11,13,0.15384615384615385,0.8461538461538461
6069,27,2,1,3,4,0.25,0.75
5937,27,2,1,0,1,1.0,0.0
6028,27,2,3,28,31,0.0967741935483871,0.9032258064516129
5990,27,2,0,130,130,0.0,1.0
5928,27,2,1,480,481,0.002079002079002079,0.997920997920998
5992,27,2,2,2,4,0.5,0.5
6058,27,2,3,10,13,0.23076923076923078,0.7692307692307693
6001,27,2,0,29,29,0.0,1.0
5964,27,2,0,31,31,0.0,1.0
5950,27,2,0,4,4,0.0,1.0
5991,27,2,1,7,8,0.125,0.875
6177,27,2,0,309,309,0.0,1.0
5961,27,2,0,321,321,0.0,1.0
6176,27,2,0,93,93,0.0,1.0
5956,27,2,0,31,31,0.0,1.0
5938,27,2,0,639,639,0.0,1.0
6179,27,2,0,28,28,0.0,1.0
5947,27,2,2,58,60,0.03333333333333333,0.9666666666666667
5927,27,2,1,454,455,0.002197802197802198,0.9978021978021978
5977,27,2,0,306,306,0.0,1.0
6198,27,2,0,5,5,0.0,1.0
5957,27,2,0,45,45,0.0,1.0
6057,27,2,0,29,29,0.0,1.0
6043,27,2,0,8,8,0.0,1.0
6077,27,2,0,4,4,0.0,1.0
6014,27,2,1,13,14,0.07142857142857142,0.9285714285714286
6015,27,2,0,3,3,0.0,1.0
5978,27,2,1,2,3,0.3333333333333333,0.6666666666666666
5986,27,2,1,49,50,0.02,0.98
5959,27,2,0,359,359,0.0,1.0
6051,27,2,0,38,38,0.0,1.0
6029,27,2,0,3,3,0.0,1.0
6070,27,2,0,1,1,0.0,1.0
5942,27,2,0,145,145,0.0,1.0
5953,27,2,1,3,4,0.25,0.75
6076,27,2,0,7,7,0.0,1.0
5940,27,2,3,7,10,0.3,0.7
6109,27,2,0,93,93,0.0,1.0
6187,27,2,1,2,3,0.3333333333333333,0.6666666666666666
6053,27,2,0,17,17,0.0,1.0
6104,27,2,0,9,9,0.0,1.0
5943,27,2,0,2,2,0.0,1.0
6017,27,2,3,0,3,1.0,0.0
6168,27,2,1,15,16,0.0625,0.9375
5989,27,2,0,6,6,0.0,1.0
5963,27,2,6,0,6,1.0,0.0
6194,27,2,0,26,26,0.0,1.0
6167,27,2,0,19,19,0.0,1.0
6004,27,2,1,63,64,0.015625,0.984375
6030,27,2,2,5,7,0.2857142857142857,0.7142857142857143
6054,27,2,1,5,6,0.16666666666666666,0.8333333333333334
6032,27,2,1,11,12,0.08333333333333333,0.9166666666666666
6170,27,2,1,63,64,0.015625,0.984375
6063,27,2,1,2,3,0.3333333333333333,0.6666666666666666
5988,27,2,1,0,1,1.0,0.0
6075,27,2,0,3,3,0.0,1.0
6061,27,2,0,67,67,0.0,1.0
5965,27,2,0,49,49,0.0,1.0
6040,27,2,1,9,10,0.1,0.9
6059,27,2,0,85,85,0.0,1.0
6106,27,2,1,62,63,0.015873015873015872,0.9841269841269841
6031,27,2,4,10,14,0.2857142857142857,0.7142857142857143
6180,27,2,0,6,6,0.0,1.0
6039,27,2,2,61,63,0.031746031746031744,0.9682539682539683
6189,28,2,0,18,18,0.0,1.0
5936,28,2,1,5,6,0.16666666666666666,0.8333333333333334
6087,28,2,1,10,11,0.09090909090909091,0.9090909090909091
5973,28,2,1,847,848,0.0011792452830188679,0.9988207547169812
6085,28,2,3,9,12,0.25,0.75
6012,28,2,0,62,62,0.0,1.0
5982,28,2,1,5,6,0.16666666666666666,0.8333333333333334
5948,28,2,0,57,57,0.0,1.0
5974,28,2,0,6,6,0.0,1.0
6090,28,2,0,4,4,0.0,1.0
6068,28,2,2,1,3,0.6666666666666666,0.3333333333333333
5962,28,2,1,40,41,0.024390243902439025,0.975609756097561
6033,28,2,0,1,1,0.0,1.0
6038,28,2,2,0,2,1.0,0.0
6042,28,2,2,95,97,0.020618556701030927,0.979381443298969
5924,28,2,1,2,3,0.3333333333333333,0.6666666666666666
6083,28,2,0,27,27,0.0,1.0
6178,28,2,3,15,18,0.16666666666666666,0.8333333333333334
5958,28,2,2,2,4,0.5,0.5
6086,28,2,0,14,14,0.0,1.0
5945,28,2,1,18,19,0.05263157894736842,0.9473684210526315
5935,28,2,1,4,5,0.2,0.8
6073,28,2,1,14,15,0.06666666666666667,0.9333333333333333
5980,28,2,0,45,45,0.0,1.0
5993,28,2,1,482,483,0.002070393374741201,0.9979296066252588
6037,28,2,0,223,223,0.0,1.0
5979,28,2,3,2,5,0.6,0.4
5966,28,2,0,73,73,0.0,1.0
5985,28,2,0,3,3,0.0,1.0
5967,28,2,0,76,76,0.0,1.0
6188,28,2,0,22,22,0.0,1.0
6041,28,2,0,12,12,0.0,1.0
5972,28,2,2,11,13,0.15384615384615385,0.8461538461538461
6069,28,2,0,4,4,0.0,1.0
5937,28,2,1,0,1,1.0,0.0
6028,28,2,2,29,31,0.06451612903225806,0.9354838709677419
5990,28,2,0,130,130,0.0,1.0
5928,28,2,1,480,481,0.002079002079002079,0.997920997920998
5992,28,2,3,1,4,0.75,0.25
6058,28,2,1,12,13,0.07692307692307693,0.9230769230769231
6001,28,2,0,29,29,0.0,1.0
5964,28,2,0,31,31,0.0,1.0
5950,28,2,0,4,4,0.0,1.0
5991,28,2,0,8,8,0.0,1.0
6177,28,2,0,309,309,0.0,1.0
5961,28,2,0,321,321,0.0,1.0
6176,28,2,0,93,93,0.0,1.0
5956,28,2,0,31,31,0.0,1.0
5938,28,2,0,639,639,0.0,1.0
6179,28,2,0,28,28,0.0,1.0
5947,28,2,1,59,60,0.016666666666666666,0.9833333333333333
5927,28,2,0,455,455,0.0,1.0
5977,28,2,0,306,306,0.0,1.0
6198,28,2,0,5,5,0.0,1.0
5957,28,2,0,45,45,0.0,1.0
6057,28,2,0,29,29,0.0,1.0
6043,28,2,1,7,8,0.125,0.875
6077,28,2,0,4,4,0.0,1.0
6014,28,2,1,13,14,0.07142857142857142,0.9285714285714286
6015,28,2,0,3,3,0.0,1.0
5978,28,2,1,2,3,0.3333333333333333,0.6666666666666666
5986,28,2,1,49,50,0.02,0.98
5959,28,2,1,358,359,0.002785515320334262,0.9972144846796658
6051,28,2,0,38,38,0.0,1.0
6029,28,2,0,3,3,0.0,1.0
6070,28,2,0,1,1,0.0,1.0
5942,28,2,0,145,145,0.0,1.0
5953,28,2,0,4,4,0.0,1.0
6076,28,2,0,7,7,0.0,1.0
5940,28,2,2,8,10,0.2,0.8
6109,28,2,1,92,93,0.010752688172043012,0.989247311827957
6187,28,2,0,3,3,0.0,1.0
6053,28,2,0,17,17,0.0,1.0
6104,28,2,0,9,9,0.0,1.0
5943,28,2,1,1,2,0.5,0.5
6017,28,2,3,0,3,1.0,0.0
6168,28,2,1,15,16,0.0625,0.9375
5989,28,2,2,4,6,0.3333333333333333,0.6666666666666666
5963,28,2,5,1,6,0.8333333333333334,0.16666666666666666
6194,28,2,0,26,26,0.0,1.0
6167,28,2,0,19,19,0.0,1.0
6004,28,2,1,63,64,0.015625,0.984375
6030,28,2,4,3,7,0.5714285714285714,0.42857142857142855
6054,28,2,1,5,6,0.16666666666666666,0.8333333333333334
6032,28,2,1,11,12,0.08333333333333333,0.9166666666666666
6170,28,2,2,62,64,0.03125,0.96875
6063,28,2,1,2,3,0.3333333333333333,0.6666666666666666
5988,28,2,1,0,1,1.0,0.0
6075,28,2,0,3,3,0.0,1.0
6061,28,2,0,67,67,0.0,1.0
5965,28,2,0,49,49,0.0,1.0
6040,28,2,0,10,10,0.0,1.0
6059,28,2,0,85,85,0.0,1.0
6106,28,2,1,62,63,0.015873015873015872,0.9841269841269841
6031,28,2,1,13,14,0.07142857142857142,0.9285714285714286
6180,28,2,0,6,6,0.0,1.0
6039,28,2,1,62,63,0.015873015873015872,0.9841269841269841
6189,29,2,0,18,18,0.0,1.0
5936,29,2,1,5,6,0.16666666666666666,0.8333333333333334
6087,29,2,2,9,11,0.18181818181818182,0.8181818181818182
5973,29,2,0,848,848,0.0,1.0
6085,29,2,0,12,12,0.0,1.0
6012,29,2,0,62,62,0.0,1.0
5982,29,2,0,6,6,0.0,1.0
5948,29,2,0,57,57,0.0,1.0
5974,29,2,2,4,6,0.3333333333333333,0.6666666666666666
6090,29,2,0,4,4,0.0,1.0
6068,29,2,1,2,3,0.3333333333333333,0.6666666666666666
5962,29,2,0,41,41,0.0,1.0
6033,29,2,0,1,1,0.0,1.0
6038,29,2,1,1,2,0.5,0.5
6042,29,2,2,95,97,0.020618556701030927,0.979381443298969
5924,29,2,0,3,3,0.0,1.0
6083,29,2,0,27,27,0.0,1.0
6178,29,2,2,16,18,0.1111111111111111,0.8888888888888888
5958,29,2,2,2,4,0.5,0.5
6086,29,2,0,14,14,0.0,1.0
5945,29,2,0,19,19,0.0,1.0
5935,29,2,0,5,5,0.0,1.0
6073,29,2,0,15,15,0.0,1.0
5980,29,2,0,45,45,0.0,1.0
5993,29,2,0,483,483,0.0,1.0
6037,29,2,0,223,223,0.0,1.0
5979,29,2,2,3,5,0.4,0.6
5966,29,2,0,73,73,0.0,1.0
5985,29,2,0,3,3,0.0,1.0
5967,29,2,0,76,76,0.0,1.0
6188,29,2,0,22,22,0.0,1.0
6041,29,2,0,12,12,0.0,1.0
5972,29,2,2,11,13,0.15384615384615385,0.8461538461538461
6069,29,2,1,3,4,0.25,0.75
5937,29,2,1,0,1,1.0,0.0
6028,29,2,2,29,31,0.06451612903225806,0.9354838709677419
5990,29,2,0,130,130,0.0,1.0
5928,29,2,0,481,481,0.0,1.0
5992,29,2,2,2,4,0.5,0.5
6058,29,2,0,13,13,0.0,1.0
6001,29,2,0,29,29,0.0,1.0
5964,29,2,2,29,31,0.06451612903225806,0.9354838709677419
5950,29,2,0,4,4,0.0,1.0
5991,29,2,1,7,8,0.125,0.875
6177,29,2,0,309,309,0.0,1.0
5961,29,2,0,321,321,0.0,1.0
6176,29,2,0,93,93,0.0,1.0
5956,29,2,0,31,31,0.0,1.0
5938,29,2,0,639,639,0.0,1.0
6179,29,2,1,27,28,0.03571428571428571,0.9642857142857143
5947,29,2,2,58,60,0.03333333333333333,0.9666666666666667
5927,29,2,1,454,455,0.002197802197802198,0.9978021978021978
5977,29,2,0,306,306,0.0,1.0
6198,29,2,0,5,5,0.0,1.0
5957,29,2,0,45,45,0.0,1.0
6057,29,2,0,29,29,0.0,1.0
6043,29,2,0,8,8,0.0,1.0
6077,29,2,0,4,4,0.0,1.0
6014,29,2,0,14,14,0.0,1.0
6015,29,2,0,3,3,0.0,1.0
5978,29,2,1,2,3,0.3333333333333333,0.6666666666666666
5986,29,2,2,48,50,0.04,0.96
5959,29,2,0,359,359,0.0,1.0
6051,29,2,0,38,38,0.0,1.0
6029,29,2,0,3,3,0.0,1.0
6070,29,2,0,1,1,0.0,1.0
5942,29,2,0,145,145,0.0,1.0
5953,29,2,1,3,4,0.25,0.75
6076,29,2,0,7,7,0.0,1.0
5940,29,2,2,8,10,0.2,0.8
6109,29,2,1,92,93,0.010752688172043012,0.989247311827957
6187,29,2,0,3,3,0.0,1.0
6053,29,2,0,17,17,0.0,1.0
6104,29,2,0,9,9,0.0,1.0
5943,29,2,0,2,2,0.0,1.0
6017,29,2,1,2,3,0.3333333333333333,0.6666666666666666
6168,29,2,1,15,16,0.0625,0.9375
5989,29,2,2,4,6,0.3333333333333333,0.6666666666666666
5963,29,2,6,0,6,1.0,0.0
6194,29,2,0,26,26,0.0,1.0
6167,29,2,0,19,19,0.0,1.0
6004,29,2,0,64,64,0.0,1.0
6030,29,2,2,5,7,0.2857142857142857,0.7142857142857143
6054,29,2,0,6,6,0.0,1.0
6032,29,2,3,9,12,0.25,0.75
6170,29,2,1,63,64,0.015625,0.984375
6063,29,2,1,2,3,0.3333333333333333,0.6666666666666666
5988,29,2,1,0,1,1.0,0.0
6075,29,2,0,3,3,0.0,1.0
6061,29,2,0,67,67,0.0,1.0
5965,29,2,0,49,49,0.0,1.0
6040,29,2,2,8,10,0.2,0.8
6059,29,2,0,85,85,0.0,1.0
6106,29,2,0,63,63,0.0,1.0
6031,29,2,5,9,14,0.35714285714285715,0.6428571428571429
6180,29,2,0,6,6,0.0,1.0
6039,29,2,1,62,63,0.015873015873015872,0.9841269841269841
6189,0,3,0,18,18,0.0,1.0
5936,0,3,6,0,6,1.0,0.0
6087,0,3,2,9,11,0.18181818181818182,0.8181818181818182
5973,0,3,5,843,848,0.00589622641509434,0.9941037735849056
6085,0,3,12,0,12,1.0,0.0
6012,0,3,0,62,62,0.0,1.0
5982,0,3,1,5,6,0.16666666666666666,0.8333333333333334
5948,0,3,0,57,57,0.0,1.0
5974,0,3,6,0,6,1.0,0.0
6090,0,3,0,4,4,0.0,1.0
6068,0,3,3,0,3,1.0,0.0
5962,0,3,35,6,41,0.8536585365853658,0.14634146341463414
6033,0,3,1,0,1,1.0,0.0
6038,0,3,2,0,2,1.0,0.0
6042,0,3,86,11,97,0.8865979381443299,0.1134020618556701
5924,0,3,3,0,3,1.0,0.0
6083,0,3,0,27,27,0.0,1.0
6178,0,3,18,0,18,1.0,0.0
5958,0,3,4,0,4,1.0,0.0
6086,0,3,0,14,14,0.0,1.0
5945,0,3,18,1,19,0.9473684210526315,0.05263157894736842
5935,0,3,5,0,5,1.0,0.0
6073,0,3,14,1,15,0.9333333333333333,0.06666666666666667
5980,0,3,45,0,45,1.0,0.0
5993,0,3,187,296,483,0.38716356107660455,0.6128364389233955
6037,0,3,169,54,223,0.757847533632287,0.242152466367713
5979,0,3,5,0,5,1.0,0.0
5966,0,3,0,73,73,0.0,1.0
5985,0,3,3,0,3,1.0,0.0
5967,0,3,0,76,76,0.0,1.0
6188,0,3,22,0,22,1.0,0.0
6041,0,3,0,12,12,0.0,1.0
5972,0,3,13,0,13,1.0,0.0
6069,0,3,1,3,4,0.25,0.75
5937,0,3,1,0,1,1.0,0.0
6028,0,3,31,0,31,1.0,0.0
5990,0,3,0,130,130,0.0,1.0
5928,0,3,255,226,481,0.5301455301455301,0.4698544698544699
5992,0,3,4,0,4,1.0,0.0
6058,0,3,13,0,13,1.0,0.0
6001,0,3,28,1,29,0.9655172413793104,0.034482758620689655
5964,0,3,30,1,31,0.967741935483871,0.03225806451612903
5950,0,3,4,0,4,1.0,0.0
5991,0,3,8,0,8,1.0,0.0
6177,0,3,252,57,309,0.8155339805825242,0.18446601941747573
5961,0,3,0,321,321,0.0,1.0
6176,0,3,0,93,93,0.0,1.0
5956,0,3,0,31,31,0.0,1.0
5938,0,3,60,579,639,0.09389671361502347,0.9061032863849765
6179,0,3,28,0,28,1.0,0.0
5947,0,3,55,5,60,0.9166666666666666,0.08333333333333333
5927,0,3,16,439,455,0.035164835164835165,0.9648351648351648
5977,0,3,5,301,306,0.016339869281045753,0.9836601307189542
6198,0,3,0,5,5,0.0,1.0
5957,0,3,0,45,45,0.0,1.0
6057,0,3,29,0,29,1.0,0.0
6043,0,3,8,0,8,1.0,0.0
6077,0,3,0,4,4,0.0,1.0
6014,0,3,14,0,14,1.0,0.0
6015,0,3,3,0,3,1.0,0.0
5978,0,3,3,0,3,1.0,0.0
5986,0,3,17,33,50,0.34,0.66
5959,0,3,268,91,359,0.7465181058495822,0.25348189415041783
6051,0,3,31,7,38,0.8157894736842105,0.18421052631578946
6029,0,3,3,0,3,1.0,0.0
6070,0,3,1,0,1,1.0,0.0
5942,0,3,0,145,145,0.0,1.0
5953,0,3,4,0,4,1.0,0.0
6076,0,3,7,0,7,1.0,0.0
5940,0,3,10,0,10,1.0,0.0
6109,0,3,81,12,93,0.8709677419354839,0.12903225806451613
6187,0,3,3,0,3,1.0,0.0
6053,0,3,0,17,17,0.0,1.0
6104,0,3,9,0,9,1.0,0.0
5943,0,3,2,0,2,1.0,0.0
6017,0,3,3,0,3,1.0,0.0
6168,0,3,12,4,16,0.75,0.25
5989,0,3,5,1,6,0.8333333333333334,0.16666666666666666
5963,0,3,6,0,6,1.0,0.0
6194,0,3,0,26,26,0.0,1.0
6167,0,3,18,1,19,0.9473684210526315,0.05263157894736842
6004,0,3,0,64,64,0.0,1.0
6030,0,3,7,0,7,1.0,0.0
6054,0,3,6,0,6,1.0,0.0
6032,0,3,12,0,12,1.0,0.0
6170,0,3,63,1,64,0.984375,0.015625
6063,0,3,3,0,3,1.0,0.0
5988,0,3,1,0,1,1.0,0.0
6075,0,3,3,0,3,1.0,0.0
6061,0,3,0,67,67,0.0,1.0
5965,0,3,45,4,49,0.9183673469387755,0.08163265306122448
6040,0,3,10,0,10,1.0,0.0
6059,0,3,0,85,85,0.0,1.0
6106,0,3,61,2,63,0.9682539682539683,0.031746031746031744
6031,0,3,6,8,14,0.42857142857142855,0.5714285714285714
6180,0,3,0,6,6,0.0,1.0
6039,0,3,27,36,63,0.42857142857142855,0.5714285714285714
6189,1,3,0,18,18,0.0,1.0
5936,1,3,6,0,6,1.0,0.0
6087,1,3,1,10,11,0.09090909090909091,0.9090909090909091
5973,1,3,4,844,848,0.0047169811320754715,0.9952830188679245
6085,1,3,12,0,12,1.0,0.0
6012,1,3,0,62,62,0.0,1.0
5982,1,3,0,6,6,0.0,1.0
5948,1,3,0,57,57,0.0,1.0
5974,1,3,6,0,6,1.0,0.0
6090,1,3,0,4,4,0.0,1.0
6068,1,3,3,0,3,1.0,0.0
5962,1,3,37,4,41,0.9024390243902439,0.0975609756097561
6033,1,3,1,0,1,1.0,0.0
6038,1,3,2,0,2,1.0,0.0
6042,1,3,76,21,97,0.7835051546391752,0.21649484536082475
5924,1,3,3,0,3,1.0,0.0
6083,1,3,0,27,27,0.0,1.0
6178,1,3,18,0,18,1.0,0.0
5958,1,3,4,0,4,1.0,0.0
6086,1,3,0,14,14,0.0,1.0
5945,1,3,17,2,19,0.8947368421052632,0.10526315789473684
5935,1,3,5,0,5,1.0,0.0
6073,1,3,14,1,15,0.9333333333333333,0.06666666666666667
5980,1,3,44,1,45,0.9777777777777777,0.022222222222222223
5993,1,3,110,373,483,0.2277432712215321,0.772256728778468
6037,1,3,107,116,223,0.4798206278026906,0.5201793721973094
5979,1,3,5,0,5,1.0,0.0
5966,1,3,0,73,73,0.0,1.0
5985,1,3,3,0,3,1.0,0.0
5967,1,3,0,76,76,0.0,1.0
6188,1,3,21,1,22,0.9545454545454546,0.045454545454545456
6041,1,3,0,12,12,0.0,1.0
5972,1,3,13,0,13,1.0,0.0
6069,1,3,1,3,4,0.25,0.75
5937,1,3,1,0,1,1.0,0.0
6028,1,3,29,2,31,0.9354838709677419,0.06451612903225806
5990,1,3,0,130,130,0.0,1.0
5928,1,3,142,339,481,0.29521829521829523,0.7047817047817048
5992,1,3,4,0,4,1.0,0.0
6058,1,3,13,0,13,1.0,0.0
6001,1,3,28,1,29,0.9655172413793104,0.034482758620689655
5964,1,3,30,1,31,0.967741935483871,0.03225806451612903
5950,1,3,4,0,4,1.0,0.0
5991,1,3,8,0,8,1.0,0.0
6177,1,3,180,129,309,0.5825242718446602,0.4174757281553398
5961,1,3,0,321,321,0.0,1.0
6176,1,3,0,93,93,0.0,1.0
5956,1,3,0,31,31,0.0,1.0
5938,1,3,64,575,639,0.10015649452269171,0.8998435054773083
6179,1,3,27,1,28,0.9642857142857143,0.03571428571428571
5947,1,3,53,7,60,0.8833333333333333,0.11666666666666667
5927,1,3,10,445,455,0.02197802197802198,0.978021978021978
5977,1,3,6,300,306,0.0196078431372549,0.9803921568627451
6198,1,3,0,5,5,0.0,1.0
5957,1,3,0,45,45,0.0,1.0
6057,1,3,26,3,29,0.896551724137931,0.10344827586206896
6043,1,3,8,0,8,1.0,0.0
6077,1,3,0,4,4,0.0,1.0
6014,1,3,14,0,14,1.0,0.0
6015,1,3,3,0,3,1.0,0.0
5978,1,3,3,0,3,1.0,0.0
5986,1,3,16,34,50,0.32,0.68
5959,1,3,179,180,359,0.4986072423398329,0.5013927576601671
6051,1,3,33,5,38,0.868421052631579,0.13157894736842105
6029,1,3,3,0,3,1.0,0.0
6070,1,3,1,0,1,1.0,0.0
5942,1,3,0,145,145,0.0,1.0
5953,1,3,4,0,4,1.0,0.0
6076,1,3,7,0,7,1.0,0.0
5940,1,3,10,0,10,1.0,0.0
6109,1,3,69,24,93,0.7419354838709677,0.25806451612903225
6187,1,3,3,0,3,1.0,0.0
6053,1,3,0,17,17,0.0,1.0
6104,1,3,9,0,9,1.0,0.0
5943,1,3,2,0,2,1.0,0.0
6017,1,3,3,0,3,1.0,0.0
6168,1,3,12,4,16,0.75,0.25
5989,1,3,6,0,6,1.0,0.0
5963,1,3,6,0,6,1.0,0.0
6194,1,3,0,26,26,0.0,1.0
6167,1,3,19,0,19,1.0,0.0
6004,1,3,1,63,64,0.015625,0.984375
6030,1,3,7,0,7,1.0,0.0
6054,1,3,6,0,6,1.0,0.0
6032,1,3,12,0,12,1.0,0.0
6170,1,3,57,7,64,0.890625,0.109375
6063,1,3,3,0,3,1.0,0.0
5988,1,3,1,0,1,1.0,0.0
6075,1,3,3,0,3,1.0,0.0
6061,1,3,0,67,67,0.0,1.0
5965,1,3,38,11,49,0.7755102040816326,0.22448979591836735
6040,1,3,9,1,10,0.9,0.1
6059,1,3,0,85,85,0.0,1.0
6106,1,3,53,10,63,0.8412698412698413,0.15873015873015872
6031,1,3,6,8,14,0.42857142857142855,0.5714285714285714
6180,1,3,0,6,6,0.0,1.0
6039,1,3,22,41,63,0.3492063492063492,0.6507936507936508
6189,2,3,0,18,18,0.0,1.0
5936,2,3,6,0,6,1.0,0.0
6087,2,3,3,8,11,0.2727272727272727,0.7272727272727273
5973,2,3,1,847,848,0.0011792452830188679,0.9988207547169812
6085,2,3,12,0,12,1.0,0.0
6012,2,3,0,62,62,0.0,1.0
5982,2,3,1,5,6,0.16666666666666666,0.8333333333333334
5948,2,3,0,57,57,0.0,1.0
5974,2,3,6,0,6,1.0,0.0
6090,2,3,0,4,4,0.0,1.0
6068,2,3,3,0,3,1.0,0.0
5962,2,3,27,14,41,0.6585365853658537,0.34146341463414637
6033,2,3,0,1,1,0.0,1.0
6038,2,3,2,0,2,1.0,0.0
6042,2,3,53,44,97,0.5463917525773195,0.4536082474226804
5924,2,3,2,1,3,0.6666666666666666,0.3333333333333333
6083,2,3,0,27,27,0.0,1.0
6178,2,3,18,0,18,1.0,0.0
5958,2,3,4,0,4,1.0,0.0
6086,2,3,0,14,14,0.0,1.0
5945,2,3,14,5,19,0.7368421052631579,0.2631578947368421
5935,2,3,5,0,5,1.0,0.0
6073,2,3,12,3,15,0.8,0.2
5980,2,3,43,2,45,0.9555555555555556,0.044444444444444446
5993,2,3,56,427,483,0.11594202898550725,0.8840579710144928
6037,2,3,46,177,223,0.2062780269058296,0.7937219730941704
5979,2,3,5,0,5,1.0,0.0
5966,2,3,0,73,73,0.0,1.0
5985,2,3,3,0,3,1.0,0.0
5967,2,3,0,76,76,0.0,1.0
6188,2,3,16,6,22,0.7272727272727273,0.2727272727272727
6041,2,3,0,12,12,0.0,1.0
5972,2,3,13,0,13,1.0,0.0
6069,2,3,2,2,4,0.5,0.5
5937,2,3,1,0,1,1.0,0.0
6028,2,3,22,9,31,0.7096774193548387,0.2903225806451613
5990,2,3,0,130,130,0.0,1.0
5928,2,3,57,424,481,0.11850311850311851,0.8814968814968815
5992,2,3,4,0,4,1.0,0.0
6058,2,3,13,0,13,1.0,0.0
6001,2,3,22,7,29,0.7586206896551724,0.2413793103448276
5964,2,3,26,5,31,0.8387096774193549,0.16129032258064516
5950,2,3,4,0,4,1.0,0.0
5991,2,3,7,1,8,0.875,0.125
6177,2,3,57,252,309,0.18446601941747573,0.8155339805825242
5961,2,3,0,321,321,0.0,1.0
6176,2,3,0,93,93,0.0,1.0
5956,2,3,0,31,31,0.0,1.0
5938,2,3,36,603,639,0.056338028169014086,0.9436619718309859
6179,2,3,21,7,28,0.75,0.25
5947,2,3,43,17,60,0.7166666666666667,0.2833333333333333
5927,2,3,3,452,455,0.006593406593406593,0.9934065934065934
5977,2,3,2,304,306,0.006535947712418301,0.9934640522875817
6198,2,3,0,5,5,0.0,1.0
5957,2,3,0,45,45,0.0,1.0
6057,2,3,19,10,29,0.6551724137931034,0.3448275862068966
6043,2,3,8,0,8,1.0,0.0
6077,2,3,0,4,4,0.0,1.0
6014,2,3,12,2,14,0.8571428571428571,0.14285714285714285
6015,2,3,3,0,3,1.0,0.0
5978,2,3,3,0,3,1.0,0.0
5986,2,3,12,38,50,0.24,0.76
5959,2,3,77,282,359,0.21448467966573817,0.7855153203342619
6051,2,3,30,8,38,0.7894736842105263,0.21052631578947367
6029,2,3,3,0,3,1.0,0.0
6070,2,3,1,0,1,1.0,0.0
5942,2,3,0,145,145,0.0,1.0
5953,2,3,4,0,4,1.0,0.0
6076,2,3,7,0,7,1.0,0.0
5940,2,3,10,0,10,1.0,0.0
6109,2,3,33,60,93,0.3548387096774194,0.6451612903225806
6187,2,3,2,1,3,0.6666666666666666,0.3333333333333333
6053,2,3,0,17,17,0.0,1.0
6104,2,3,9,0,9,1.0,0.0
5943,2,3,2,0,2,1.0,0.0
6017,2,3,3,0,3,1.0,0.0
6168,2,3,10,6,16,0.625,0.375
5989,2,3,5,1,6,0.8333333333333334,0.16666666666666666
5963,2,3,6,0,6,1.0,0.0
6194,2,3,0,26,26,0.0,1.0
6167,2,3,17,2,19,0.8947368421052632,0.10526315789473684
6004,2,3,1,63,64,0.015625,0.984375
6030,2,3,6,1,7,0.8571428571428571,0.14285714285714285
6054,2,3,6,0,6,1.0,0.0
6032,2,3,12,0,12,1.0,0.0
6170,2,3,44,20,64,0.6875,0.3125
6063,2,3,3,0,3,1.0,0.0
5988,2,3,1,0,1,1.0,0.0
6075,2,3,3,0,3,1.0,0.0
6061,2,3,0,67,67,0.0,1.0
5965,2,3,24,25,49,0.4897959183673469,0.5102040816326531
6040,2,3,9,1,10,0.9,0.1
6059,2,3,0,85,85,0.0,1.0
6106,2,3,23,40,63,0.36507936507936506,0.6349206349206349
6031,2,3,7,7,14,0.5,0.5
6180,2,3,0,6,6,0.0,1.0
6039,2,3,21,42,63,0.3333333333333333,0.6666666666666666
6189,3,3,0,18,18,0.0,1.0
5936,3,3,6,0,6,1.0,0.0
6087,3,3,3,8,11,0.2727272727272727,0.7272727272727273
5973,3,3,2,846,848,0.0023584905660377358,0.9976415094339622
6085,3,3,12,0,12,1.0,0.0
6012,3,3,0,62,62,0.0,1.0
5982,3,3,1,5,6,0.16666666666666666,0.8333333333333334
5948,3,3,0,57,57,0.0,1.0
5974,3,3,4,2,6,0.6666666666666666,0.3333333333333333
6090,3,3,0,4,4,0.0,1.0
6068,3,3,3,0,3,1.0,0.0
5962,3,3,20,21,41,0.4878048780487805,0.5121951219512195
6033,3,3,0,1,1,0.0,1.0
6038,3,3,2,0,2,1.0,0.0
6042,3,3,36,61,97,0.3711340206185567,0.6288659793814433
5924,3,3,3,0,3,1.0,0.0
6083,3,3,0,27,27,0.0,1.0
6178,3,3,17,1,18,0.9444444444444444,0.05555555555555555
5958,3,3,4,0,4,1.0,0.0
6086,3,3,0,14,14,0.0,1.0
5945,3,3,11,8,19,0.5789473684210527,0.42105263157894735
5935,3,3,4,1,5,0.8,0.2
6073,3,3,10,5,15,0.6666666666666666,0.3333333333333333
5980,3,3,36,9,45,0.8,0.2
5993,3,3,38,445,483,0.07867494824016563,0.9213250517598344
6037,3,3,26,197,223,0.11659192825112108,0.8834080717488789
5979,3,3,5,0,5,1.0,0.0
5966,3,3,0,73,73,0.0,1.0
5985,3,3,3,0,3,1.0,0.0
5967,3,3,0,76,76,0.0,1.0
6188,3,3,16,6,22,0.7272727272727273,0.2727272727272727
6041,3,3,0,12,12,0.0,1.0
5972,3,3,12,1,13,0.9230769230769231,0.07692307692307693
6069,3,3,0,4,4,0.0,1.0
5937,3,3,1,0,1,1.0,0.0
6028,3,3,17,14,31,0.5483870967741935,0.45161290322580644
5990,3,3,0,130,130,0.0,1.0
5928,3,3,31,450,481,0.06444906444906445,0.9355509355509356
5992,3,3,4,0,4,1.0,0.0
6058,3,3,12,1,13,0.9230769230769231,0.07692307692307693
6001,3,3,18,11,29,0.6206896551724138,0.3793103448275862
5964,3,3,23,8,31,0.7419354838709677,0.25806451612903225
5950,3,3,3,1,4,0.75,0.25
5991,3,3,5,3,8,0.625,0.375
6177,3,3,41,268,309,0.13268608414239483,0.8673139158576052
5961,3,3,0,321,321,0.0,1.0
6176,3,3,0,93,93,0.0,1.0
5956,3,3,0,31,31,0.0,1.0
5938,3,3,13,626,639,0.02034428794992175,0.9796557120500783
6179,3,3,15,13,28,0.5357142857142857,0.4642857142857143
5947,3,3,35,25,60,0.5833333333333334,0.4166666666666667
5927,3,3,2,453,455,0.004395604395604396,0.9956043956043956
5977,3,3,3,303,306,0.00980392156862745,0.9901960784313726
6198,3,3,0,5,5,0.0,1.0
5957,3,3,0,45,45,0.0,1.0
6057,3,3,19,10,29,0.6551724137931034,0.3448275862068966
6043,3,3,8,0,8,1.0,0.0
6077,3,3,0,4,4,0.0,1.0
6014,3,3,11,3,14,0.7857142857142857,0.21428571428571427
6015,3,3,3,0,3,1.0,0.0
5978,3,3,2,1,3,0.6666666666666666,0.3333333333333333
5986,3,3,10,40,50,0.2,0.8
5959,3,3,52,307,359,0.14484679665738162,0.8551532033426184
6051,3,3,26,12,38,0.6842105263157895,0.3157894736842105
6029,3,3,2,1,3,0.6666666666666666,0.3333333333333333
6070,3,3,1,0,1,1.0,0.0
5942,3,3,0,145,145,0.0,1.0
5953,3,3,4,0,4,1.0,0.0
6076,3,3,6,1,7,0.8571428571428571,0.14285714285714285
5940,3,3,10,0,10,1.0,0.0
6109,3,3,20,73,93,0.21505376344086022,0.7849462365591398
6187,3,3,2,1,3,0.6666666666666666,0.3333333333333333
6053,3,3,0,17,17,0.0,1.0
6104,3,3,8,1,9,0.8888888888888888,0.1111111111111111
5943,3,3,2,0,2,1.0,0.0
6017,3,3,2,1,3,0.6666666666666666,0.3333333333333333
6168,3,3,10,6,16,0.625,0.375
5989,3,3,5,1,6,0.8333333333333334,0.16666666666666666
5963,3,3,6,0,6,1.0,0.0
6194,3,3,0,26,26,0.0,1.0
6167,3,3,17,2,19,0.8947368421052632,0.10526315789473684
6004,3,3,0,64,64,0.0,1.0
6030,3,3,7,0,7,1.0,0.0
6054,3,3,5,1,6,0.8333333333333334,0.16666666666666666
6032,3,3,12,0,12,1.0,0.0
6170,3,3,28,36,64,0.4375,0.5625
6063,3,3,3,0,3,1.0,0.0
5988,3,3,1,0,1,1.0,0.0
6075,3,3,3,0,3,1.0,0.0
6061,3,3,0,67,67,0.0,1.0
5965,3,3,19,30,49,0.3877551020408163,0.6122448979591837
6040,3,3,10,0,10,1.0,0.0
6059,3,3,0,85,85,0.0,1.0
6106,3,3,25,38,63,0.3968253968253968,0.6031746031746031
6031,3,3,7,7,14,0.5,0.5
6180,3,3,0,6,6,0.0,1.0
6039,3,3,14,49,63,0.2222222222222222,0.7777777777777778
6189,4,3,0,18,18,0.0,1.0
5936,4,3,6,0,6,1.0,0.0
6087,4,3,3,8,11,0.2727272727272727,0.7272727272727273
5973,4,3,1,847,848,0.0011792452830188679,0.9988207547169812
6085,4,3,12,0,12,1.0,0.0
6012,4,3,0,62,62,0.0,1.0
5982,4,3,1,5,6,0.16666666666666666,0.8333333333333334
5948,4,3,0,57,57,0.0,1.0
5974,4,3,3,3,6,0.5,0.5
6090,4,3,0,4,4,0.0,1.0
6068,4,3,3,0,3,1.0,0.0
5962,4,3,17,24,41,0.4146341463414634,0.5853658536585366
6033,4,3,0,1,1,0.0,1.0
6038,4,3,2,0,2,1.0,0.0
6042,4,3,24,73,97,0.24742268041237114,0.7525773195876289
5924,4,3,2,1,3,0.6666666666666666,0.3333333333333333
6083,4,3,0,27,27,0.0,1.0
6178,4,3,14,4,18,0.7777777777777778,0.2222222222222222
5958,4,3,3,1,4,0.75,0.25
6086,4,3,0,14,14,0.0,1.0
5945,4,3,8,11,19,0.42105263157894735,0.5789473684210527
5935,4,3,4,1,5,0.8,0.2
6073,4,3,8,7,15,0.5333333333333333,0.4666666666666667
5980,4,3,29,16,45,0.6444444444444445,0.35555555555555557
5993,4,3,18,465,483,0.037267080745341616,0.9627329192546584
6037,4,3,10,213,223,0.04484304932735426,0.9551569506726457
5979,4,3,5,0,5,1.0,0.0
5966,4,3,0,73,73,0.0,1.0
5985,4,3,3,0,3,1.0,0.0
5967,4,3,0,76,76,0.0,1.0
6188,4,3,10,12,22,0.45454545454545453,0.5454545454545454
6041,4,3,0,12,12,0.0,1.0
5972,4,3,13,0,13,1.0,0.0
6069,4,3,1,3,4,0.25,0.75
5937,4,3,1,0,1,1.0,0.0
6028,4,3,14,17,31,0.45161290322580644,0.5483870967741935
5990,4,3,0,130,130,0.0,1.0
5928,4,3,20,461,481,0.04158004158004158,0.9584199584199584
5992,4,3,4,0,4,1.0,0.0
6058,4,3,12,1,13,0.9230769230769231,0.07692307692307693
6001,4,3,11,18,29,0.3793103448275862,0.6206896551724138
5964,4,3,22,9,31,0.7096774193548387,0.2903225806451613
5950,4,3,4,0,4,1.0,0.0
5991,4,3,3,5,8,0.375,0.625
6177,4,3,21,288,309,0.06796116504854369,0.9320388349514563
5961,4,3,0,321,321,0.0,1.0
6176,4,3,0,93,93,0.0,1.0
5956,4,3,0,31,31,0.0,1.0
5938,4,3,10,629,639,0.01564945226917058,0.9843505477308294
6179,4,3,11,17,28,0.39285714285714285,0.6071428571428571
5947,4,3,25,35,60,0.4166666666666667,0.5833333333333334
5927,4,3,2,453,455,0.004395604395604396,0.9956043956043956
5977,4,3,0,306,306,0.0,1.0
6198,4,3,0,5,5,0.0,1.0
5957,4,3,0,45,45,0.0,1.0
6057,4,3,10,19,29,0.3448275862068966,0.6551724137931034
6043,4,3,8,0,8,1.0,0.0
6077,4,3,0,4,4,0.0,1.0
6014,4,3,11,3,14,0.7857142857142857,0.21428571428571427
6015,4,3,2,1,3,0.6666666666666666,0.3333333333333333
5978,4,3,2,1,3,0.6666666666666666,0.3333333333333333
5986,4,3,7,43,50,0.14,0.86
5959,4,3,33,326,359,0.09192200557103064,0.9080779944289693
6051,4,3,22,16,38,0.5789473684210527,0.42105263157894735
6029,4,3,2,1,3,0.6666666666666666,0.3333333333333333
6070,4,3,1,0,1,1.0,0.0
5942,4,3,0,145,145,0.0,1.0
5953,4,3,4,0,4,1.0,0.0
6076,4,3,5,2,7,0.7142857142857143,0.2857142857142857
5940,4,3,6,4,10,0.6,0.4
6109,4,3,14,79,93,0.15053763440860216,0.8494623655913979
6187,4,3,2,1,3,0.6666666666666666,0.3333333333333333
6053,4,3,0,17,17,0.0,1.0
6104,4,3,9,0,9,1.0,0.0
5943,4,3,2,0,2,1.0,0.0
6017,4,3,3,0,3,1.0,0.0
6168,4,3,7,9,16,0.4375,0.5625
5989,4,3,5,1,6,0.8333333333333334,0.16666666666666666
5963,4,3,6,0,6,1.0,0.0
6194,4,3,0,26,26,0.0,1.0
6167,4,3,14,5,19,0.7368421052631579,0.2631578947368421
6004,4,3,1,63,64,0.015625,0.984375
6030,4,3,6,1,7,0.8571428571428571,0.14285714285714285
6054,4,3,5,1,6,0.8333333333333334,0.16666666666666666
6032,4,3,10,2,12,0.8333333333333334,0.16666666666666666
6170,4,3,19,45,64,0.296875,0.703125
6063,4,3,3,0,3,1.0,0.0
5988,4,3,1,0,1,1.0,0.0
6075,4,3,3,0,3,1.0,0.0
6061,4,3,0,67,67,0.0,1.0
5965,4,3,15,34,49,0.30612244897959184,0.6938775510204082
6040,4,3,8,2,10,0.8,0.2
6059,4,3,0,85,85,0.0,1.0
6106,4,3,12,51,63,0.19047619047619047,0.8095238095238095
6031,4,3,5,9,14,0.35714285714285715,0.6428571428571429
6180,4,3,0,6,6,0.0,1.0
6039,4,3,10,53,63,0.15873015873015872,0.8412698412698413
6189,5,3,0,18,18,0.0,1.0
5936,5,3,5,1,6,0.8333333333333334,0.16666666666666666
6087,5,3,2,9,11,0.18181818181818182,0.8181818181818182
5973,5,3,0,848,848,0.0,1.0
6085,5,3,9,3,12,0.75,0.25
6012,5,3,0,62,62,0.0,1.0
5982,5,3,1,5,6,0.16666666666666666,0.8333333333333334
5948,5,3,0,57,57,0.0,1.0
5974,5,3,3,3,6,0.5,0.5
6090,5,3,0,4,4,0.0,1.0
6068,5,3,3,0,3,1.0,0.0
5962,5,3,12,29,41,0.2926829268292683,0.7073170731707317
6033,5,3,0,1,1,0.0,1.0
6038,5,3,2,0,2,1.0,0.0
6042,5,3,23,74,97,0.23711340206185566,0.7628865979381443
5924,5,3,2,1,3,0.6666666666666666,0.3333333333333333
6083,5,3,0,27,27,0.0,1.0
6178,5,3,14,4,18,0.7777777777777778,0.2222222222222222
5958,5,3,3,1,4,0.75,0.25
6086,5,3,0,14,14,0.0,1.0
5945,5,3,3,16,19,0.15789473684210525,0.8421052631578947
5935,5,3,4,1,5,0.8,0.2
6073,5,3,10,5,15,0.6666666666666666,0.3333333333333333
5980,5,3,30,15,45,0.6666666666666666,0.3333333333333333
5993,5,3,15,468,483,0.031055900621118012,0.968944099378882
6037,5,3,11,212,223,0.04932735426008968,0.9506726457399103
5979,5,3,5,0,5,1.0,0.0
5966,5,3,0,73,73,0.0,1.0
5985,5,3,3,0,3,1.0,0.0
5967,5,3,0,76,76,0.0,1.0
6188,5,3,7,15,22,0.3181818181818182,0.6818181818181818
6041,5,3,0,12,12,0.0,1.0
5972,5,3,10,3,13,0.7692307692307693,0.23076923076923078
6069,5,3,2,2,4,0.5,0.5
5937,5,3,1,0,1,1.0,0.0
6028,5,3,10,21,31,0.3225806451612903,0.6774193548387096
5990,5,3,0,130,130,0.0,1.0
5928,5,3,13,468,481,0.02702702702702703,0.972972972972973
5992,5,3,4,0,4,1.0,0.0
6058,5,3,11,2,13,0.8461538461538461,0.15384615384615385
6001,5,3,12,17,29,0.41379310344827586,0.5862068965517241
5964,5,3,16,15,31,0.5161290322580645,0.4838709677419355
5950,5,3,3,1,4,0.75,0.25
5991,5,3,6,2,8,0.75,0.25
6177,5,3,11,298,309,0.03559870550161812,0.9644012944983819
5961,5,3,0,321,321,0.0,1.0
6176,5,3,0,93,93,0.0,1.0
5956,5,3,0,31,31,0.0,1.0
5938,5,3,8,631,639,0.012519561815336464,0.9874804381846636
6179,5,3,5,23,28,0.17857142857142858,0.8214285714285714
5947,5,3,22,38,60,0.36666666666666664,0.6333333333333333
5927,5,3,1,454,455,0.002197802197802198,0.9978021978021978
5977,5,3,1,305,306,0.0032679738562091504,0.9967320261437909
6198,5,3,0,5,5,0.0,1.0
5957,5,3,0,45,45,0.0,1.0
6057,5,3,8,21,29,0.27586206896551724,0.7241379310344828
6043,5,3,8,0,8,1.0,0.0
6077,5,3,0,4,4,0.0,1.0
6014,5,3,12,2,14,0.8571428571428571,0.14285714285714285
6015,5,3,1,2,3,0.3333333333333333,0.6666666666666666
5978,5,3,2,1,3,0.6666666666666666,0.3333333333333333
5986,5,3,7,43,50,0.14,0.86
5959,5,3,17,342,359,0.04735376044568245,0.9526462395543176
6051,5,3,19,19,38,0.5,0.5
6029,5,3,1,2,3,0.3333333333333333,0.6666666666666666
6070,5,3,1,0,1,1.0,0.0
5942,5,3,0,145,145,0.0,1.0
5953,5,3,4,0,4,1.0,0.0
6076,5,3,4,3,7,0.5714285714285714,0.42857142857142855
5940,5,3,7,3,10,0.7,0.3
6109,5,3,12,81,93,0.12903225806451613,0.8709677419354839
6187,5,3,2,1,3,0.6666666666666666,0.3333333333333333
6053,5,3,0,17,17,0.0,1.0
6104,5,3,8,1,9,0.8888888888888888,0.1111111111111111
5943,5,3,2,0,2,1.0,0.0
6017,5,3,3,0,3,1.0,0.0
6168,5,3,4,12,16,0.25,0.75
5989,5,3,5,1,6,0.8333333333333334,0.16666666666666666
5963,5,3,6,0,6,1.0,0.0
6194,5,3,0,26,26,0.0,1.0
6167,5,3,9,10,19,0.47368421052631576,0.5263157894736842
6004,5,3,0,64,64,0.0,1.0
6030,5,3,6,1,7,0.8571428571428571,0.14285714285714285
6054,5,3,6,0,6,1.0,0.0
6032,5,3,9,3,12,0.75,0.25
6170,5,3,19,45,64,0.296875,0.703125
6063,5,3,3,0,3,1.0,0.0
5988,5,3,1,0,1,1.0,0.0
6075,5,3,3,0,3,1.0,0.0
6061,5,3,0,67,67,0.0,1.0
5965,5,3,9,40,49,0.1836734693877551,0.8163265306122449
6040,5,3,9,1,10,0.9,0.1
6059,5,3,0,85,85,0.0,1.0
6106,5,3,7,56,63,0.1111111111111111,0.8888888888888888
6031,5,3,6,8,14,0.42857142857142855,0.5714285714285714
6180,5,3,0,6,6,0.0,1.0
6039,5,3,11,52,63,0.1746031746031746,0.8253968253968254
6189,6,3,0,18,18,0.0,1.0
5936,6,3,4,2,6,0.6666666666666666,0.3333333333333333
6087,6,3,2,9,11,0.18181818181818182,0.8181818181818182
5973,6,3,1,847,848,0.0011792452830188679,0.9988207547169812
6085,6,3,6,6,12,0.5,0.5
6012,6,3,0,62,62,0.0,1.0
5982,6,3,0,6,6,0.0,1.0
5948,6,3,0,57,57,0.0,1.0
5974,6,3,2,4,6,0.3333333333333333,0.6666666666666666
6090,6,3,0,4,4,0.0,1.0
6068,6,3,3,0,3,1.0,0.0
5962,6,3,10,31,41,0.24390243902439024,0.7560975609756098
6033,6,3,0,1,1,0.0,1.0
6038,6,3,2,0,2,1.0,0.0
6042,6,3,14,83,97,0.14432989690721648,0.8556701030927835
5924,6,3,2,1,3,0.6666666666666666,0.3333333333333333
6083,6,3,0,27,27,0.0,1.0
6178,6,3,10,8,18,0.5555555555555556,0.4444444444444444
5958,6,3,4,0,4,1.0,0.0
6086,6,3,0,14,14,0.0,1.0
5945,6,3,3,16,19,0.15789473684210525,0.8421052631578947
5935,6,3,4,1,5,0.8,0.2
6073,6,3,8,7,15,0.5333333333333333,0.4666666666666667
5980,6,3,20,25,45,0.4444444444444444,0.5555555555555556
5993,6,3,8,475,483,0.016563146997929608,0.9834368530020704
6037,6,3,7,216,223,0.03139013452914798,0.968609865470852
5979,6,3,5,0,5,1.0,0.0
5966,6,3,0,73,73,0.0,1.0
5985,6,3,3,0,3,1.0,0.0
5967,6,3,0,76,76,0.0,1.0
6188,6,3,6,16,22,0.2727272727272727,0.7272727272727273
6041,6,3,0,12,12,0.0,1.0
5972,6,3,10,3,13,0.7692307692307693,0.23076923076923078
6069,6,3,1,3,4,0.25,0.75
5937,6,3,1,0,1,1.0,0.0
6028,6,3,7,24,31,0.22580645161290322,0.7741935483870968
5990,6,3,0,130,130,0.0,1.0
5928,6,3,13,468,481,0.02702702702702703,0.972972972972973
5992,6,3,3,1,4,0.75,0.25
6058,6,3,10,3,13,0.7692307692307693,0.23076923076923078
6001,6,3,7,22,29,0.2413793103448276,0.7586206896551724
5964,6,3,15,16,31,0.4838709677419355,0.5161290322580645
5950,6,3,3,1,4,0.75,0.25
5991,6,3,2,6,8,0.25,0.75
6177,6,3,15,294,309,0.04854368932038835,0.9514563106796117
5961,6,3,0,321,321,0.0,1.0
6176,6,3,0,93,93,0.0,1.0
5956,6,3,0,31,31,0.0,1.0
5938,6,3,7,632,639,0.010954616588419406,0.9890453834115805
6179,6,3,5,23,28,0.17857142857142858,0.8214285714285714
5947,6,3,16,44,60,0.26666666666666666,0.7333333333333333
5927,6,3,2,453,455,0.004395604395604396,0.9956043956043956
5977,6,3,1,305,306,0.0032679738562091504,0.9967320261437909
6198,6,3,0,5,5,0.0,1.0
5957,6,3,0,45,45,0.0,1.0
6057,6,3,10,19,29,0.3448275862068966,0.6551724137931034
6043,6,3,8,0,8,1.0,0.0
6077,6,3,0,4,4,0.0,1.0
6014,6,3,9,5,14,0.6428571428571429,0.35714285714285715
6015,6,3,3,0,3,1.0,0.0
5978,6,3,2,1,3,0.6666666666666666,0.3333333333333333
5986,6,3,1,49,50,0.02,0.98
5959,6,3,19,340,359,0.052924791086350974,0.947075208913649
6051,6,3,13,25,38,0.34210526315789475,0.6578947368421053
6029,6,3,1,2,3,0.3333333333333333,0.6666666666666666
6070,6,3,1,0,1,1.0,0.0
5942,6,3,0,145,145,0.0,1.0
5953,6,3,4,0,4,1.0,0.0
6076,6,3,4,3,7,0.5714285714285714,0.42857142857142855
5940,6,3,4,6,10,0.4,0.6
6109,6,3,9,84,93,0.0967741935483871,0.9032258064516129
6187,6,3,3,0,3,1.0,0.0
6053,6,3,0,17,17,0.0,1.0
6104,6,3,8,1,9,0.8888888888888888,0.1111111111111111
5943,6,3,2,0,2,1.0,0.0
6017,6,3,2,1,3,0.6666666666666666,0.3333333333333333
6168,6,3,6,10,16,0.375,0.625
5989,6,3,5,1,6,0.8333333333333334,0.16666666666666666
5963,6,3,6,0,6,1.0,0.0
6194,6,3,0,26,26,0.0,1.0
6167,6,3,11,8,19,0.5789473684210527,0.42105263157894735
6004,6,3,0,64,64,0.0,1.0
6030,6,3,6,1,7,0.8571428571428571,0.14285714285714285
6054,6,3,4,2,6,0.6666666666666666,0.3333333333333333
6032,6,3,9,3,12,0.75,0.25
6170,6,3,15,49,64,0.234375,0.765625
6063,6,3,3,0,3,1.0,0.0
5988,6,3,1,0,1,1.0,0.0
6075,6,3,2,1,3,0.6666666666666666,0.3333333333333333
6061,6,3,0,67,67,0.0,1.0
5965,6,3,9,40,49,0.1836734693877551,0.8163265306122449
6040,6,3,8,2,10,0.8,0.2
6059,6,3,0,85,85,0.0,1.0
6106,6,3,1,62,63,0.015873015873015872,0.9841269841269841
6031,6,3,6,8,14,0.42857142857142855,0.5714285714285714
6180,6,3,0,6,6,0.0,1.0
6039,6,3,8,55,63,0.12698412698412698,0.873015873015873
6189,7,3,0,18,18,0.0,1.0
5936,7,3,5,1,6,0.8333333333333334,0.16666666666666666
6087,7,3,2,9,11,0.18181818181818182,0.8181818181818182
5973,7,3,2,846,848,0.0023584905660377358,0.9976415094339622
6085,7,3,7,5,12,0.5833333333333334,0.4166666666666667
6012,7,3,0,62,62,0.0,1.0
5982,7,3,1,5,6,0.16666666666666666,0.8333333333333334
5948,7,3,0,57,57,0.0,1.0
5974,7,3,3,3,6,0.5,0.5
6090,7,3,0,4,4,0.0,1.0
6068,7,3,3,0,3,1.0,0.0
5962,7,3,6,35,41,0.14634146341463414,0.8536585365853658
6033,7,3,0,1,1,0.0,1.0
6038,7,3,2,0,2,1.0,0.0
6042,7,3,14,83,97,0.14432989690721648,0.8556701030927835
5924,7,3,0,3,3,0.0,1.0
6083,7,3,0,27,27,0.0,1.0
6178,7,3,8,10,18,0.4444444444444444,0.5555555555555556
5958,7,3,3,1,4,0.75,0.25
6086,7,3,0,14,14,0.0,1.0
5945,7,3,4,15,19,0.21052631578947367,0.7894736842105263
5935,7,3,4,1,5,0.8,0.2
6073,7,3,7,8,15,0.4666666666666667,0.5333333333333333
5980,7,3,14,31,45,0.3111111111111111,0.6888888888888889
5993,7,3,10,473,483,0.020703933747412008,0.979296066252588
6037,7,3,4,219,223,0.017937219730941704,0.9820627802690582
5979,7,3,5,0,5,1.0,0.0
5966,7,3,0,73,73,0.0,1.0
5985,7,3,2,1,3,0.6666666666666666,0.3333333333333333
5967,7,3,0,76,76,0.0,1.0
6188,7,3,5,17,22,0.22727272727272727,0.7727272727272727
6041,7,3,0,12,12,0.0,1.0
5972,7,3,8,5,13,0.6153846153846154,0.38461538461538464
6069,7,3,1,3,4,0.25,0.75
5937,7,3,1,0,1,1.0,0.0
6028,7,3,9,22,31,0.2903225806451613,0.7096774193548387
5990,7,3,0,130,130,0.0,1.0
5928,7,3,16,465,481,0.033264033264033266,0.9667359667359667
5992,7,3,2,2,4,0.5,0.5
6058,7,3,10,3,13,0.7692307692307693,0.23076923076923078
6001,7,3,2,27,29,0.06896551724137931,0.9310344827586207
5964,7,3,10,21,31,0.3225806451612903,0.6774193548387096
5950,7,3,2,2,4,0.5,0.5
5991,7,3,2,6,8,0.25,0.75
6177,7,3,12,297,309,0.038834951456310676,0.9611650485436893
5961,7,3,0,321,321,0.0,1.0
6176,7,3,0,93,93,0.0,1.0
5956,7,3,0,31,31,0.0,1.0
5938,7,3,7,632,639,0.010954616588419406,0.9890453834115805
6179,7,3,3,25,28,0.10714285714285714,0.8928571428571429
5947,7,3,11,49,60,0.18333333333333332,0.8166666666666667
5927,7,3,1,454,455,0.002197802197802198,0.9978021978021978
5977,7,3,1,305,306,0.0032679738562091504,0.9967320261437909
6198,7,3,0,5,5,0.0,1.0
5957,7,3,0,45,45,0.0,1.0
6057,7,3,7,22,29,0.2413793103448276,0.7586206896551724
6043,7,3,8,0,8,1.0,0.0
6077,7,3,0,4,4,0.0,1.0
6014,7,3,8,6,14,0.5714285714285714,0.42857142857142855
6015,7,3,1,2,3,0.3333333333333333,0.6666666666666666
5978,7,3,2,1,3,0.6666666666666666,0.3333333333333333
5986,7,3,4,46,50,0.08,0.92
5959,7,3,4,355,359,0.011142061281337047,0.9888579387186629
6051,7,3,11,27,38,0.2894736842105263,0.7105263157894737
6029,7,3,1,2,3,0.3333333333333333,0.6666666666666666
6070,7,3,1,0,1,1.0,0.0
5942,7,3,0,145,145,0.0,1.0
5953,7,3,4,0,4,1.0,0.0
6076,7,3,3,4,7,0.42857142857142855,0.5714285714285714
5940,7,3,6,4,10,0.6,0.4
6109,7,3,11,82,93,0.11827956989247312,0.8817204301075269
6187,7,3,1,2,3,0.3333333333333333,0.6666666666666666
6053,7,3,0,17,17,0.0,1.0
6104,7,3,8,1,9,0.8888888888888888,0.1111111111111111
5943,7,3,2,0,2,1.0,0.0
6017,7,3,2,1,3,0.6666666666666666,0.3333333333333333
6168,7,3,9,7,16,0.5625,0.4375
5989,7,3,4,2,6,0.6666666666666666,0.3333333333333333
5963,7,3,6,0,6,1.0,0.0
6194,7,3,0,26,26,0.0,1.0
6167,7,3,8,11,19,0.42105263157894735,0.5789473684210527
6004,7,3,1,63,64,0.015625,0.984375
6030,7,3,7,0,7,1.0,0.0
6054,7,3,3,3,6,0.5,0.5
6032,7,3,8,4,12,0.6666666666666666,0.3333333333333333
6170,7,3,10,54,64,0.15625,0.84375
6063,7,3,3,0,3,1.0,0.0
5988,7,3,1,0,1,1.0,0.0
6075,7,3,1,2,3,0.3333333333333333,0.6666666666666666
6061,7,3,0,67,67,0.0,1.0
5965,7,3,9,40,49,0.1836734693877551,0.8163265306122449
6040,7,3,8,2,10,0.8,0.2
6059,7,3,0,85,85,0.0,1.0
6106,7,3,1,62,63,0.015873015873015872,0.9841269841269841
6031,7,3,3,11,14,0.21428571428571427,0.7857142857142857
6180,7,3,0,6,6,0.0,1.0
6039,7,3,6,57,63,0.09523809523809523,0.9047619047619048
6189,8,3,0,18,18,0.0,1.0
5936,8,3,4,2,6,0.6666666666666666,0.3333333333333333
6087,8,3,3,8,11,0.2727272727272727,0.7272727272727273
5973,8,3,1,847,848,0.0011792452830188679,0.9988207547169812
6085,8,3,5,7,12,0.4166666666666667,0.5833333333333334
6012,8,3,0,62,62,0.0,1.0
5982,8,3,1,5,6,0.16666666666666666,0.8333333333333334
5948,8,3,0,57,57,0.0,1.0
5974,8,3,3,3,6,0.5,0.5
6090,8,3,0,4,4,0.0,1.0
6068,8,3,3,0,3,1.0,0.0
5962,8,3,7,34,41,0.17073170731707318,0.8292682926829268
6033,8,3,0,1,1,0.0,1.0
6038,8,3,2,0,2,1.0,0.0
6042,8,3,2,95,97,0.020618556701030927,0.979381443298969
5924,8,3,0,3,3,0.0,1.0
6083,8,3,0,27,27,0.0,1.0
6178,8,3,10,8,18,0.5555555555555556,0.4444444444444444
5958,8,3,3,1,4,0.75,0.25
6086,8,3,0,14,14,0.0,1.0
5945,8,3,7,12,19,0.3684210526315789,0.631578947368421
5935,8,3,4,1,5,0.8,0.2
6073,8,3,7,8,15,0.4666666666666667,0.5333333333333333
5980,8,3,9,36,45,0.2,0.8
5993,8,3,6,477,483,0.012422360248447204,0.9875776397515528
6037,8,3,6,217,223,0.026905829596412557,0.9730941704035875
5979,8,3,5,0,5,1.0,0.0
5966,8,3,0,73,73,0.0,1.0
5985,8,3,1,2,3,0.3333333333333333,0.6666666666666666
5967,8,3,0,76,76,0.0,1.0
6188,8,3,4,18,22,0.18181818181818182,0.8181818181818182
6041,8,3,0,12,12,0.0,1.0
5972,8,3,6,7,13,0.46153846153846156,0.5384615384615384
6069,8,3,2,2,4,0.5,0.5
5937,8,3,1,0,1,1.0,0.0
6028,8,3,10,21,31,0.3225806451612903,0.6774193548387096
5990,8,3,0,130,130,0.0,1.0
5928,8,3,7,474,481,0.014553014553014554,0.9854469854469855
5992,8,3,3,1,4,0.75,0.25
6058,8,3,5,8,13,0.38461538461538464,0.6153846153846154
6001,8,3,5,24,29,0.1724137931034483,0.8275862068965517
5964,8,3,14,17,31,0.45161290322580644,0.5483870967741935
5950,8,3,4,0,4,1.0,0.0
5991,8,3,4,4,8,0.5,0.5
6177,8,3,9,300,309,0.02912621359223301,0.970873786407767
5961,8,3,0,321,321,0.0,1.0
6176,8,3,0,93,93,0.0,1.0
5956,8,3,0,31,31,0.0,1.0
5938,8,3,3,636,639,0.004694835680751174,0.9953051643192489
6179,8,3,6,22,28,0.21428571428571427,0.7857142857142857
5947,8,3,13,47,60,0.21666666666666667,0.7833333333333333
5927,8,3,2,453,455,0.004395604395604396,0.9956043956043956
5977,8,3,1,305,306,0.0032679738562091504,0.9967320261437909
6198,8,3,0,5,5,0.0,1.0
5957,8,3,0,45,45,0.0,1.0
6057,8,3,3,26,29,0.10344827586206896,0.896551724137931
6043,8,3,8,0,8,1.0,0.0
6077,8,3,0,4,4,0.0,1.0
6014,8,3,7,7,14,0.5,0.5
6015,8,3,2,1,3,0.6666666666666666,0.3333333333333333
5978,8,3,2,1,3,0.6666666666666666,0.3333333333333333
5986,8,3,4,46,50,0.08,0.92
5959,8,3,11,348,359,0.03064066852367688,0.9693593314763231
6051,8,3,11,27,38,0.2894736842105263,0.7105263157894737
6029,8,3,1,2,3,0.3333333333333333,0.6666666666666666
6070,8,3,1,0,1,1.0,0.0
5942,8,3,0,145,145,0.0,1.0
5953,8,3,4,0,4,1.0,0.0
6076,8,3,2,5,7,0.2857142857142857,0.7142857142857143
5940,8,3,3,7,10,0.3,0.7
6109,8,3,6,87,93,0.06451612903225806,0.9354838709677419
6187,8,3,2,1,3,0.6666666666666666,0.3333333333333333
6053,8,3,0,17,17,0.0,1.0
6104,8,3,6,3,9,0.6666666666666666,0.3333333333333333
5943,8,3,1,1,2,0.5,0.5
6017,8,3,2,1,3,0.6666666666666666,0.3333333333333333
6168,8,3,3,13,16,0.1875,0.8125
5989,8,3,2,4,6,0.3333333333333333,0.6666666666666666
5963,8,3,6,0,6,1.0,0.0
6194,8,3,0,26,26,0.0,1.0
6167,8,3,6,13,19,0.3157894736842105,0.6842105263157895
6004,8,3,1,63,64,0.015625,0.984375
6030,8,3,6,1,7,0.8571428571428571,0.14285714285714285
6054,8,3,5,1,6,0.8333333333333334,0.16666666666666666
6032,8,3,8,4,12,0.6666666666666666,0.3333333333333333
6170,8,3,10,54,64,0.15625,0.84375
6063,8,3,3,0,3,1.0,0.0
5988,8,3,1,0,1,1.0,0.0
6075,8,3,1,2,3,0.3333333333333333,0.6666666666666666
6061,8,3,0,67,67,0.0,1.0
5965,8,3,10,39,49,0.20408163265306123,0.7959183673469388
6040,8,3,6,4,10,0.6,0.4
6059,8,3,0,85,85,0.0,1.0
6106,8,3,2,61,63,0.031746031746031744,0.9682539682539683
6031,8,3,4,10,14,0.2857142857142857,0.7142857142857143
6180,8,3,0,6,6,0.0,1.0
6039,8,3,8,55,63,0.12698412698412698,0.873015873015873
6189,9,3,0,18,18,0.0,1.0
5936,9,3,4,2,6,0.6666666666666666,0.3333333333333333
6087,9,3,2,9,11,0.18181818181818182,0.8181818181818182
5973,9,3,1,847,848,0.0011792452830188679,0.9988207547169812
6085,9,3,6,6,12,0.5,0.5
6012,9,3,0,62,62,0.0,1.0
5982,9,3,0,6,6,0.0,1.0
5948,9,3,0,57,57,0.0,1.0
5974,9,3,4,2,6,0.6666666666666666,0.3333333333333333
6090,9,3,0,4,4,0.0,1.0
6068,9,3,3,0,3,1.0,0.0
5962,9,3,10,31,41,0.24390243902439024,0.7560975609756098
6033,9,3,0,1,1,0.0,1.0
6038,9,3,2,0,2,1.0,0.0
6042,9,3,5,92,97,0.05154639175257732,0.9484536082474226
5924,9,3,0,3,3,0.0,1.0
6083,9,3,0,27,27,0.0,1.0
6178,9,3,10,8,18,0.5555555555555556,0.4444444444444444
5958,9,3,3,1,4,0.75,0.25
6086,9,3,0,14,14,0.0,1.0
5945,9,3,2,17,19,0.10526315789473684,0.8947368421052632
5935,9,3,4,1,5,0.8,0.2
6073,9,3,4,11,15,0.26666666666666666,0.7333333333333333
5980,9,3,7,38,45,0.15555555555555556,0.8444444444444444
5993,9,3,10,473,483,0.020703933747412008,0.979296066252588
6037,9,3,3,220,223,0.013452914798206279,0.9865470852017937
5979,9,3,4,1,5,0.8,0.2
5966,9,3,0,73,73,0.0,1.0
5985,9,3,1,2,3,0.3333333333333333,0.6666666666666666
5967,9,3,0,76,76,0.0,1.0
6188,9,3,6,16,22,0.2727272727272727,0.7272727272727273
6041,9,3,0,12,12,0.0,1.0
5972,9,3,8,5,13,0.6153846153846154,0.38461538461538464
6069,9,3,0,4,4,0.0,1.0
5937,9,3,1,0,1,1.0,0.0
6028,9,3,5,26,31,0.16129032258064516,0.8387096774193549
5990,9,3,0,130,130,0.0,1.0
5928,9,3,9,472,481,0.018711018711018712,0.9812889812889813
5992,9,3,3,1,4,0.75,0.25
6058,9,3,5,8,13,0.38461538461538464,0.6153846153846154
6001,9,3,2,27,29,0.06896551724137931,0.9310344827586207
5964,9,3,11,20,31,0.3548387096774194,0.6451612903225806
5950,9,3,2,2,4,0.5,0.5
5991,9,3,3,5,8,0.375,0.625
6177,9,3,2,307,309,0.006472491909385114,0.9935275080906149
5961,9,3,0,321,321,0.0,1.0
6176,9,3,0,93,93,0.0,1.0
5956,9,3,0,31,31,0.0,1.0
5938,9,3,2,637,639,0.003129890453834116,0.9968701095461658
6179,9,3,3,25,28,0.10714285714285714,0.8928571428571429
5947,9,3,9,51,60,0.15,0.85
5927,9,3,0,455,455,0.0,1.0
5977,9,3,1,305,306,0.0032679738562091504,0.9967320261437909
6198,9,3,0,5,5,0.0,1.0
5957,9,3,0,45,45,0.0,1.0
6057,9,3,1,28,29,0.034482758620689655,0.9655172413793104
6043,9,3,8,0,8,1.0,0.0
6077,9,3,0,4,4,0.0,1.0
6014,9,3,7,7,14,0.5,0.5
6015,9,3,3,0,3,1.0,0.0
5978,9,3,2,1,3,0.6666666666666666,0.3333333333333333
5986,9,3,1,49,50,0.02,0.98
5959,9,3,3,356,359,0.008356545961002786,0.9916434540389972
6051,9,3,12,26,38,0.3157894736842105,0.6842105263157895
6029,9,3,1,2,3,0.3333333333333333,0.6666666666666666
6070,9,3,1,0,1,1.0,0.0
5942,9,3,0,145,145,0.0,1.0
5953,9,3,3,1,4,0.75,0.25
6076,9,3,2,5,7,0.2857142857142857,0.7142857142857143
5940,9,3,3,7,10,0.3,0.7
6109,9,3,5,88,93,0.053763440860215055,0.946236559139785
6187,9,3,1,2,3,0.3333333333333333,0.6666666666666666
6053,9,3,0,17,17,0.0,1.0
6104,9,3,7,2,9,0.7777777777777778,0.2222222222222222
5943,9,3,2,0,2,1.0,0.0
6017,9,3,3,0,3,1.0,0.0
6168,9,3,4,12,16,0.25,0.75
5989,9,3,2,4,6,0.3333333333333333,0.6666666666666666
5963,9,3,6,0,6,1.0,0.0
6194,9,3,0,26,26,0.0,1.0
6167,9,3,9,10,19,0.47368421052631576,0.5263157894736842
6004,9,3,0,64,64,0.0,1.0
6030,9,3,7,0,7,1.0,0.0
6054,9,3,3,3,6,0.5,0.5
6032,9,3,10,2,12,0.8333333333333334,0.16666666666666666
6170,9,3,10,54,64,0.15625,0.84375
6063,9,3,3,0,3,1.0,0.0
5988,9,3,1,0,1,1.0,0.0
6075,9,3,1,2,3,0.3333333333333333,0.6666666666666666
6061,9,3,0,67,67,0.0,1.0
5965,9,3,7,42,49,0.14285714285714285,0.8571428571428571
6040,9,3,5,5,10,0.5,0.5
6059,9,3,0,85,85,0.0,1.0
6106,9,3,2,61,63,0.031746031746031744,0.9682539682539683
6031,9,3,4,10,14,0.2857142857142857,0.7142857142857143
6180,9,3,0,6,6,0.0,1.0
6039,9,3,6,57,63,0.09523809523809523,0.9047619047619048
6189,10,3,0,18,18,0.0,1.0
5936,10,3,3,3,6,0.5,0.5
6087,10,3,1,10,11,0.09090909090909091,0.9090909090909091
5973,10,3,1,847,848,0.0011792452830188679,0.9988207547169812
6085,10,3,5,7,12,0.4166666666666667,0.5833333333333334
6012,10,3,0,62,62,0.0,1.0
5982,10,3,1,5,6,0.16666666666666666,0.8333333333333334
5948,10,3,0,57,57,0.0,1.0
5974,10,3,3,3,6,0.5,0.5
6090,10,3,0,4,4,0.0,1.0
6068,10,3,3,0,3,1.0,0.0
5962,10,3,7,34,41,0.17073170731707318,0.8292682926829268
6033,10,3,0,1,1,0.0,1.0
6038,10,3,2,0,2,1.0,0.0
6042,10,3,5,92,97,0.05154639175257732,0.9484536082474226
5924,10,3,1,2,3,0.3333333333333333,0.6666666666666666
6083,10,3,0,27,27,0.0,1.0
6178,10,3,12,6,18,0.6666666666666666,0.3333333333333333
5958,10,3,3,1,4,0.75,0.25
6086,10,3,0,14,14,0.0,1.0
5945,10,3,1,18,19,0.05263157894736842,0.9473684210526315
5935,10,3,4,1,5,0.8,0.2
6073,10,3,4,11,15,0.26666666666666666,0.7333333333333333
5980,10,3,4,41,45,0.08888888888888889,0.9111111111111111
5993,10,3,5,478,483,0.010351966873706004,0.989648033126294
6037,10,3,3,220,223,0.013452914798206279,0.9865470852017937
5979,10,3,5,0,5,1.0,0.0
5966,10,3,0,73,73,0.0,1.0
5985,10,3,2,1,3,0.6666666666666666,0.3333333333333333
5967,10,3,0,76,76,0.0,1.0
6188,10,3,1,21,22,0.045454545454545456,0.9545454545454546
6041,10,3,0,12,12,0.0,1.0
5972,10,3,7,6,13,0.5384615384615384,0.46153846153846156
6069,10,3,1,3,4,0.25,0.75
5937,10,3,1,0,1,1.0,0.0
6028,10,3,4,27,31,0.12903225806451613,0.8709677419354839
5990,10,3,0,130,130,0.0,1.0
5928,10,3,6,475,481,0.012474012474012475,0.9875259875259875
5992,10,3,2,2,4,0.5,0.5
6058,10,3,6,7,13,0.46153846153846156,0.5384615384615384
6001,10,3,2,27,29,0.06896551724137931,0.9310344827586207
5964,10,3,9,22,31,0.2903225806451613,0.7096774193548387
5950,10,3,2,2,4,0.5,0.5
5991,10,3,3,5,8,0.375,0.625
6177,10,3,7,302,309,0.022653721682847898,0.9773462783171522
5961,10,3,0,321,321,0.0,1.0
6176,10,3,0,93,93,0.0,1.0
5956,10,3,0,31,31,0.0,1.0
5938,10,3,1,638,639,0.001564945226917058,0.9984350547730829
6179,10,3,3,25,28,0.10714285714285714,0.8928571428571429
5947,10,3,9,51,60,0.15,0.85
5927,10,3,1,454,455,0.002197802197802198,0.9978021978021978
5977,10,3,1,305,306,0.0032679738562091504,0.9967320261437909
6198,10,3,0,5,5,0.0,1.0
5957,10,3,0,45,45,0.0,1.0
6057,10,3,2,27,29,0.06896551724137931,0.9310344827586207
6043,10,3,8,0,8,1.0,0.0
6077,10,3,0,4,4,0.0,1.0
6014,10,3,4,10,14,0.2857142857142857,0.7142857142857143
6015,10,3,3,0,3,1.0,0.0
5978,10,3,2,1,3,0.6666666666666666,0.3333333333333333
5986,10,3,2,48,50,0.04,0.96
5959,10,3,2,357,359,0.005571030640668524,0.9944289693593314
6051,10,3,8,30,38,0.21052631578947367,0.7894736842105263
6029,10,3,1,2,3,0.3333333333333333,0.6666666666666666
6070,10,3,1,0,1,1.0,0.0
5942,10,3,0,145,145,0.0,1.0
5953,10,3,4,0,4,1.0,0.0
6076,10,3,1,6,7,0.14285714285714285,0.8571428571428571
5940,10,3,2,8,10,0.2,0.8
6109,10,3,2,91,93,0.021505376344086023,0.978494623655914
6187,10,3,2,1,3,0.6666666666666666,0.3333333333333333
6053,10,3,0,17,17,0.0,1.0
6104,10,3,8,1,9,0.8888888888888888,0.1111111111111111
5943,10,3,1,1,2,0.5,0.5
6017,10,3,3,0,3,1.0,0.0
6168,10,3,3,13,16,0.1875,0.8125
5989,10,3,0,6,6,0.0,1.0
5963,10,3,6,0,6,1.0,0.0
6194,10,3,0,26,26,0.0,1.0
6167,10,3,6,13,19,0.3157894736842105,0.6842105263157895
6004,10,3,0,64,64,0.0,1.0
6030,10,3,5,2,7,0.7142857142857143,0.2857142857142857
6054,10,3,2,4,6,0.3333333333333333,0.6666666666666666
6032,10,3,6,6,12,0.5,0.5
6170,10,3,10,54,64,0.15625,0.84375
6063,10,3,3,0,3,1.0,0.0
5988,10,3,1,0,1,1.0,0.0
6075,10,3,1,2,3,0.3333333333333333,0.6666666666666666
6061,10,3,0,67,67,0.0,1.0
5965,10,3,4,45,49,0.08163265306122448,0.9183673469387755
6040,10,3,7,3,10,0.7,0.3
6059,10,3,0,85,85,0.0,1.0
6106,10,3,0,63,63,0.0,1.0
6031,10,3,4,10,14,0.2857142857142857,0.7142857142857143
6180,10,3,0,6,6,0.0,1.0
6039,10,3,5,58,63,0.07936507936507936,0.9206349206349206
6189,11,3,0,18,18,0.0,1.0
5936,11,3,2,4,6,0.3333333333333333,0.6666666666666666
6087,11,3,3,8,11,0.2727272727272727,0.7272727272727273
5973,11,3,2,846,848,0.0023584905660377358,0.9976415094339622
6085,11,3,5,7,12,0.4166666666666667,0.5833333333333334
6012,11,3,0,62,62,0.0,1.0
5982,11,3,0,6,6,0.0,1.0
5948,11,3,0,57,57,0.0,1.0
5974,11,3,2,4,6,0.3333333333333333,0.6666666666666666
6090,11,3,0,4,4,0.0,1.0
6068,11,3,3,0,3,1.0,0.0
5962,11,3,5,36,41,0.12195121951219512,0.8780487804878049
6033,11,3,0,1,1,0.0,1.0
6038,11,3,2,0,2,1.0,0.0
6042,11,3,3,94,97,0.030927835051546393,0.9690721649484536
5924,11,3,2,1,3,0.6666666666666666,0.3333333333333333
6083,11,3,0,27,27,0.0,1.0
6178,11,3,5,13,18,0.2777777777777778,0.7222222222222222
5958,11,3,3,1,4,0.75,0.25
6086,11,3,0,14,14,0.0,1.0
5945,11,3,5,14,19,0.2631578947368421,0.7368421052631579
5935,11,3,4,1,5,0.8,0.2
6073,11,3,6,9,15,0.4,0.6
5980,11,3,2,43,45,0.044444444444444446,0.9555555555555556
5993,11,3,2,481,483,0.004140786749482402,0.9958592132505176
6037,11,3,0,223,223,0.0,1.0
5979,11,3,5,0,5,1.0,0.0
5966,11,3,0,73,73,0.0,1.0
5985,11,3,2,1,3,0.6666666666666666,0.3333333333333333
5967,11,3,0,76,76,0.0,1.0
6188,11,3,3,19,22,0.13636363636363635,0.8636363636363636
6041,11,3,0,12,12,0.0,1.0
5972,11,3,7,6,13,0.5384615384615384,0.46153846153846156
6069,11,3,1,3,4,0.25,0.75
5937,11,3,1,0,1,1.0,0.0
6028,11,3,6,25,31,0.1935483870967742,0.8064516129032258
5990,11,3,0,130,130,0.0,1.0
5928,11,3,5,476,481,0.010395010395010396,0.9896049896049897
5992,11,3,2,2,4,0.5,0.5
6058,11,3,2,11,13,0.15384615384615385,0.8461538461538461
6001,11,3,2,27,29,0.06896551724137931,0.9310344827586207
5964,11,3,6,25,31,0.1935483870967742,0.8064516129032258
5950,11,3,3,1,4,0.75,0.25
5991,11,3,1,7,8,0.125,0.875
6177,11,3,4,305,309,0.012944983818770227,0.9870550161812298
5961,11,3,0,321,321,0.0,1.0
6176,11,3,0,93,93,0.0,1.0
5956,11,3,0,31,31,0.0,1.0
5938,11,3,3,636,639,0.004694835680751174,0.9953051643192489
6179,11,3,3,25,28,0.10714285714285714,0.8928571428571429
5947,11,3,7,53,60,0.11666666666666667,0.8833333333333333
5927,11,3,1,454,455,0.002197802197802198,0.9978021978021978
5977,11,3,0,306,306,0.0,1.0
6198,11,3,0,5,5,0.0,1.0
5957,11,3,0,45,45,0.0,1.0
6057,11,3,2,27,29,0.06896551724137931,0.9310344827586207
6043,11,3,7,1,8,0.875,0.125
6077,11,3,0,4,4,0.0,1.0
6014,11,3,5,9,14,0.35714285714285715,0.6428571428571429
6015,11,3,3,0,3,1.0,0.0
5978,11,3,1,2,3,0.3333333333333333,0.6666666666666666
5986,11,3,1,49,50,0.02,0.98
5959,11,3,4,355,359,0.011142061281337047,0.9888579387186629
6051,11,3,5,33,38,0.13157894736842105,0.868421052631579
6029,11,3,1,2,3,0.3333333333333333,0.6666666666666666
6070,11,3,1,0,1,1.0,0.0
5942,11,3,0,145,145,0.0,1.0
5953,11,3,4,0,4,1.0,0.0
6076,11,3,1,6,7,0.14285714285714285,0.8571428571428571
5940,11,3,2,8,10,0.2,0.8
6109,11,3,2,91,93,0.021505376344086023,0.978494623655914
6187,11,3,2,1,3,0.6666666666666666,0.3333333333333333
6053,11,3,0,17,17,0.0,1.0
6104,11,3,5,4,9,0.5555555555555556,0.4444444444444444
5943,11,3,1,1,2,0.5,0.5
6017,11,3,2,1,3,0.6666666666666666,0.3333333333333333
6168,11,3,4,12,16,0.25,0.75
5989,11,3,1,5,6,0.16666666666666666,0.8333333333333334
5963,11,3,5,1,6,0.8333333333333334,0.16666666666666666
6194,11,3,0,26,26,0.0,1.0
6167,11,3,2,17,19,0.10526315789473684,0.8947368421052632
6004,11,3,0,64,64,0.0,1.0
6030,11,3,7,0,7,1.0,0.0
6054,11,3,3,3,6,0.5,0.5
6032,11,3,6,6,12,0.5,0.5
6170,11,3,5,59,64,0.078125,0.921875
6063,11,3,3,0,3,1.0,0.0
5988,11,3,1,0,1,1.0,0.0
6075,11,3,1,2,3,0.3333333333333333,0.6666666666666666
6061,11,3,0,67,67,0.0,1.0
5965,11,3,3,46,49,0.061224489795918366,0.9387755102040817
6040,11,3,5,5,10,0.5,0.5
6059,11,3,0,85,85,0.0,1.0
6106,11,3,1,62,63,0.015873015873015872,0.9841269841269841
6031,11,3,3,11,14,0.21428571428571427,0.7857142857142857
6180,11,3,0,6,6,0.0,1.0
6039,11,3,4,59,63,0.06349206349206349,0.9365079365079365
6189,12,3,0,18,18,0.0,1.0
5936,12,3,3,3,6,0.5,0.5
6087,12,3,1,10,11,0.09090909090909091,0.9090909090909091
5973,12,3,3,845,848,0.003537735849056604,0.9964622641509434
6085,12,3,6,6,12,0.5,0.5
6012,12,3,0,62,62,0.0,1.0
5982,12,3,1,5,6,0.16666666666666666,0.8333333333333334
5948,12,3,0,57,57,0.0,1.0
5974,12,3,3,3,6,0.5,0.5
6090,12,3,0,4,4,0.0,1.0
6068,12,3,3,0,3,1.0,0.0
5962,12,3,1,40,41,0.024390243902439025,0.975609756097561
6033,12,3,0,1,1,0.0,1.0
6038,12,3,2,0,2,1.0,0.0
6042,12,3,5,92,97,0.05154639175257732,0.9484536082474226
5924,12,3,1,2,3,0.3333333333333333,0.6666666666666666
6083,12,3,0,27,27,0.0,1.0
6178,12,3,7,11,18,0.3888888888888889,0.6111111111111112
5958,12,3,2,2,4,0.5,0.5
6086,12,3,0,14,14,0.0,1.0
5945,12,3,3,16,19,0.15789473684210525,0.8421052631578947
5935,12,3,4,1,5,0.8,0.2
6073,12,3,3,12,15,0.2,0.8
5980,12,3,8,37,45,0.17777777777777778,0.8222222222222222
5993,12,3,6,477,483,0.012422360248447204,0.9875776397515528
6037,12,3,0,223,223,0.0,1.0
5979,12,3,4,1,5,0.8,0.2
5966,12,3,0,73,73,0.0,1.0
5985,12,3,1,2,3,0.3333333333333333,0.6666666666666666
5967,12,3,0,76,76,0.0,1.0
6188,12,3,2,20,22,0.09090909090909091,0.9090909090909091
6041,12,3,0,12,12,0.0,1.0
5972,12,3,6,7,13,0.46153846153846156,0.5384615384615384
6069,12,3,2,2,4,0.5,0.5
5937,12,3,1,0,1,1.0,0.0
6028,12,3,7,24,31,0.22580645161290322,0.7741935483870968
5990,12,3,0,130,130,0.0,1.0
5928,12,3,2,479,481,0.004158004158004158,0.9958419958419958
5992,12,3,2,2,4,0.5,0.5
6058,12,3,4,9,13,0.3076923076923077,0.6923076923076923
6001,12,3,1,28,29,0.034482758620689655,0.9655172413793104
5964,12,3,4,27,31,0.12903225806451613,0.8709677419354839
5950,12,3,1,3,4,0.25,0.75
5991,12,3,2,6,8,0.25,0.75
6177,12,3,9,300,309,0.02912621359223301,0.970873786407767
5961,12,3,0,321,321,0.0,1.0
6176,12,3,0,93,93,0.0,1.0
5956,12,3,0,31,31,0.0,1.0
5938,12,3,2,637,639,0.003129890453834116,0.9968701095461658
6179,12,3,4,24,28,0.14285714285714285,0.8571428571428571
5947,12,3,5,55,60,0.08333333333333333,0.9166666666666666
5927,12,3,0,455,455,0.0,1.0
5977,12,3,0,306,306,0.0,1.0
6198,12,3,0,5,5,0.0,1.0
5957,12,3,0,45,45,0.0,1.0
6057,12,3,3,26,29,0.10344827586206896,0.896551724137931
6043,12,3,8,0,8,1.0,0.0
6077,12,3,0,4,4,0.0,1.0
6014,12,3,4,10,14,0.2857142857142857,0.7142857142857143
6015,12,3,1,2,3,0.3333333333333333,0.6666666666666666
5978,12,3,1,2,3,0.3333333333333333,0.6666666666666666
5986,12,3,2,48,50,0.04,0.96
5959,12,3,4,355,359,0.011142061281337047,0.9888579387186629
6051,12,3,3,35,38,0.07894736842105263,0.9210526315789473
6029,12,3,2,1,3,0.6666666666666666,0.3333333333333333
6070,12,3,1,0,1,1.0,0.0
5942,12,3,0,145,145,0.0,1.0
5953,12,3,4,0,4,1.0,0.0
6076,12,3,1,6,7,0.14285714285714285,0.8571428571428571
5940,12,3,2,8,10,0.2,0.8
6109,12,3,6,87,93,0.06451612903225806,0.9354838709677419
6187,12,3,1,2,3,0.3333333333333333,0.6666666666666666
6053,12,3,0,17,17,0.0,1.0
6104,12,3,6,3,9,0.6666666666666666,0.3333333333333333
5943,12,3,1,1,2,0.5,0.5
6017,12,3,2,1,3,0.6666666666666666,0.3333333333333333
6168,12,3,7,9,16,0.4375,0.5625
5989,12,3,0,6,6,0.0,1.0
5963,12,3,6,0,6,1.0,0.0
6194,12,3,0,26,26,0.0,1.0
6167,12,3,4,15,19,0.21052631578947367,0.7894736842105263
6004,12,3,1,63,64,0.015625,0.984375
6030,12,3,5,2,7,0.7142857142857143,0.2857142857142857
6054,12,3,1,5,6,0.16666666666666666,0.8333333333333334
6032,12,3,5,7,12,0.4166666666666667,0.5833333333333334
6170,12,3,7,57,64,0.109375,0.890625
6063,12,3,3,0,3,1.0,0.0
5988,12,3,1,0,1,1.0,0.0
6075,12,3,0,3,3,0.0,1.0
6061,12,3,0,67,67,0.0,1.0
5965,12,3,6,43,49,0.12244897959183673,0.8775510204081632
6040,12,3,4,6,10,0.4,0.6
6059,12,3,0,85,85,0.0,1.0
6106,12,3,2,61,63,0.031746031746031744,0.9682539682539683
6031,12,3,5,9,14,0.35714285714285715,0.6428571428571429
6180,12,3,0,6,6,0.0,1.0
6039,12,3,5,58,63,0.07936507936507936,0.9206349206349206
6189,13,3,0,18,18,0.0,1.0
5936,13,3,3,3,6,0.5,0.5
6087,13,3,3,8,11,0.2727272727272727,0.7272727272727273
5973,13,3,1,847,848,0.0011792452830188679,0.9988207547169812
6085,13,3,3,9,12,0.25,0.75
6012,13,3,0,62,62,0.0,1.0
5982,13,3,1,5,6,0.16666666666666666,0.8333333333333334
5948,13,3,0,57,57,0.0,1.0
5974,13,3,2,4,6,0.3333333333333333,0.6666666666666666
6090,13,3,0,4,4,0.0,1.0
6068,13,3,3,0,3,1.0,0.0
5962,13,3,2,39,41,0.04878048780487805,0.9512195121951219
6033,13,3,0,1,1,0.0,1.0
6038,13,3,2,0,2,1.0,0.0
6042,13,3,4,93,97,0.041237113402061855,0.9587628865979382
5924,13,3,0,3,3,0.0,1.0
6083,13,3,0,27,27,0.0,1.0
6178,13,3,5,13,18,0.2777777777777778,0.7222222222222222
5958,13,3,2,2,4,0.5,0.5
6086,13,3,0,14,14,0.0,1.0
5945,13,3,1,18,19,0.05263157894736842,0.9473684210526315
5935,13,3,2,3,5,0.4,0.6
6073,13,3,7,8,15,0.4666666666666667,0.5333333333333333
5980,13,3,4,41,45,0.08888888888888889,0.9111111111111111
5993,13,3,2,481,483,0.004140786749482402,0.9958592132505176
6037,13,3,2,221,223,0.008968609865470852,0.9910313901345291
5979,13,3,3,2,5,0.6,0.4
5966,13,3,0,73,73,0.0,1.0
5985,13,3,1,2,3,0.3333333333333333,0.6666666666666666
5967,13,3,0,76,76,0.0,1.0
6188,13,3,1,21,22,0.045454545454545456,0.9545454545454546
6041,13,3,0,12,12,0.0,1.0
5972,13,3,6,7,13,0.46153846153846156,0.5384615384615384
6069,13,3,0,4,4,0.0,1.0
5937,13,3,1,0,1,1.0,0.0
6028,13,3,5,26,31,0.16129032258064516,0.8387096774193549
5990,13,3,0,130,130,0.0,1.0
5928,13,3,6,475,481,0.012474012474012475,0.9875259875259875
5992,13,3,3,1,4,0.75,0.25
6058,13,3,3,10,13,0.23076923076923078,0.7692307692307693
6001,13,3,1,28,29,0.034482758620689655,0.9655172413793104
5964,13,3,5,26,31,0.16129032258064516,0.8387096774193549
5950,13,3,4,0,4,1.0,0.0
5991,13,3,1,7,8,0.125,0.875
6177,13,3,1,308,309,0.003236245954692557,0.9967637540453075
5961,13,3,0,321,321,0.0,1.0
6176,13,3,0,93,93,0.0,1.0
5956,13,3,0,31,31,0.0,1.0
5938,13,3,3,636,639,0.004694835680751174,0.9953051643192489
6179,13,3,2,26,28,0.07142857142857142,0.9285714285714286
5947,13,3,7,53,60,0.11666666666666667,0.8833333333333333
5927,13,3,2,453,455,0.004395604395604396,0.9956043956043956
5977,13,3,0,306,306,0.0,1.0
6198,13,3,0,5,5,0.0,1.0
5957,13,3,0,45,45,0.0,1.0
6057,13,3,0,29,29,0.0,1.0
6043,13,3,8,0,8,1.0,0.0
6077,13,3,0,4,4,0.0,1.0
6014,13,3,4,10,14,0.2857142857142857,0.7142857142857143
6015,13,3,2,1,3,0.6666666666666666,0.3333333333333333
5978,13,3,2,1,3,0.6666666666666666,0.3333333333333333
5986,13,3,4,46,50,0.08,0.92
5959,13,3,6,353,359,0.016713091922005572,0.9832869080779945
6051,13,3,2,36,38,0.05263157894736842,0.9473684210526315
6029,13,3,2,1,3,0.6666666666666666,0.3333333333333333
6070,13,3,1,0,1,1.0,0.0
5942,13,3,0,145,145,0.0,1.0
5953,13,3,3,1,4,0.75,0.25
6076,13,3,1,6,7,0.14285714285714285,0.8571428571428571
5940,13,3,2,8,10,0.2,0.8
6109,13,3,6,87,93,0.06451612903225806,0.9354838709677419
6187,13,3,1,2,3,0.3333333333333333,0.6666666666666666
6053,13,3,0,17,17,0.0,1.0
6104,13,3,4,5,9,0.4444444444444444,0.5555555555555556
5943,13,3,1,1,2,0.5,0.5
6017,13,3,2,1,3,0.6666666666666666,0.3333333333333333
6168,13,3,4,12,16,0.25,0.75
5989,13,3,0,6,6,0.0,1.0
5963,13,3,5,1,6,0.8333333333333334,0.16666666666666666
6194,13,3,0,26,26,0.0,1.0
6167,13,3,3,16,19,0.15789473684210525,0.8421052631578947
6004,13,3,1,63,64,0.015625,0.984375
6030,13,3,5,2,7,0.7142857142857143,0.2857142857142857
6054,13,3,2,4,6,0.3333333333333333,0.6666666666666666
6032,13,3,5,7,12,0.4166666666666667,0.5833333333333334
6170,13,3,8,56,64,0.125,0.875
6063,13,3,3,0,3,1.0,0.0
5988,13,3,1,0,1,1.0,0.0
6075,13,3,0,3,3,0.0,1.0
6061,13,3,0,67,67,0.0,1.0
5965,13,3,2,47,49,0.04081632653061224,0.9591836734693877
6040,13,3,5,5,10,0.5,0.5
6059,13,3,0,85,85,0.0,1.0
6106,13,3,3,60,63,0.047619047619047616,0.9523809523809523
6031,13,3,5,9,14,0.35714285714285715,0.6428571428571429
6180,13,3,0,6,6,0.0,1.0
6039,13,3,2,61,63,0.031746031746031744,0.9682539682539683
6189,14,3,0,18,18,0.0,1.0
5936,14,3,3,3,6,0.5,0.5
6087,14,3,2,9,11,0.18181818181818182,0.8181818181818182
5973,14,3,0,848,848,0.0,1.0
6085,14,3,2,10,12,0.16666666666666666,0.8333333333333334
6012,14,3,0,62,62,0.0,1.0
5982,14,3,1,5,6,0.16666666666666666,0.8333333333333334
5948,14,3,0,57,57,0.0,1.0
5974,14,3,1,5,6,0.16666666666666666,0.8333333333333334
6090,14,3,0,4,4,0.0,1.0
6068,14,3,3,0,3,1.0,0.0
5962,14,3,1,40,41,0.024390243902439025,0.975609756097561
6033,14,3,0,1,1,0.0,1.0
6038,14,3,1,1,2,0.5,0.5
6042,14,3,2,95,97,0.020618556701030927,0.979381443298969
5924,14,3,1,2,3,0.3333333333333333,0.6666666666666666
6083,14,3,0,27,27,0.0,1.0
6178,14,3,8,10,18,0.4444444444444444,0.5555555555555556
5958,14,3,3,1,4,0.75,0.25
6086,14,3,0,14,14,0.0,1.0
5945,14,3,1,18,19,0.05263157894736842,0.9473684210526315
5935,14,3,2,3,5,0.4,0.6
6073,14,3,1,14,15,0.06666666666666667,0.9333333333333333
5980,14,3,0,45,45,0.0,1.0
5993,14,3,7,476,483,0.014492753623188406,0.9855072463768116
6037,14,3,1,222,223,0.004484304932735426,0.9955156950672646
5979,14,3,2,3,5,0.4,0.6
5966,14,3,0,73,73,0.0,1.0
5985,14,3,0,3,3,0.0,1.0
5967,14,3,0,76,76,0.0,1.0
6188,14,3,4,18,22,0.18181818181818182,0.8181818181818182
6041,14,3,0,12,12,0.0,1.0
5972,14,3,5,8,13,0.38461538461538464,0.6153846153846154
6069,14,3,2,2,4,0.5,0.5
5937,14,3,1,0,1,1.0,0.0
6028,14,3,1,30,31,0.03225806451612903,0.967741935483871
5990,14,3,0,130,130,0.0,1.0
5928,14,3,3,478,481,0.006237006237006237,0.9937629937629938
5992,14,3,3,1,4,0.75,0.25
6058,14,3,3,10,13,0.23076923076923078,0.7692307692307693
6001,14,3,1,28,29,0.034482758620689655,0.9655172413793104
5964,14,3,12,19,31,0.3870967741935484,0.6129032258064516
5950,14,3,2,2,4,0.5,0.5
5991,14,3,1,7,8,0.125,0.875
6177,14,3,2,307,309,0.006472491909385114,0.9935275080906149
5961,14,3,0,321,321,0.0,1.0
6176,14,3,0,93,93,0.0,1.0
5956,14,3,0,31,31,0.0,1.0
5938,14,3,1,638,639,0.001564945226917058,0.9984350547730829
6179,14,3,2,26,28,0.07142857142857142,0.9285714285714286
5947,14,3,8,52,60,0.13333333333333333,0.8666666666666667
5927,14,3,0,455,455,0.0,1.0
5977,14,3,0,306,306,0.0,1.0
6198,14,3,0,5,5,0.0,1.0
5957,14,3,0,45,45,0.0,1.0
6057,14,3,0,29,29,0.0,1.0
6043,14,3,8,0,8,1.0,0.0
6077,14,3,0,4,4,0.0,1.0
6014,14,3,6,8,14,0.42857142857142855,0.5714285714285714
6015,14,3,0,3,3,0.0,1.0
5978,14,3,2,1,3,0.6666666666666666,0.3333333333333333
5986,14,3,1,49,50,0.02,0.98
5959,14,3,2,357,359,0.005571030640668524,0.9944289693593314
6051,14,3,4,34,38,0.10526315789473684,0.8947368421052632
6029,14,3,1,2,3,0.3333333333333333,0.6666666666666666
6070,14,3,1,0,1,1.0,0.0
5942,14,3,0,145,145,0.0,1.0
5953,14,3,2,2,4,0.5,0.5
6076,14,3,0,7,7,0.0,1.0
5940,14,3,2,8,10,0.2,0.8
6109,14,3,2,91,93,0.021505376344086023,0.978494623655914
6187,14,3,0,3,3,0.0,1.0
6053,14,3,0,17,17,0.0,1.0
6104,14,3,5,4,9,0.5555555555555556,0.4444444444444444
5943,14,3,1,1,2,0.5,0.5
6017,14,3,2,1,3,0.6666666666666666,0.3333333333333333
6168,14,3,3,13,16,0.1875,0.8125
5989,14,3,2,4,6,0.3333333333333333,0.6666666666666666
5963,14,3,6,0,6,1.0,0.0
6194,14,3,0,26,26,0.0,1.0
6167,14,3,3,16,19,0.15789473684210525,0.8421052631578947
6004,14,3,0,64,64,0.0,1.0
6030,14,3,6,1,7,0.8571428571428571,0.14285714285714285
6054,14,3,2,4,6,0.3333333333333333,0.6666666666666666
6032,14,3,3,9,12,0.25,0.75
6170,14,3,5,59,64,0.078125,0.921875
6063,14,3,3,0,3,1.0,0.0
5988,14,3,1,0,1,1.0,0.0
6075,14,3,3,0,3,1.0,0.0
6061,14,3,0,67,67,0.0,1.0
5965,14,3,1,48,49,0.02040816326530612,0.9795918367346939
6040,14,3,2,8,10,0.2,0.8
6059,14,3,0,85,85,0.0,1.0
6106,14,3,0,63,63,0.0,1.0
6031,14,3,2,12,14,0.14285714285714285,0.8571428571428571
6180,14,3,0,6,6,0.0,1.0
6039,14,3,2,61,63,0.031746031746031744,0.9682539682539683
6189,15,3,0,18,18,0.0,1.0
5936,15,3,1,5,6,0.16666666666666666,0.8333333333333334
6087,15,3,1,10,11,0.09090909090909091,0.9090909090909091
5973,15,3,0,848,848,0.0,1.0
6085,15,3,2,10,12,0.16666666666666666,0.8333333333333334
6012,15,3,0,62,62,0.0,1.0
5982,15,3,0,6,6,0.0,1.0
5948,15,3,0,57,57,0.0,1.0
5974,15,3,2,4,6,0.3333333333333333,0.6666666666666666
6090,15,3,0,4,4,0.0,1.0
6068,15,3,3,0,3,1.0,0.0
5962,15,3,1,40,41,0.024390243902439025,0.975609756097561
6033,15,3,0,1,1,0.0,1.0
6038,15,3,1,1,2,0.5,0.5
6042,15,3,1,96,97,0.010309278350515464,0.9896907216494846
5924,15,3,0,3,3,0.0,1.0
6083,15,3,0,27,27,0.0,1.0
6178,15,3,5,13,18,0.2777777777777778,0.7222222222222222
5958,15,3,2,2,4,0.5,0.5
6086,15,3,0,14,14,0.0,1.0
5945,15,3,0,19,19,0.0,1.0
5935,15,3,2,3,5,0.4,0.6
6073,15,3,7,8,15,0.4666666666666667,0.5333333333333333
5980,15,3,2,43,45,0.044444444444444446,0.9555555555555556
5993,15,3,1,482,483,0.002070393374741201,0.9979296066252588
6037,15,3,0,223,223,0.0,1.0
5979,15,3,3,2,5,0.6,0.4
5966,15,3,0,73,73,0.0,1.0
5985,15,3,1,2,3,0.3333333333333333,0.6666666666666666
5967,15,3,0,76,76,0.0,1.0
6188,15,3,1,21,22,0.045454545454545456,0.9545454545454546
6041,15,3,0,12,12,0.0,1.0
5972,15,3,7,6,13,0.5384615384615384,0.46153846153846156
6069,15,3,1,3,4,0.25,0.75
5937,15,3,1,0,1,1.0,0.0
6028,15,3,6,25,31,0.1935483870967742,0.8064516129032258
5990,15,3,0,130,130,0.0,1.0
5928,15,3,3,478,481,0.006237006237006237,0.9937629937629938
5992,15,3,2,2,4,0.5,0.5
6058,15,3,4,9,13,0.3076923076923077,0.6923076923076923
6001,15,3,1,28,29,0.034482758620689655,0.9655172413793104
5964,15,3,3,28,31,0.0967741935483871,0.9032258064516129
5950,15,3,0,4,4,0.0,1.0
5991,15,3,2,6,8,0.25,0.75
6177,15,3,0,309,309,0.0,1.0
5961,15,3,0,321,321,0.0,1.0
6176,15,3,0,93,93,0.0,1.0
5956,15,3,0,31,31,0.0,1.0
5938,15,3,0,639,639,0.0,1.0
6179,15,3,2,26,28,0.07142857142857142,0.9285714285714286
5947,15,3,4,56,60,0.06666666666666667,0.9333333333333333
5927,15,3,0,455,455,0.0,1.0
5977,15,3,0,306,306,0.0,1.0
6198,15,3,0,5,5,0.0,1.0
5957,15,3,0,45,45,0.0,1.0
6057,15,3,4,25,29,0.13793103448275862,0.8620689655172413
6043,15,3,5,3,8,0.625,0.375
6077,15,3,0,4,4,0.0,1.0
6014,15,3,6,8,14,0.42857142857142855,0.5714285714285714
6015,15,3,2,1,3,0.6666666666666666,0.3333333333333333
5978,15,3,1,2,3,0.3333333333333333,0.6666666666666666
5986,15,3,1,49,50,0.02,0.98
5959,15,3,6,353,359,0.016713091922005572,0.9832869080779945
6051,15,3,1,37,38,0.02631578947368421,0.9736842105263158
6029,15,3,1,2,3,0.3333333333333333,0.6666666666666666
6070,15,3,0,1,1,0.0,1.0
5942,15,3,0,145,145,0.0,1.0
5953,15,3,2,2,4,0.5,0.5
6076,15,3,3,4,7,0.42857142857142855,0.5714285714285714
5940,15,3,2,8,10,0.2,0.8
6109,15,3,1,92,93,0.010752688172043012,0.989247311827957
6187,15,3,1,2,3,0.3333333333333333,0.6666666666666666
6053,15,3,0,17,17,0.0,1.0
6104,15,3,3,6,9,0.3333333333333333,0.6666666666666666
5943,15,3,1,1,2,0.5,0.5
6017,15,3,2,1,3,0.6666666666666666,0.3333333333333333
6168,15,3,7,9,16,0.4375,0.5625
5989,15,3,0,6,6,0.0,1.0
5963,15,3,5,1,6,0.8333333333333334,0.16666666666666666
6194,15,3,0,26,26,0.0,1.0
6167,15,3,4,15,19,0.21052631578947367,0.7894736842105263
6004,15,3,1,63,64,0.015625,0.984375
6030,15,3,6,1,7,0.8571428571428571,0.14285714285714285
6054,15,3,2,4,6,0.3333333333333333,0.6666666666666666
6032,15,3,6,6,12,0.5,0.5
6170,15,3,3,61,64,0.046875,0.953125
6063,15,3,3,0,3,1.0,0.0
5988,15,3,1,0,1,1.0,0.0
6075,15,3,0,3,3,0.0,1.0
6061,15,3,0,67,67,0.0,1.0
5965,15,3,5,44,49,0.10204081632653061,0.8979591836734694
6040,15,3,5,5,10,0.5,0.5
6059,15,3,0,85,85,0.0,1.0
6106,15,3,1,62,63,0.015873015873015872,0.9841269841269841
6031,15,3,5,9,14,0.35714285714285715,0.6428571428571429
6180,15,3,0,6,6,0.0,1.0
6039,15,3,3,60,63,0.047619047619047616,0.9523809523809523
6189,16,3,0,18,18,0.0,1.0
5936,16,3,3,3,6,0.5,0.5
6087,16,3,2,9,11,0.18181818181818182,0.8181818181818182
5973,16,3,0,848,848,0.0,1.0
6085,16,3,2,10,12,0.16666666666666666,0.8333333333333334
6012,16,3,0,62,62,0.0,1.0
5982,16,3,1,5,6,0.16666666666666666,0.8333333333333334
5948,16,3,0,57,57,0.0,1.0
5974,16,3,4,2,6,0.6666666666666666,0.3333333333333333
6090,16,3,0,4,4,0.0,1.0
6068,16,3,2,1,3,0.6666666666666666,0.3333333333333333
5962,16,3,5,36,41,0.12195121951219512,0.8780487804878049
6033,16,3,0,1,1,0.0,1.0
6038,16,3,1,1,2,0.5,0.5
6042,16,3,3,94,97,0.030927835051546393,0.9690721649484536
5924,16,3,1,2,3,0.3333333333333333,0.6666666666666666
6083,16,3,0,27,27,0.0,1.0
6178,16,3,5,13,18,0.2777777777777778,0.7222222222222222
5958,16,3,2,2,4,0.5,0.5
6086,16,3,0,14,14,0.0,1.0
5945,16,3,2,17,19,0.10526315789473684,0.8947368421052632
5935,16,3,2,3,5,0.4,0.6
6073,16,3,4,11,15,0.26666666666666666,0.7333333333333333
5980,16,3,2,43,45,0.044444444444444446,0.9555555555555556
5993,16,3,1,482,483,0.002070393374741201,0.9979296066252588
6037,16,3,1,222,223,0.004484304932735426,0.9955156950672646
5979,16,3,3,2,5,0.6,0.4
5966,16,3,0,73,73,0.0,1.0
5985,16,3,0,3,3,0.0,1.0
5967,16,3,0,76,76,0.0,1.0
6188,16,3,3,19,22,0.13636363636363635,0.8636363636363636
6041,16,3,0,12,12,0.0,1.0
5972,16,3,4,9,13,0.3076923076923077,0.6923076923076923
6069,16,3,0,4,4,0.0,1.0
5937,16,3,1,0,1,1.0,0.0
6028,16,3,4,27,31,0.12903225806451613,0.8709677419354839
5990,16,3,0,130,130,0.0,1.0
5928,16,3,2,479,481,0.004158004158004158,0.9958419958419958
5992,16,3,2,2,4,0.5,0.5
6058,16,3,2,11,13,0.15384615384615385,0.8461538461538461
6001,16,3,1,28,29,0.034482758620689655,0.9655172413793104
5964,16,3,6,25,31,0.1935483870967742,0.8064516129032258
5950,16,3,1,3,4,0.25,0.75
5991,16,3,2,6,8,0.25,0.75
6177,16,3,2,307,309,0.006472491909385114,0.9935275080906149
5961,16,3,0,321,321,0.0,1.0
6176,16,3,0,93,93,0.0,1.0
5956,16,3,0,31,31,0.0,1.0
5938,16,3,1,638,639,0.001564945226917058,0.9984350547730829
6179,16,3,2,26,28,0.07142857142857142,0.9285714285714286
5947,16,3,5,55,60,0.08333333333333333,0.9166666666666666
5927,16,3,1,454,455,0.002197802197802198,0.9978021978021978
5977,16,3,0,306,306,0.0,1.0
6198,16,3,0,5,5,0.0,1.0
5957,16,3,0,45,45,0.0,1.0
6057,16,3,4,25,29,0.13793103448275862,0.8620689655172413
6043,16,3,5,3,8,0.625,0.375
6077,16,3,0,4,4,0.0,1.0
6014,16,3,3,11,14,0.21428571428571427,0.7857142857142857
6015,16,3,3,0,3,1.0,0.0
5978,16,3,1,2,3,0.3333333333333333,0.6666666666666666
5986,16,3,1,49,50,0.02,0.98
5959,16,3,1,358,359,0.002785515320334262,0.9972144846796658
6051,16,3,1,37,38,0.02631578947368421,0.9736842105263158
6029,16,3,1,2,3,0.3333333333333333,0.6666666666666666
6070,16,3,0,1,1,0.0,1.0
5942,16,3,0,145,145,0.0,1.0
5953,16,3,1,3,4,0.25,0.75
6076,16,3,3,4,7,0.42857142857142855,0.5714285714285714
5940,16,3,3,7,10,0.3,0.7
6109,16,3,2,91,93,0.021505376344086023,0.978494623655914
6187,16,3,1,2,3,0.3333333333333333,0.6666666666666666
6053,16,3,0,17,17,0.0,1.0
6104,16,3,1,8,9,0.1111111111111111,0.8888888888888888
5943,16,3,1,1,2,0.5,0.5
6017,16,3,3,0,3,1.0,0.0
6168,16,3,4,12,16,0.25,0.75
5989,16,3,0,6,6,0.0,1.0
5963,16,3,6,0,6,1.0,0.0
6194,16,3,0,26,26,0.0,1.0
6167,16,3,3,16,19,0.15789473684210525,0.8421052631578947
6004,16,3,0,64,64,0.0,1.0
6030,16,3,5,2,7,0.7142857142857143,0.2857142857142857
6054,16,3,1,5,6,0.16666666666666666,0.8333333333333334
6032,16,3,1,11,12,0.08333333333333333,0.9166666666666666
6170,16,3,4,60,64,0.0625,0.9375
6063,16,3,3,0,3,1.0,0.0
5988,16,3,1,0,1,1.0,0.0
6075,16,3,0,3,3,0.0,1.0
6061,16,3,0,67,67,0.0,1.0
5965,16,3,1,48,49,0.02040816326530612,0.9795918367346939
6040,16,3,0,10,10,0.0,1.0
6059,16,3,0,85,85,0.0,1.0
6106,16,3,0,63,63,0.0,1.0
6031,16,3,3,11,14,0.21428571428571427,0.7857142857142857
6180,16,3,0,6,6,0.0,1.0
6039,16,3,2,61,63,0.031746031746031744,0.9682539682539683
6189,17,3,0,18,18,0.0,1.0
5936,17,3,2,4,6,0.3333333333333333,0.6666666666666666
6087,17,3,2,9,11,0.18181818181818182,0.8181818181818182
5973,17,3,0,848,848,0.0,1.0
6085,17,3,1,11,12,0.08333333333333333,0.9166666666666666
6012,17,3,0,62,62,0.0,1.0
5982,17,3,1,5,6,0.16666666666666666,0.8333333333333334
5948,17,3,0,57,57,0.0,1.0
5974,17,3,3,3,6,0.5,0.5
6090,17,3,0,4,4,0.0,1.0
6068,17,3,3,0,3,1.0,0.0
5962,17,3,1,40,41,0.024390243902439025,0.975609756097561
6033,17,3,0,1,1,0.0,1.0
6038,17,3,1,1,2,0.5,0.5
6042,17,3,2,95,97,0.020618556701030927,0.979381443298969
5924,17,3,0,3,3,0.0,1.0
6083,17,3,0,27,27,0.0,1.0
6178,17,3,6,12,18,0.3333333333333333,0.6666666666666666
5958,17,3,3,1,4,0.75,0.25
6086,17,3,0,14,14,0.0,1.0
5945,17,3,1,18,19,0.05263157894736842,0.9473684210526315
5935,17,3,2,3,5,0.4,0.6
6073,17,3,0,15,15,0.0,1.0
5980,17,3,0,45,45,0.0,1.0
5993,17,3,1,482,483,0.002070393374741201,0.9979296066252588
6037,17,3,1,222,223,0.004484304932735426,0.9955156950672646
5979,17,3,1,4,5,0.2,0.8
5966,17,3,0,73,73,0.0,1.0
5985,17,3,0,3,3,0.0,1.0
5967,17,3,0,76,76,0.0,1.0
6188,17,3,1,21,22,0.045454545454545456,0.9545454545454546
6041,17,3,0,12,12,0.0,1.0
5972,17,3,7,6,13,0.5384615384615384,0.46153846153846156
6069,17,3,1,3,4,0.25,0.75
5937,17,3,1,0,1,1.0,0.0
6028,17,3,5,26,31,0.16129032258064516,0.8387096774193549
5990,17,3,0,130,130,0.0,1.0
5928,17,3,3,478,481,0.006237006237006237,0.9937629937629938
5992,17,3,3,1,4,0.75,0.25
6058,17,3,4,9,13,0.3076923076923077,0.6923076923076923
6001,17,3,3,26,29,0.10344827586206896,0.896551724137931
5964,17,3,5,26,31,0.16129032258064516,0.8387096774193549
5950,17,3,3,1,4,0.75,0.25
5991,17,3,1,7,8,0.125,0.875
6177,17,3,0,309,309,0.0,1.0
5961,17,3,0,321,321,0.0,1.0
6176,17,3,0,93,93,0.0,1.0
5956,17,3,0,31,31,0.0,1.0
5938,17,3,2,637,639,0.003129890453834116,0.9968701095461658
6179,17,3,2,26,28,0.07142857142857142,0.9285714285714286
5947,17,3,6,54,60,0.1,0.9
5927,17,3,0,455,455,0.0,1.0
5977,17,3,0,306,306,0.0,1.0
6198,17,3,0,5,5,0.0,1.0
5957,17,3,0,45,45,0.0,1.0
6057,17,3,0,29,29,0.0,1.0
6043,17,3,4,4,8,0.5,0.5
6077,17,3,0,4,4,0.0,1.0
6014,17,3,3,11,14,0.21428571428571427,0.7857142857142857
6015,17,3,1,2,3,0.3333333333333333,0.6666666666666666
5978,17,3,1,2,3,0.3333333333333333,0.6666666666666666
5986,17,3,0,50,50,0.0,1.0
5959,17,3,4,355,359,0.011142061281337047,0.9888579387186629
6051,17,3,0,38,38,0.0,1.0
6029,17,3,1,2,3,0.3333333333333333,0.6666666666666666
6070,17,3,0,1,1,0.0,1.0
5942,17,3,0,145,145,0.0,1.0
5953,17,3,2,2,4,0.5,0.5
6076,17,3,1,6,7,0.14285714285714285,0.8571428571428571
5940,17,3,1,9,10,0.1,0.9
6109,17,3,3,90,93,0.03225806451612903,0.967741935483871
6187,17,3,0,3,3,0.0,1.0
6053,17,3,0,17,17,0.0,1.0
6104,17,3,3,6,9,0.3333333333333333,0.6666666666666666
5943,17,3,0,2,2,0.0,1.0
6017,17,3,2,1,3,0.6666666666666666,0.3333333333333333
6168,17,3,5,11,16,0.3125,0.6875
5989,17,3,2,4,6,0.3333333333333333,0.6666666666666666
5963,17,3,5,1,6,0.8333333333333334,0.16666666666666666
6194,17,3,0,26,26,0.0,1.0
6167,17,3,1,18,19,0.05263157894736842,0.9473684210526315
6004,17,3,0,64,64,0.0,1.0
6030,17,3,4,3,7,0.5714285714285714,0.42857142857142855
6054,17,3,3,3,6,0.5,0.5
6032,17,3,4,8,12,0.3333333333333333,0.6666666666666666
6170,17,3,2,62,64,0.03125,0.96875
6063,17,3,3,0,3,1.0,0.0
5988,17,3,1,0,1,1.0,0.0
6075,17,3,0,3,3,0.0,1.0
6061,17,3,0,67,67,0.0,1.0
5965,17,3,4,45,49,0.08163265306122448,0.9183673469387755
6040,17,3,2,8,10,0.2,0.8
6059,17,3,0,85,85,0.0,1.0
6106,17,3,2,61,63,0.031746031746031744,0.9682539682539683
6031,17,3,3,11,14,0.21428571428571427,0.7857142857142857
6180,17,3,0,6,6,0.0,1.0
6039,17,3,4,59,63,0.06349206349206349,0.9365079365079365
6189,18,3,0,18,18,0.0,1.0
5936,18,3,2,4,6,0.3333333333333333,0.6666666666666666
6087,18,3,2,9,11,0.18181818181818182,0.8181818181818182
5973,18,3,0,848,848,0.0,1.0
6085,18,3,0,12,12,0.0,1.0
6012,18,3,0,62,62,0.0,1.0
5982,18,3,1,5,6,0.16666666666666666,0.8333333333333334
5948,18,3,0,57,57,0.0,1.0
5974,18,3,3,3,6,0.5,0.5
6090,18,3,0,4,4,0.0,1.0
6068,18,3,2,1,3,0.6666666666666666,0.3333333333333333
5962,18,3,2,39,41,0.04878048780487805,0.9512195121951219
6033,18,3,0,1,1,0.0,1.0
6038,18,3,2,0,2,1.0,0.0
6042,18,3,2,95,97,0.020618556701030927,0.979381443298969
5924,18,3,1,2,3,0.3333333333333333,0.6666666666666666
6083,18,3,0,27,27,0.0,1.0
6178,18,3,4,14,18,0.2222222222222222,0.7777777777777778
5958,18,3,3,1,4,0.75,0.25
6086,18,3,0,14,14,0.0,1.0
5945,18,3,1,18,19,0.05263157894736842,0.9473684210526315
5935,18,3,2,3,5,0.4,0.6
6073,18,3,5,10,15,0.3333333333333333,0.6666666666666666
5980,18,3,1,44,45,0.022222222222222223,0.9777777777777777
5993,18,3,1,482,483,0.002070393374741201,0.9979296066252588
6037,18,3,0,223,223,0.0,1.0
5979,18,3,3,2,5,0.6,0.4
5966,18,3,0,73,73,0.0,1.0
5985,18,3,0,3,3,0.0,1.0
5967,18,3,0,76,76,0.0,1.0
6188,18,3,1,21,22,0.045454545454545456,0.9545454545454546
6041,18,3,0,12,12,0.0,1.0
5972,18,3,4,9,13,0.3076923076923077,0.6923076923076923
6069,18,3,1,3,4,0.25,0.75
5937,18,3,1,0,1,1.0,0.0
6028,18,3,1,30,31,0.03225806451612903,0.967741935483871
5990,18,3,0,130,130,0.0,1.0
5928,18,3,2,479,481,0.004158004158004158,0.9958419958419958
5992,18,3,3,1,4,0.75,0.25
6058,18,3,3,10,13,0.23076923076923078,0.7692307692307693
6001,18,3,1,28,29,0.034482758620689655,0.9655172413793104
5964,18,3,4,27,31,0.12903225806451613,0.8709677419354839
5950,18,3,0,4,4,0.0,1.0
5991,18,3,2,6,8,0.25,0.75
6177,18,3,0,309,309,0.0,1.0
5961,18,3,0,321,321,0.0,1.0
6176,18,3,0,93,93,0.0,1.0
5956,18,3,0,31,31,0.0,1.0
5938,18,3,1,638,639,0.001564945226917058,0.9984350547730829
6179,18,3,3,25,28,0.10714285714285714,0.8928571428571429
5947,18,3,3,57,60,0.05,0.95
5927,18,3,0,455,455,0.0,1.0
5977,18,3,0,306,306,0.0,1.0
6198,18,3,0,5,5,0.0,1.0
5957,18,3,0,45,45,0.0,1.0
6057,18,3,1,28,29,0.034482758620689655,0.9655172413793104
6043,18,3,4,4,8,0.5,0.5
6077,18,3,0,4,4,0.0,1.0
6014,18,3,2,12,14,0.14285714285714285,0.8571428571428571
6015,18,3,0,3,3,0.0,1.0
5978,18,3,0,3,3,0.0,1.0
5986,18,3,1,49,50,0.02,0.98
5959,18,3,1,358,359,0.002785515320334262,0.9972144846796658
6051,18,3,4,34,38,0.10526315789473684,0.8947368421052632
6029,18,3,2,1,3,0.6666666666666666,0.3333333333333333
6070,18,3,0,1,1,0.0,1.0
5942,18,3,0,145,145,0.0,1.0
5953,18,3,3,1,4,0.75,0.25
6076,18,3,1,6,7,0.14285714285714285,0.8571428571428571
5940,18,3,3,7,10,0.3,0.7
6109,18,3,1,92,93,0.010752688172043012,0.989247311827957
6187,18,3,0,3,3,0.0,1.0
6053,18,3,0,17,17,0.0,1.0
6104,18,3,1,8,9,0.1111111111111111,0.8888888888888888
5943,18,3,1,1,2,0.5,0.5
6017,18,3,2,1,3,0.6666666666666666,0.3333333333333333
6168,18,3,2,14,16,0.125,0.875
5989,18,3,0,6,6,0.0,1.0
5963,18,3,5,1,6,0.8333333333333334,0.16666666666666666
6194,18,3,0,26,26,0.0,1.0
6167,18,3,3,16,19,0.15789473684210525,0.8421052631578947
6004,18,3,0,64,64,0.0,1.0
6030,18,3,5,2,7,0.7142857142857143,0.2857142857142857
6054,18,3,1,5,6,0.16666666666666666,0.8333333333333334
6032,18,3,2,10,12,0.16666666666666666,0.8333333333333334
6170,18,3,1,63,64,0.015625,0.984375
6063,18,3,3,0,3,1.0,0.0
5988,18,3,1,0,1,1.0,0.0
6075,18,3,0,3,3,0.0,1.0
6061,18,3,0,67,67,0.0,1.0
5965,18,3,1,48,49,0.02040816326530612,0.9795918367346939
6040,18,3,3,7,10,0.3,0.7
6059,18,3,0,85,85,0.0,1.0
6106,18,3,2,61,63,0.031746031746031744,0.9682539682539683
6031,18,3,4,10,14,0.2857142857142857,0.7142857142857143
6180,18,3,0,6,6,0.0,1.0
6039,18,3,3,60,63,0.047619047619047616,0.9523809523809523
6189,19,3,0,18,18,0.0,1.0
5936,19,3,2,4,6,0.3333333333333333,0.6666666666666666
6087,19,3,3,8,11,0.2727272727272727,0.7272727272727273
5973,19,3,0,848,848,0.0,1.0
6085,19,3,1,11,12,0.08333333333333333,0.9166666666666666
6012,19,3,0,62,62,0.0,1.0
5982,19,3,0,6,6,0.0,1.0
5948,19,3,0,57,57,0.0,1.0
5974,19,3,2,4,6,0.3333333333333333,0.6666666666666666
6090,19,3,0,4,4,0.0,1.0
6068,19,3,2,1,3,0.6666666666666666,0.3333333333333333
5962,19,3,2,39,41,0.04878048780487805,0.9512195121951219
6033,19,3,0,1,1,0.0,1.0
6038,19,3,1,1,2,0.5,0.5
6042,19,3,1,96,97,0.010309278350515464,0.9896907216494846
5924,19,3,1,2,3,0.3333333333333333,0.6666666666666666
6083,19,3,0,27,27,0.0,1.0
6178,19,3,5,13,18,0.2777777777777778,0.7222222222222222
5958,19,3,2,2,4,0.5,0.5
6086,19,3,0,14,14,0.0,1.0
5945,19,3,1,18,19,0.05263157894736842,0.9473684210526315
5935,19,3,1,4,5,0.2,0.8
6073,19,3,2,13,15,0.13333333333333333,0.8666666666666667
5980,19,3,2,43,45,0.044444444444444446,0.9555555555555556
5993,19,3,2,481,483,0.004140786749482402,0.9958592132505176
6037,19,3,1,222,223,0.004484304932735426,0.9955156950672646
5979,19,3,2,3,5,0.4,0.6
5966,19,3,0,73,73,0.0,1.0
5985,19,3,0,3,3,0.0,1.0
5967,19,3,0,76,76,0.0,1.0
6188,19,3,0,22,22,0.0,1.0
6041,19,3,0,12,12,0.0,1.0
5972,19,3,4,9,13,0.3076923076923077,0.6923076923076923
6069,19,3,1,3,4,0.25,0.75
5937,19,3,1,0,1,1.0,0.0
6028,19,3,4,27,31,0.12903225806451613,0.8709677419354839
5990,19,3,0,130,130,0.0,1.0
5928,19,3,3,478,481,0.006237006237006237,0.9937629937629938
5992,19,3,2,2,4,0.5,0.5
6058,19,3,0,13,13,0.0,1.0
6001,19,3,0,29,29,0.0,1.0
5964,19,3,4,27,31,0.12903225806451613,0.8709677419354839
5950,19,3,0,4,4,0.0,1.0
5991,19,3,0,8,8,0.0,1.0
6177,19,3,0,309,309,0.0,1.0
5961,19,3,0,321,321,0.0,1.0
6176,19,3,0,93,93,0.0,1.0
5956,19,3,0,31,31,0.0,1.0
5938,19,3,1,638,639,0.001564945226917058,0.9984350547730829
6179,19,3,2,26,28,0.07142857142857142,0.9285714285714286
5947,19,3,1,59,60,0.016666666666666666,0.9833333333333333
5927,19,3,1,454,455,0.002197802197802198,0.9978021978021978
5977,19,3,0,306,306,0.0,1.0
6198,19,3,0,5,5,0.0,1.0
5957,19,3,0,45,45,0.0,1.0
6057,19,3,0,29,29,0.0,1.0
6043,19,3,3,5,8,0.375,0.625
6077,19,3,0,4,4,0.0,1.0
6014,19,3,1,13,14,0.07142857142857142,0.9285714285714286
6015,19,3,0,3,3,0.0,1.0
5978,19,3,1,2,3,0.3333333333333333,0.6666666666666666
5986,19,3,0,50,50,0.0,1.0
5959,19,3,0,359,359,0.0,1.0
6051,19,3,3,35,38,0.07894736842105263,0.9210526315789473
6029,19,3,2,1,3,0.6666666666666666,0.3333333333333333
6070,19,3,0,1,1,0.0,1.0
5942,19,3,0,145,145,0.0,1.0
5953,19,3,1,3,4,0.25,0.75
6076,19,3,0,7,7,0.0,1.0
5940,19,3,1,9,10,0.1,0.9
6109,19,3,1,92,93,0.010752688172043012,0.989247311827957
6187,19,3,1,2,3,0.3333333333333333,0.6666666666666666
6053,19,3,0,17,17,0.0,1.0
6104,19,3,0,9,9,0.0,1.0
5943,19,3,0,2,2,0.0,1.0
6017,19,3,2,1,3,0.6666666666666666,0.3333333333333333
6168,19,3,1,15,16,0.0625,0.9375
5989,19,3,0,6,6,0.0,1.0
5963,19,3,5,1,6,0.8333333333333334,0.16666666666666666
6194,19,3,0,26,26,0.0,1.0
6167,19,3,1,18,19,0.05263157894736842,0.9473684210526315
6004,19,3,0,64,64,0.0,1.0
6030,19,3,4,3,7,0.5714285714285714,0.42857142857142855
6054,19,3,0,6,6,0.0,1.0
6032,19,3,6,6,12,0.5,0.5
6170,19,3,3,61,64,0.046875,0.953125
6063,19,3,3,0,3,1.0,0.0
5988,19,3,1,0,1,1.0,0.0
6075,19,3,0,3,3,0.0,1.0
6061,19,3,0,67,67,0.0,1.0
5965,19,3,1,48,49,0.02040816326530612,0.9795918367346939
6040,19,3,1,9,10,0.1,0.9
6059,19,3,0,85,85,0.0,1.0
6106,19,3,2,61,63,0.031746031746031744,0.9682539682539683
6031,19,3,5,9,14,0.35714285714285715,0.6428571428571429
6180,19,3,0,6,6,0.0,1.0
6039,19,3,0,63,63,0.0,1.0
6189,20,3,0,18,18,0.0,1.0
5936,20,3,1,5,6,0.16666666666666666,0.8333333333333334
6087,20,3,1,10,11,0.09090909090909091,0.9090909090909091
5973,20,3,1,847,848,0.0011792452830188679,0.9988207547169812
6085,20,3,3,9,12,0.25,0.75
6012,20,3,0,62,62,0.0,1.0
5982,20,3,1,5,6,0.16666666666666666,0.8333333333333334
5948,20,3,0,57,57,0.0,1.0
5974,20,3,3,3,6,0.5,0.5
6090,20,3,0,4,4,0.0,1.0
6068,20,3,3,0,3,1.0,0.0
5962,20,3,2,39,41,0.04878048780487805,0.9512195121951219
6033,20,3,0,1,1,0.0,1.0
6038,20,3,1,1,2,0.5,0.5
6042,20,3,2,95,97,0.020618556701030927,0.979381443298969
5924,20,3,0,3,3,0.0,1.0
6083,20,3,0,27,27,0.0,1.0
6178,20,3,6,12,18,0.3333333333333333,0.6666666666666666
5958,20,3,2,2,4,0.5,0.5
6086,20,3,0,14,14,0.0,1.0
5945,20,3,1,18,19,0.05263157894736842,0.9473684210526315
5935,20,3,2,3,5,0.4,0.6
6073,20,3,3,12,15,0.2,0.8
5980,20,3,2,43,45,0.044444444444444446,0.9555555555555556
5993,20,3,1,482,483,0.002070393374741201,0.9979296066252588
6037,20,3,0,223,223,0.0,1.0
5979,20,3,2,3,5,0.4,0.6
5966,20,3,0,73,73,0.0,1.0
5985,20,3,0,3,3,0.0,1.0
5967,20,3,0,76,76,0.0,1.0
6188,20,3,1,21,22,0.045454545454545456,0.9545454545454546
6041,20,3,0,12,12,0.0,1.0
5972,20,3,3,10,13,0.23076923076923078,0.7692307692307693
6069,20,3,0,4,4,0.0,1.0
5937,20,3,1,0,1,1.0,0.0
6028,20,3,3,28,31,0.0967741935483871,0.9032258064516129
5990,20,3,0,130,130,0.0,1.0
5928,20,3,0,481,481,0.0,1.0
5992,20,3,3,1,4,0.75,0.25
6058,20,3,2,11,13,0.15384615384615385,0.8461538461538461
6001,20,3,1,28,29,0.034482758620689655,0.9655172413793104
5964,20,3,2,29,31,0.06451612903225806,0.9354838709677419
5950,20,3,0,4,4,0.0,1.0
5991,20,3,1,7,8,0.125,0.875
6177,20,3,1,308,309,0.003236245954692557,0.9967637540453075
5961,20,3,0,321,321,0.0,1.0
6176,20,3,0,93,93,0.0,1.0
5956,20,3,0,31,31,0.0,1.0
5938,20,3,0,639,639,0.0,1.0
6179,20,3,2,26,28,0.07142857142857142,0.9285714285714286
5947,20,3,2,58,60,0.03333333333333333,0.9666666666666667
5927,20,3,1,454,455,0.002197802197802198,0.9978021978021978
5977,20,3,0,306,306,0.0,1.0
6198,20,3,0,5,5,0.0,1.0
5957,20,3,0,45,45,0.0,1.0
6057,20,3,0,29,29,0.0,1.0
6043,20,3,3,5,8,0.375,0.625
6077,20,3,0,4,4,0.0,1.0
6014,20,3,1,13,14,0.07142857142857142,0.9285714285714286
6015,20,3,0,3,3,0.0,1.0
5978,20,3,1,2,3,0.3333333333333333,0.6666666666666666
5986,20,3,0,50,50,0.0,1.0
5959,20,3,0,359,359,0.0,1.0
6051,20,3,3,35,38,0.07894736842105263,0.9210526315789473
6029,20,3,1,2,3,0.3333333333333333,0.6666666666666666
6070,20,3,0,1,1,0.0,1.0
5942,20,3,0,145,145,0.0,1.0
5953,20,3,2,2,4,0.5,0.5
6076,20,3,0,7,7,0.0,1.0
5940,20,3,0,10,10,0.0,1.0
6109,20,3,0,93,93,0.0,1.0
6187,20,3,1,2,3,0.3333333333333333,0.6666666666666666
6053,20,3,0,17,17,0.0,1.0
6104,20,3,4,5,9,0.4444444444444444,0.5555555555555556
5943,20,3,0,2,2,0.0,1.0
6017,20,3,2,1,3,0.6666666666666666,0.3333333333333333
6168,20,3,1,15,16,0.0625,0.9375
5989,20,3,0,6,6,0.0,1.0
5963,20,3,6,0,6,1.0,0.0
6194,20,3,0,26,26,0.0,1.0
6167,20,3,0,19,19,0.0,1.0
6004,20,3,0,64,64,0.0,1.0
6030,20,3,3,4,7,0.42857142857142855,0.5714285714285714
6054,20,3,1,5,6,0.16666666666666666,0.8333333333333334
6032,20,3,4,8,12,0.3333333333333333,0.6666666666666666
6170,20,3,3,61,64,0.046875,0.953125
6063,20,3,3,0,3,1.0,0.0
5988,20,3,1,0,1,1.0,0.0
6075,20,3,0,3,3,0.0,1.0
6061,20,3,0,67,67,0.0,1.0
5965,20,3,0,49,49,0.0,1.0
6040,20,3,1,9,10,0.1,0.9
6059,20,3,0,85,85,0.0,1.0
6106,20,3,2,61,63,0.031746031746031744,0.9682539682539683
6031,20,3,1,13,14,0.07142857142857142,0.9285714285714286
6180,20,3,0,6,6,0.0,1.0
6039,20,3,2,61,63,0.031746031746031744,0.9682539682539683
6189,21,3,0,18,18,0.0,1.0
5936,21,3,1,5,6,0.16666666666666666,0.8333333333333334
6087,21,3,1,10,11,0.09090909090909091,0.9090909090909091
5973,21,3,1,847,848,0.0011792452830188679,0.9988207547169812
6085,21,3,2,10,12,0.16666666666666666,0.8333333333333334
6012,21,3,0,62,62,0.0,1.0
5982,21,3,0,6,6,0.0,1.0
5948,21,3,0,57,57,0.0,1.0
5974,21,3,3,3,6,0.5,0.5
6090,21,3,0,4,4,0.0,1.0
6068,21,3,2,1,3,0.6666666666666666,0.3333333333333333
5962,21,3,1,40,41,0.024390243902439025,0.975609756097561
6033,21,3,0,1,1,0.0,1.0
6038,21,3,2,0,2,1.0,0.0
6042,21,3,2,95,97,0.020618556701030927,0.979381443298969
5924,21,3,1,2,3,0.3333333333333333,0.6666666666666666
6083,21,3,0,27,27,0.0,1.0
6178,21,3,6,12,18,0.3333333333333333,0.6666666666666666
5958,21,3,2,2,4,0.5,0.5
6086,21,3,0,14,14,0.0,1.0
5945,21,3,4,15,19,0.21052631578947367,0.7894736842105263
5935,21,3,4,1,5,0.8,0.2
6073,21,3,1,14,15,0.06666666666666667,0.9333333333333333
5980,21,3,1,44,45,0.022222222222222223,0.9777777777777777
5993,21,3,1,482,483,0.002070393374741201,0.9979296066252588
6037,21,3,0,223,223,0.0,1.0
5979,21,3,2,3,5,0.4,0.6
5966,21,3,0,73,73,0.0,1.0
5985,21,3,0,3,3,0.0,1.0
5967,21,3,0,76,76,0.0,1.0
6188,21,3,0,22,22,0.0,1.0
6041,21,3,0,12,12,0.0,1.0
5972,21,3,5,8,13,0.38461538461538464,0.6153846153846154
6069,21,3,1,3,4,0.25,0.75
5937,21,3,1,0,1,1.0,0.0
6028,21,3,2,29,31,0.06451612903225806,0.9354838709677419
5990,21,3,0,130,130,0.0,1.0
5928,21,3,3,478,481,0.006237006237006237,0.9937629937629938
5992,21,3,4,0,4,1.0,0.0
6058,21,3,1,12,13,0.07692307692307693,0.9230769230769231
6001,21,3,3,26,29,0.10344827586206896,0.896551724137931
5964,21,3,2,29,31,0.06451612903225806,0.9354838709677419
5950,21,3,0,4,4,0.0,1.0
5991,21,3,1,7,8,0.125,0.875
6177,21,3,0,309,309,0.0,1.0
5961,21,3,0,321,321,0.0,1.0
6176,21,3,0,93,93,0.0,1.0
5956,21,3,0,31,31,0.0,1.0
5938,21,3,1,638,639,0.001564945226917058,0.9984350547730829
6179,21,3,1,27,28,0.03571428571428571,0.9642857142857143
5947,21,3,2,58,60,0.03333333333333333,0.9666666666666667
5927,21,3,1,454,455,0.002197802197802198,0.9978021978021978
5977,21,3,0,306,306,0.0,1.0
6198,21,3,0,5,5,0.0,1.0
5957,21,3,0,45,45,0.0,1.0
6057,21,3,0,29,29,0.0,1.0
6043,21,3,3,5,8,0.375,0.625
6077,21,3,0,4,4,0.0,1.0
6014,21,3,3,11,14,0.21428571428571427,0.7857142857142857
6015,21,3,0,3,3,0.0,1.0
5978,21,3,1,2,3,0.3333333333333333,0.6666666666666666
5986,21,3,1,49,50,0.02,0.98
5959,21,3,0,359,359,0.0,1.0
6051,21,3,1,37,38,0.02631578947368421,0.9736842105263158
6029,21,3,1,2,3,0.3333333333333333,0.6666666666666666
6070,21,3,0,1,1,0.0,1.0
5942,21,3,0,145,145,0.0,1.0
5953,21,3,2,2,4,0.5,0.5
6076,21,3,0,7,7,0.0,1.0
5940,21,3,2,8,10,0.2,0.8
6109,21,3,0,93,93,0.0,1.0
6187,21,3,1,2,3,0.3333333333333333,0.6666666666666666
6053,21,3,0,17,17,0.0,1.0
6104,21,3,2,7,9,0.2222222222222222,0.7777777777777778
5943,21,3,1,1,2,0.5,0.5
6017,21,3,3,0,3,1.0,0.0
6168,21,3,2,14,16,0.125,0.875
5989,21,3,0,6,6,0.0,1.0
5963,21,3,6,0,6,1.0,0.0
6194,21,3,0,26,26,0.0,1.0
6167,21,3,1,18,19,0.05263157894736842,0.9473684210526315
6004,21,3,0,64,64,0.0,1.0
6030,21,3,4,3,7,0.5714285714285714,0.42857142857142855
6054,21,3,1,5,6,0.16666666666666666,0.8333333333333334
6032,21,3,2,10,12,0.16666666666666666,0.8333333333333334
6170,21,3,0,64,64,0.0,1.0
6063,21,3,3,0,3,1.0,0.0
5988,21,3,1,0,1,1.0,0.0
6075,21,3,0,3,3,0.0,1.0
6061,21,3,0,67,67,0.0,1.0
5965,21,3,1,48,49,0.02040816326530612,0.9795918367346939
6040,21,3,1,9,10,0.1,0.9
6059,21,3,0,85,85,0.0,1.0
6106,21,3,1,62,63,0.015873015873015872,0.9841269841269841
6031,21,3,4,10,14,0.2857142857142857,0.7142857142857143
6180,21,3,0,6,6,0.0,1.0
6039,21,3,2,61,63,0.031746031746031744,0.9682539682539683
6189,22,3,0,18,18,0.0,1.0
5936,22,3,0,6,6,0.0,1.0
6087,22,3,2,9,11,0.18181818181818182,0.8181818181818182
5973,22,3,0,848,848,0.0,1.0
6085,22,3,3,9,12,0.25,0.75
6012,22,3,0,62,62,0.0,1.0
5982,22,3,0,6,6,0.0,1.0
5948,22,3,0,57,57,0.0,1.0
5974,22,3,3,3,6,0.5,0.5
6090,22,3,0,4,4,0.0,1.0
6068,22,3,3,0,3,1.0,0.0
5962,22,3,1,40,41,0.024390243902439025,0.975609756097561
6033,22,3,0,1,1,0.0,1.0
6038,22,3,1,1,2,0.5,0.5
6042,22,3,4,93,97,0.041237113402061855,0.9587628865979382
5924,22,3,0,3,3,0.0,1.0
6083,22,3,0,27,27,0.0,1.0
6178,22,3,3,15,18,0.16666666666666666,0.8333333333333334
5958,22,3,2,2,4,0.5,0.5
6086,22,3,0,14,14,0.0,1.0
5945,22,3,1,18,19,0.05263157894736842,0.9473684210526315
5935,22,3,1,4,5,0.2,0.8
6073,22,3,0,15,15,0.0,1.0
5980,22,3,2,43,45,0.044444444444444446,0.9555555555555556
5993,22,3,0,483,483,0.0,1.0
6037,22,3,0,223,223,0.0,1.0
5979,22,3,2,3,5,0.4,0.6
5966,22,3,0,73,73,0.0,1.0
5985,22,3,0,3,3,0.0,1.0
5967,22,3,0,76,76,0.0,1.0
6188,22,3,0,22,22,0.0,1.0
6041,22,3,0,12,12,0.0,1.0
5972,22,3,4,9,13,0.3076923076923077,0.6923076923076923
6069,22,3,1,3,4,0.25,0.75
5937,22,3,1,0,1,1.0,0.0
6028,22,3,3,28,31,0.0967741935483871,0.9032258064516129
5990,22,3,0,130,130,0.0,1.0
5928,22,3,3,478,481,0.006237006237006237,0.9937629937629938
5992,22,3,2,2,4,0.5,0.5
6058,22,3,1,12,13,0.07692307692307693,0.9230769230769231
6001,22,3,1,28,29,0.034482758620689655,0.9655172413793104
5964,22,3,1,30,31,0.03225806451612903,0.967741935483871
5950,22,3,3,1,4,0.75,0.25
5991,22,3,1,7,8,0.125,0.875
6177,22,3,0,309,309,0.0,1.0
5961,22,3,0,321,321,0.0,1.0
6176,22,3,0,93,93,0.0,1.0
5956,22,3,0,31,31,0.0,1.0
5938,22,3,1,638,639,0.001564945226917058,0.9984350547730829
6179,22,3,1,27,28,0.03571428571428571,0.9642857142857143
5947,22,3,2,58,60,0.03333333333333333,0.9666666666666667
5927,22,3,0,455,455,0.0,1.0
5977,22,3,0,306,306,0.0,1.0
6198,22,3,0,5,5,0.0,1.0
5957,22,3,0,45,45,0.0,1.0
6057,22,3,0,29,29,0.0,1.0
6043,22,3,0,8,8,0.0,1.0
6077,22,3,0,4,4,0.0,1.0
6014,22,3,2,12,14,0.14285714285714285,0.8571428571428571
6015,22,3,0,3,3,0.0,1.0
5978,22,3,1,2,3,0.3333333333333333,0.6666666666666666
5986,22,3,1,49,50,0.02,0.98
5959,22,3,0,359,359,0.0,1.0
6051,22,3,1,37,38,0.02631578947368421,0.9736842105263158
6029,22,3,1,2,3,0.3333333333333333,0.6666666666666666
6070,22,3,0,1,1,0.0,1.0
5942,22,3,0,145,145,0.0,1.0
5953,22,3,3,1,4,0.75,0.25
6076,22,3,0,7,7,0.0,1.0
5940,22,3,3,7,10,0.3,0.7
6109,22,3,0,93,93,0.0,1.0
6187,22,3,1,2,3,0.3333333333333333,0.6666666666666666
6053,22,3,0,17,17,0.0,1.0
6104,22,3,2,7,9,0.2222222222222222,0.7777777777777778
5943,22,3,1,1,2,0.5,0.5
6017,22,3,3,0,3,1.0,0.0
6168,22,3,1,15,16,0.0625,0.9375
5989,22,3,0,6,6,0.0,1.0
5963,22,3,6,0,6,1.0,0.0
6194,22,3,0,26,26,0.0,1.0
6167,22,3,0,19,19,0.0,1.0
6004,22,3,1,63,64,0.015625,0.984375
6030,22,3,5,2,7,0.7142857142857143,0.2857142857142857
6054,22,3,1,5,6,0.16666666666666666,0.8333333333333334
6032,22,3,2,10,12,0.16666666666666666,0.8333333333333334
6170,22,3,1,63,64,0.015625,0.984375
6063,22,3,3,0,3,1.0,0.0
5988,22,3,1,0,1,1.0,0.0
6075,22,3,0,3,3,0.0,1.0
6061,22,3,0,67,67,0.0,1.0
5965,22,3,1,48,49,0.02040816326530612,0.9795918367346939
6040,22,3,1,9,10,0.1,0.9
6059,22,3,0,85,85,0.0,1.0
6106,22,3,3,60,63,0.047619047619047616,0.9523809523809523
6031,22,3,2,12,14,0.14285714285714285,0.8571428571428571
6180,22,3,0,6,6,0.0,1.0
6039,22,3,2,61,63,0.031746031746031744,0.9682539682539683
6189,23,3,0,18,18,0.0,1.0
5936,23,3,2,4,6,0.3333333333333333,0.6666666666666666
6087,23,3,1,10,11,0.09090909090909091,0.9090909090909091
5973,23,3,0,848,848,0.0,1.0
6085,23,3,0,12,12,0.0,1.0
6012,23,3,0,62,62,0.0,1.0
5982,23,3,1,5,6,0.16666666666666666,0.8333333333333334
5948,23,3,0,57,57,0.0,1.0
5974,23,3,2,4,6,0.3333333333333333,0.6666666666666666
6090,23,3,0,4,4,0.0,1.0
6068,23,3,2,1,3,0.6666666666666666,0.3333333333333333
5962,23,3,1,40,41,0.024390243902439025,0.975609756097561
6033,23,3,0,1,1,0.0,1.0
6038,23,3,1,1,2,0.5,0.5
6042,23,3,1,96,97,0.010309278350515464,0.9896907216494846
5924,23,3,1,2,3,0.3333333333333333,0.6666666666666666
6083,23,3,0,27,27,0.0,1.0
6178,23,3,2,16,18,0.1111111111111111,0.8888888888888888
5958,23,3,2,2,4,0.5,0.5
6086,23,3,0,14,14,0.0,1.0
5945,23,3,1,18,19,0.05263157894736842,0.9473684210526315
5935,23,3,1,4,5,0.2,0.8
6073,23,3,1,14,15,0.06666666666666667,0.9333333333333333
5980,23,3,1,44,45,0.022222222222222223,0.9777777777777777
5993,23,3,2,481,483,0.004140786749482402,0.9958592132505176
6037,23,3,0,223,223,0.0,1.0
5979,23,3,1,4,5,0.2,0.8
5966,23,3,0,73,73,0.0,1.0
5985,23,3,0,3,3,0.0,1.0
5967,23,3,0,76,76,0.0,1.0
6188,23,3,0,22,22,0.0,1.0
6041,23,3,0,12,12,0.0,1.0
5972,23,3,0,13,13,0.0,1.0
6069,23,3,0,4,4,0.0,1.0
5937,23,3,1,0,1,1.0,0.0
6028,23,3,0,31,31,0.0,1.0
5990,23,3,0,130,130,0.0,1.0
5928,23,3,2,479,481,0.004158004158004158,0.9958419958419958
5992,23,3,4,0,4,1.0,0.0
6058,23,3,1,12,13,0.07692307692307693,0.9230769230769231
6001,23,3,1,28,29,0.034482758620689655,0.9655172413793104
5964,23,3,1,30,31,0.03225806451612903,0.967741935483871
5950,23,3,0,4,4,0.0,1.0
5991,23,3,1,7,8,0.125,0.875
6177,23,3,0,309,309,0.0,1.0
5961,23,3,0,321,321,0.0,1.0
6176,23,3,0,93,93,0.0,1.0
5956,23,3,0,31,31,0.0,1.0
5938,23,3,0,639,639,0.0,1.0
6179,23,3,0,28,28,0.0,1.0
5947,23,3,5,55,60,0.08333333333333333,0.9166666666666666
5927,23,3,0,455,455,0.0,1.0
5977,23,3,0,306,306,0.0,1.0
6198,23,3,0,5,5,0.0,1.0
5957,23,3,0,45,45,0.0,1.0
6057,23,3,0,29,29,0.0,1.0
6043,23,3,1,7,8,0.125,0.875
6077,23,3,0,4,4,0.0,1.0
6014,23,3,0,14,14,0.0,1.0
6015,23,3,0,3,3,0.0,1.0
5978,23,3,2,1,3,0.6666666666666666,0.3333333333333333
5986,23,3,1,49,50,0.02,0.98
5959,23,3,0,359,359,0.0,1.0
6051,23,3,0,38,38,0.0,1.0
6029,23,3,0,3,3,0.0,1.0
6070,23,3,0,1,1,0.0,1.0
5942,23,3,0,145,145,0.0,1.0
5953,23,3,1,3,4,0.25,0.75
6076,23,3,0,7,7,0.0,1.0
5940,23,3,1,9,10,0.1,0.9
6109,23,3,0,93,93,0.0,1.0
6187,23,3,0,3,3,0.0,1.0
6053,23,3,0,17,17,0.0,1.0
6104,23,3,2,7,9,0.2222222222222222,0.7777777777777778
5943,23,3,1,1,2,0.5,0.5
6017,23,3,3,0,3,1.0,0.0
6168,23,3,4,12,16,0.25,0.75
5989,23,3,0,6,6,0.0,1.0
5963,23,3,5,1,6,0.8333333333333334,0.16666666666666666
6194,23,3,0,26,26,0.0,1.0
6167,23,3,0,19,19,0.0,1.0
6004,23,3,1,63,64,0.015625,0.984375
6030,23,3,3,4,7,0.42857142857142855,0.5714285714285714
6054,23,3,1,5,6,0.16666666666666666,0.8333333333333334
6032,23,3,1,11,12,0.08333333333333333,0.9166666666666666
6170,23,3,0,64,64,0.0,1.0
6063,23,3,3,0,3,1.0,0.0
5988,23,3,1,0,1,1.0,0.0
6075,23,3,0,3,3,0.0,1.0
6061,23,3,0,67,67,0.0,1.0
5965,23,3,0,49,49,0.0,1.0
6040,23,3,0,10,10,0.0,1.0
6059,23,3,0,85,85,0.0,1.0
6106,23,3,1,62,63,0.015873015873015872,0.9841269841269841
6031,23,3,3,11,14,0.21428571428571427,0.7857142857142857
6180,23,3,0,6,6,0.0,1.0
6039,23,3,0,63,63,0.0,1.0
6189,24,3,0,18,18,0.0,1.0
5936,24,3,0,6,6,0.0,1.0
6087,24,3,1,10,11,0.09090909090909091,0.9090909090909091
5973,24,3,1,847,848,0.0011792452830188679,0.9988207547169812
6085,24,3,2,10,12,0.16666666666666666,0.8333333333333334
6012,24,3,0,62,62,0.0,1.0
5982,24,3,1,5,6,0.16666666666666666,0.8333333333333334
5948,24,3,0,57,57,0.0,1.0
5974,24,3,1,5,6,0.16666666666666666,0.8333333333333334
6090,24,3,0,4,4,0.0,1.0
6068,24,3,1,2,3,0.3333333333333333,0.6666666666666666
5962,24,3,2,39,41,0.04878048780487805,0.9512195121951219
6033,24,3,0,1,1,0.0,1.0
6038,24,3,2,0,2,1.0,0.0
6042,24,3,1,96,97,0.010309278350515464,0.9896907216494846
5924,24,3,1,2,3,0.3333333333333333,0.6666666666666666
6083,24,3,0,27,27,0.0,1.0
6178,24,3,2,16,18,0.1111111111111111,0.8888888888888888
5958,24,3,2,2,4,0.5,0.5
6086,24,3,0,14,14,0.0,1.0
5945,24,3,1,18,19,0.05263157894736842,0.9473684210526315
5935,24,3,1,4,5,0.2,0.8
6073,24,3,0,15,15,0.0,1.0
5980,24,3,2,43,45,0.044444444444444446,0.9555555555555556
5993,24,3,2,481,483,0.004140786749482402,0.9958592132505176
6037,24,3,0,223,223,0.0,1.0
5979,24,3,1,4,5,0.2,0.8
5966,24,3,0,73,73,0.0,1.0
5985,24,3,0,3,3,0.0,1.0
5967,24,3,0,76,76,0.0,1.0
6188,24,3,1,21,22,0.045454545454545456,0.9545454545454546
6041,24,3,0,12,12,0.0,1.0
5972,24,3,3,10,13,0.23076923076923078,0.7692307692307693
6069,24,3,1,3,4,0.25,0.75
5937,24,3,1,0,1,1.0,0.0
6028,24,3,1,30,31,0.03225806451612903,0.967741935483871
5990,24,3,0,130,130,0.0,1.0
5928,24,3,2,479,481,0.004158004158004158,0.9958419958419958
5992,24,3,4,0,4,1.0,0.0
6058,24,3,2,11,13,0.15384615384615385,0.8461538461538461
6001,24,3,2,27,29,0.06896551724137931,0.9310344827586207
5964,24,3,2,29,31,0.06451612903225806,0.9354838709677419
5950,24,3,0,4,4,0.0,1.0
5991,24,3,1,7,8,0.125,0.875
6177,24,3,0,309,309,0.0,1.0
5961,24,3,0,321,321,0.0,1.0
6176,24,3,0,93,93,0.0,1.0
5956,24,3,0,31,31,0.0,1.0
5938,24,3,1,638,639,0.001564945226917058,0.9984350547730829
6179,24,3,1,27,28,0.03571428571428571,0.9642857142857143
5947,24,3,4,56,60,0.06666666666666667,0.9333333333333333
5927,24,3,1,454,455,0.002197802197802198,0.9978021978021978
5977,24,3,0,306,306,0.0,1.0
6198,24,3,0,5,5,0.0,1.0
5957,24,3,0,45,45,0.0,1.0
6057,24,3,0,29,29,0.0,1.0
6043,24,3,1,7,8,0.125,0.875
6077,24,3,0,4,4,0.0,1.0
6014,24,3,1,13,14,0.07142857142857142,0.9285714285714286
6015,24,3,0,3,3,0.0,1.0
5978,24,3,2,1,3,0.6666666666666666,0.3333333333333333
5986,24,3,3,47,50,0.06,0.94
5959,24,3,0,359,359,0.0,1.0
6051,24,3,0,38,38,0.0,1.0
6029,24,3,0,3,3,0.0,1.0
6070,24,3,0,1,1,0.0,1.0
5942,24,3,0,145,145,0.0,1.0
5953,24,3,0,4,4,0.0,1.0
6076,24,3,0,7,7,0.0,1.0
5940,24,3,1,9,10,0.1,0.9
6109,24,3,0,93,93,0.0,1.0
6187,24,3,1,2,3,0.3333333333333333,0.6666666666666666
6053,24,3,0,17,17,0.0,1.0
6104,24,3,1,8,9,0.1111111111111111,0.8888888888888888
5943,24,3,1,1,2,0.5,0.5
6017,24,3,3,0,3,1.0,0.0
6168,24,3,7,9,16,0.4375,0.5625
5989,24,3,2,4,6,0.3333333333333333,0.6666666666666666
5963,24,3,5,1,6,0.8333333333333334,0.16666666666666666
6194,24,3,0,26,26,0.0,1.0
6167,24,3,0,19,19,0.0,1.0
6004,24,3,0,64,64,0.0,1.0
6030,24,3,4,3,7,0.5714285714285714,0.42857142857142855
6054,24,3,0,6,6,0.0,1.0
6032,24,3,0,12,12,0.0,1.0
6170,24,3,1,63,64,0.015625,0.984375
6063,24,3,2,1,3,0.6666666666666666,0.3333333333333333
5988,24,3,1,0,1,1.0,0.0
6075,24,3,0,3,3,0.0,1.0
6061,24,3,0,67,67,0.0,1.0
5965,24,3,0,49,49,0.0,1.0
6040,24,3,2,8,10,0.2,0.8
6059,24,3,0,85,85,0.0,1.0
6106,24,3,1,62,63,0.015873015873015872,0.9841269841269841
6031,24,3,2,12,14,0.14285714285714285,0.8571428571428571
6180,24,3,0,6,6,0.0,1.0
6039,24,3,3,60,63,0.047619047619047616,0.9523809523809523
6189,25,3,0,18,18,0.0,1.0
5936,25,3,2,4,6,0.3333333333333333,0.6666666666666666
6087,25,3,0,11,11,0.0,1.0
5973,25,3,1,847,848,0.0011792452830188679,0.9988207547169812
6085,25,3,1,11,12,0.08333333333333333,0.9166666666666666
6012,25,3,0,62,62,0.0,1.0
5982,25,3,0,6,6,0.0,1.0
5948,25,3,0,57,57,0.0,1.0
5974,25,3,1,5,6,0.16666666666666666,0.8333333333333334
6090,25,3,0,4,4,0.0,1.0
6068,25,3,3,0,3,1.0,0.0
5962,25,3,1,40,41,0.024390243902439025,0.975609756097561
6033,25,3,0,1,1,0.0,1.0
6038,25,3,2,0,2,1.0,0.0
6042,25,3,1,96,97,0.010309278350515464,0.9896907216494846
5924,25,3,1,2,3,0.3333333333333333,0.6666666666666666
6083,25,3,0,27,27,0.0,1.0
6178,25,3,5,13,18,0.2777777777777778,0.7222222222222222
5958,25,3,2,2,4,0.5,0.5
6086,25,3,0,14,14,0.0,1.0
5945,25,3,0,19,19,0.0,1.0
5935,25,3,0,5,5,0.0,1.0
6073,25,3,0,15,15,0.0,1.0
5980,25,3,0,45,45,0.0,1.0
5993,25,3,3,480,483,0.006211180124223602,0.9937888198757764
6037,25,3,0,223,223,0.0,1.0
5979,25,3,2,3,5,0.4,0.6
5966,25,3,0,73,73,0.0,1.0
5985,25,3,0,3,3,0.0,1.0
5967,25,3,0,76,76,0.0,1.0
6188,25,3,1,21,22,0.045454545454545456,0.9545454545454546
6041,25,3,0,12,12,0.0,1.0
5972,25,3,3,10,13,0.23076923076923078,0.7692307692307693
6069,25,3,2,2,4,0.5,0.5
5937,25,3,1,0,1,1.0,0.0
6028,25,3,1,30,31,0.03225806451612903,0.967741935483871
5990,25,3,0,130,130,0.0,1.0
5928,25,3,1,480,481,0.002079002079002079,0.997920997920998
5992,25,3,2,2,4,0.5,0.5
6058,25,3,2,11,13,0.15384615384615385,0.8461538461538461
6001,25,3,3,26,29,0.10344827586206896,0.896551724137931
5964,25,3,1,30,31,0.03225806451612903,0.967741935483871
5950,25,3,0,4,4,0.0,1.0
5991,25,3,0,8,8,0.0,1.0
6177,25,3,0,309,309,0.0,1.0
5961,25,3,0,321,321,0.0,1.0
6176,25,3,0,93,93,0.0,1.0
5956,25,3,0,31,31,0.0,1.0
5938,25,3,0,639,639,0.0,1.0
6179,25,3,1,27,28,0.03571428571428571,0.9642857142857143
5947,25,3,0,60,60,0.0,1.0
5927,25,3,0,455,455,0.0,1.0
5977,25,3,0,306,306,0.0,1.0
6198,25,3,0,5,5,0.0,1.0
5957,25,3,0,45,45,0.0,1.0
6057,25,3,0,29,29,0.0,1.0
6043,25,3,1,7,8,0.125,0.875
6077,25,3,0,4,4,0.0,1.0
6014,25,3,1,13,14,0.07142857142857142,0.9285714285714286
6015,25,3,0,3,3,0.0,1.0
5978,25,3,1,2,3,0.3333333333333333,0.6666666666666666
5986,25,3,0,50,50,0.0,1.0
5959,25,3,0,359,359,0.0,1.0
6051,25,3,0,38,38,0.0,1.0
6029,25,3,0,3,3,0.0,1.0
6070,25,3,0,1,1,0.0,1.0
5942,25,3,0,145,145,0.0,1.0
5953,25,3,1,3,4,0.25,0.75
6076,25,3,0,7,7,0.0,1.0
5940,25,3,1,9,10,0.1,0.9
6109,25,3,1,92,93,0.010752688172043012,0.989247311827957
6187,25,3,0,3,3,0.0,1.0
6053,25,3,0,17,17,0.0,1.0
6104,25,3,2,7,9,0.2222222222222222,0.7777777777777778
5943,25,3,1,1,2,0.5,0.5
6017,25,3,1,2,3,0.3333333333333333,0.6666666666666666
6168,25,3,3,13,16,0.1875,0.8125
5989,25,3,2,4,6,0.3333333333333333,0.6666666666666666
5963,25,3,5,1,6,0.8333333333333334,0.16666666666666666
6194,25,3,0,26,26,0.0,1.0
6167,25,3,1,18,19,0.05263157894736842,0.9473684210526315
6004,25,3,0,64,64,0.0,1.0
6030,25,3,2,5,7,0.2857142857142857,0.7142857142857143
6054,25,3,1,5,6,0.16666666666666666,0.8333333333333334
6032,25,3,2,10,12,0.16666666666666666,0.8333333333333334
6170,25,3,1,63,64,0.015625,0.984375
6063,25,3,1,2,3,0.3333333333333333,0.6666666666666666
5988,25,3,1,0,1,1.0,0.0
6075,25,3,0,3,3,0.0,1.0
6061,25,3,0,67,67,0.0,1.0
5965,25,3,0,49,49,0.0,1.0
6040,25,3,1,9,10,0.1,0.9
6059,25,3,0,85,85,0.0,1.0
6106,25,3,1,62,63,0.015873015873015872,0.9841269841269841
6031,25,3,2,12,14,0.14285714285714285,0.8571428571428571
6180,25,3,0,6,6,0.0,1.0
6039,25,3,2,61,63,0.031746031746031744,0.9682539682539683
6189,26,3,0,18,18,0.0,1.0
5936,26,3,1,5,6,0.16666666666666666,0.8333333333333334
6087,26,3,1,10,11,0.09090909090909091,0.9090909090909091
5973,26,3,0,848,848,0.0,1.0
6085,26,3,1,11,12,0.08333333333333333,0.9166666666666666
6012,26,3,0,62,62,0.0,1.0
5982,26,3,1,5,6,0.16666666666666666,0.8333333333333334
5948,26,3,0,57,57,0.0,1.0
5974,26,3,2,4,6,0.3333333333333333,0.6666666666666666
6090,26,3,0,4,4,0.0,1.0
6068,26,3,3,0,3,1.0,0.0
5962,26,3,0,41,41,0.0,1.0
6033,26,3,0,1,1,0.0,1.0
6038,26,3,1,1,2,0.5,0.5
6042,26,3,1,96,97,0.010309278350515464,0.9896907216494846
5924,26,3,1,2,3,0.3333333333333333,0.6666666666666666
6083,26,3,0,27,27,0.0,1.0
6178,26,3,2,16,18,0.1111111111111111,0.8888888888888888
5958,26,3,1,3,4,0.25,0.75
6086,26,3,0,14,14,0.0,1.0
5945,26,3,1,18,19,0.05263157894736842,0.9473684210526315
5935,26,3,1,4,5,0.2,0.8
6073,26,3,2,13,15,0.13333333333333333,0.8666666666666667
5980,26,3,0,45,45,0.0,1.0
5993,26,3,2,481,483,0.004140786749482402,0.9958592132505176
6037,26,3,0,223,223,0.0,1.0
5979,26,3,3,2,5,0.6,0.4
5966,26,3,0,73,73,0.0,1.0
5985,26,3,0,3,3,0.0,1.0
5967,26,3,0,76,76,0.0,1.0
6188,26,3,0,22,22,0.0,1.0
6041,26,3,0,12,12,0.0,1.0
5972,26,3,1,12,13,0.07692307692307693,0.9230769230769231
6069,26,3,1,3,4,0.25,0.75
5937,26,3,1,0,1,1.0,0.0
6028,26,3,1,30,31,0.03225806451612903,0.967741935483871
5990,26,3,0,130,130,0.0,1.0
5928,26,3,1,480,481,0.002079002079002079,0.997920997920998
5992,26,3,1,3,4,0.25,0.75
6058,26,3,2,11,13,0.15384615384615385,0.8461538461538461
6001,26,3,3,26,29,0.10344827586206896,0.896551724137931
5964,26,3,0,31,31,0.0,1.0
5950,26,3,0,4,4,0.0,1.0
5991,26,3,1,7,8,0.125,0.875
6177,26,3,0,309,309,0.0,1.0
5961,26,3,0,321,321,0.0,1.0
6176,26,3,0,93,93,0.0,1.0
5956,26,3,0,31,31,0.0,1.0
5938,26,3,0,639,639,0.0,1.0
6179,26,3,1,27,28,0.03571428571428571,0.9642857142857143
5947,26,3,1,59,60,0.016666666666666666,0.9833333333333333
5927,26,3,0,455,455,0.0,1.0
5977,26,3,0,306,306,0.0,1.0
6198,26,3,0,5,5,0.0,1.0
5957,26,3,0,45,45,0.0,1.0
6057,26,3,0,29,29,0.0,1.0
6043,26,3,1,7,8,0.125,0.875
6077,26,3,0,4,4,0.0,1.0
6014,26,3,2,12,14,0.14285714285714285,0.8571428571428571
6015,26,3,0,3,3,0.0,1.0
5978,26,3,1,2,3,0.3333333333333333,0.6666666666666666
5986,26,3,1,49,50,0.02,0.98
5959,26,3,1,358,359,0.002785515320334262,0.9972144846796658
6051,26,3,0,38,38,0.0,1.0
6029,26,3,0,3,3,0.0,1.0
6070,26,3,0,1,1,0.0,1.0
5942,26,3,0,145,145,0.0,1.0
5953,26,3,1,3,4,0.25,0.75
6076,26,3,0,7,7,0.0,1.0
5940,26,3,0,10,10,0.0,1.0
6109,26,3,1,92,93,0.010752688172043012,0.989247311827957
6187,26,3,0,3,3,0.0,1.0
6053,26,3,0,17,17,0.0,1.0
6104,26,3,2,7,9,0.2222222222222222,0.7777777777777778
5943,26,3,1,1,2,0.5,0.5
6017,26,3,3,0,3,1.0,0.0
6168,26,3,1,15,16,0.0625,0.9375
5989,26,3,0,6,6,0.0,1.0
5963,26,3,6,0,6,1.0,0.0
6194,26,3,0,26,26,0.0,1.0
6167,26,3,0,19,19,0.0,1.0
6004,26,3,1,63,64,0.015625,0.984375
6030,26,3,3,4,7,0.42857142857142855,0.5714285714285714
6054,26,3,0,6,6,0.0,1.0
6032,26,3,2,10,12,0.16666666666666666,0.8333333333333334
6170,26,3,1,63,64,0.015625,0.984375
6063,26,3,2,1,3,0.6666666666666666,0.3333333333333333
5988,26,3,1,0,1,1.0,0.0
6075,26,3,0,3,3,0.0,1.0
6061,26,3,0,67,67,0.0,1.0
5965,26,3,1,48,49,0.02040816326530612,0.9795918367346939
6040,26,3,4,6,10,0.4,0.6
6059,26,3,0,85,85,0.0,1.0
6106,26,3,1,62,63,0.015873015873015872,0.9841269841269841
6031,26,3,2,12,14,0.14285714285714285,0.8571428571428571
6180,26,3,0,6,6,0.0,1.0
6039,26,3,1,62,63,0.015873015873015872,0.9841269841269841
6189,27,3,0,18,18,0.0,1.0
5936,27,3,1,5,6,0.16666666666666666,0.8333333333333334
6087,27,3,4,7,11,0.36363636363636365,0.6363636363636364
5973,27,3,0,848,848,0.0,1.0
6085,27,3,0,12,12,0.0,1.0
6012,27,3,0,62,62,0.0,1.0
5982,27,3,1,5,6,0.16666666666666666,0.8333333333333334
5948,27,3,0,57,57,0.0,1.0
5974,27,3,1,5,6,0.16666666666666666,0.8333333333333334
6090,27,3,0,4,4,0.0,1.0
6068,27,3,1,2,3,0.3333333333333333,0.6666666666666666
5962,27,3,1,40,41,0.024390243902439025,0.975609756097561
6033,27,3,0,1,1,0.0,1.0
6038,27,3,1,1,2,0.5,0.5
6042,27,3,2,95,97,0.020618556701030927,0.979381443298969
5924,27,3,1,2,3,0.3333333333333333,0.6666666666666666
6083,27,3,0,27,27,0.0,1.0
6178,27,3,2,16,18,0.1111111111111111,0.8888888888888888
5958,27,3,1,3,4,0.25,0.75
6086,27,3,0,14,14,0.0,1.0
5945,27,3,1,18,19,0.05263157894736842,0.9473684210526315
5935,27,3,0,5,5,0.0,1.0
6073,27,3,1,14,15,0.06666666666666667,0.9333333333333333
5980,27,3,1,44,45,0.022222222222222223,0.9777777777777777
5993,27,3,4,479,483,0.008281573498964804,0.9917184265010351
6037,27,3,0,223,223,0.0,1.0
5979,27,3,2,3,5,0.4,0.6
5966,27,3,0,73,73,0.0,1.0
5985,27,3,0,3,3,0.0,1.0
5967,27,3,0,76,76,0.0,1.0
6188,27,3,1,21,22,0.045454545454545456,0.9545454545454546
6041,27,3,0,12,12,0.0,1.0
5972,27,3,2,11,13,0.15384615384615385,0.8461538461538461
6069,27,3,1,3,4,0.25,0.75
5937,27,3,1,0,1,1.0,0.0
6028,27,3,2,29,31,0.06451612903225806,0.9354838709677419
5990,27,3,0,130,130,0.0,1.0
5928,27,3,1,480,481,0.002079002079002079,0.997920997920998
5992,27,3,1,3,4,0.25,0.75
6058,27,3,1,12,13,0.07692307692307693,0.9230769230769231
6001,27,3,2,27,29,0.06896551724137931,0.9310344827586207
5964,27,3,5,26,31,0.16129032258064516,0.8387096774193549
5950,27,3,0,4,4,0.0,1.0
5991,27,3,0,8,8,0.0,1.0
6177,27,3,0,309,309,0.0,1.0
5961,27,3,0,321,321,0.0,1.0
6176,27,3,0,93,93,0.0,1.0
5956,27,3,0,31,31,0.0,1.0
5938,27,3,0,639,639,0.0,1.0
6179,27,3,0,28,28,0.0,1.0
5947,27,3,1,59,60,0.016666666666666666,0.9833333333333333
5927,27,3,0,455,455,0.0,1.0
5977,27,3,0,306,306,0.0,1.0
6198,27,3,0,5,5,0.0,1.0
5957,27,3,0,45,45,0.0,1.0
6057,27,3,0,29,29,0.0,1.0
6043,27,3,1,7,8,0.125,0.875
6077,27,3,0,4,4,0.0,1.0
6014,27,3,1,13,14,0.07142857142857142,0.9285714285714286
6015,27,3,0,3,3,0.0,1.0
5978,27,3,1,2,3,0.3333333333333333,0.6666666666666666
5986,27,3,0,50,50,0.0,1.0
5959,27,3,0,359,359,0.0,1.0
6051,27,3,0,38,38,0.0,1.0
6029,27,3,0,3,3,0.0,1.0
6070,27,3,0,1,1,0.0,1.0
5942,27,3,0,145,145,0.0,1.0
5953,27,3,0,4,4,0.0,1.0
6076,27,3,0,7,7,0.0,1.0
5940,27,3,1,9,10,0.1,0.9
6109,27,3,1,92,93,0.010752688172043012,0.989247311827957
6187,27,3,0,3,3,0.0,1.0
6053,27,3,0,17,17,0.0,1.0
6104,27,3,0,9,9,0.0,1.0
5943,27,3,1,1,2,0.5,0.5
6017,27,3,2,1,3,0.6666666666666666,0.3333333333333333
6168,27,3,2,14,16,0.125,0.875
5989,27,3,0,6,6,0.0,1.0
5963,27,3,6,0,6,1.0,0.0
6194,27,3,0,26,26,0.0,1.0
6167,27,3,0,19,19,0.0,1.0
6004,27,3,0,64,64,0.0,1.0
6030,27,3,4,3,7,0.5714285714285714,0.42857142857142855
6054,27,3,1,5,6,0.16666666666666666,0.8333333333333334
6032,27,3,3,9,12,0.25,0.75
6170,27,3,1,63,64,0.015625,0.984375
6063,27,3,2,1,3,0.6666666666666666,0.3333333333333333
5988,27,3,1,0,1,1.0,0.0
6075,27,3,0,3,3,0.0,1.0
6061,27,3,0,67,67,0.0,1.0
5965,27,3,0,49,49,0.0,1.0
6040,27,3,1,9,10,0.1,0.9
6059,27,3,0,85,85,0.0,1.0
6106,27,3,1,62,63,0.015873015873015872,0.9841269841269841
6031,27,3,5,9,14,0.35714285714285715,0.6428571428571429
6180,27,3,0,6,6,0.0,1.0
6039,27,3,4,59,63,0.06349206349206349,0.9365079365079365
6189,28,3,0,18,18,0.0,1.0
5936,28,3,1,5,6,0.16666666666666666,0.8333333333333334
6087,28,3,0,11,11,0.0,1.0
5973,28,3,0,848,848,0.0,1.0
6085,28,3,3,9,12,0.25,0.75
6012,28,3,0,62,62,0.0,1.0
5982,28,3,1,5,6,0.16666666666666666,0.8333333333333334
5948,28,3,0,57,57,0.0,1.0
5974,28,3,2,4,6,0.3333333333333333,0.6666666666666666
6090,28,3,0,4,4,0.0,1.0
6068,28,3,1,2,3,0.3333333333333333,0.6666666666666666
5962,28,3,0,41,41,0.0,1.0
6033,28,3,0,1,1,0.0,1.0
6038,28,3,2,0,2,1.0,0.0
6042,28,3,1,96,97,0.010309278350515464,0.9896907216494846
5924,28,3,1,2,3,0.3333333333333333,0.6666666666666666
6083,28,3,0,27,27,0.0,1.0
6178,28,3,1,17,18,0.05555555555555555,0.9444444444444444
5958,28,3,1,3,4,0.25,0.75
6086,28,3,0,14,14,0.0,1.0
5945,28,3,1,18,19,0.05263157894736842,0.9473684210526315
5935,28,3,0,5,5,0.0,1.0
6073,28,3,4,11,15,0.26666666666666666,0.7333333333333333
5980,28,3,2,43,45,0.044444444444444446,0.9555555555555556
5993,28,3,0,483,483,0.0,1.0
6037,28,3,0,223,223,0.0,1.0
5979,28,3,1,4,5,0.2,0.8
5966,28,3,0,73,73,0.0,1.0
5985,28,3,0,3,3,0.0,1.0
5967,28,3,0,76,76,0.0,1.0
6188,28,3,0,22,22,0.0,1.0
6041,28,3,0,12,12,0.0,1.0
5972,28,3,0,13,13,0.0,1.0
6069,28,3,0,4,4,0.0,1.0
5937,28,3,1,0,1,1.0,0.0
6028,28,3,3,28,31,0.0967741935483871,0.9032258064516129
5990,28,3,0,130,130,0.0,1.0
5928,28,3,0,481,481,0.0,1.0
5992,28,3,2,2,4,0.5,0.5
6058,28,3,0,13,13,0.0,1.0
6001,28,3,1,28,29,0.034482758620689655,0.9655172413793104
5964,28,3,2,29,31,0.06451612903225806,0.9354838709677419
5950,28,3,3,1,4,0.75,0.25
5991,28,3,1,7,8,0.125,0.875
6177,28,3,0,309,309,0.0,1.0
5961,28,3,0,321,321,0.0,1.0
6176,28,3,0,93,93,0.0,1.0
5956,28,3,0,31,31,0.0,1.0
5938,28,3,1,638,639,0.001564945226917058,0.9984350547730829
6179,28,3,1,27,28,0.03571428571428571,0.9642857142857143
5947,28,3,2,58,60,0.03333333333333333,0.9666666666666667
5927,28,3,0,455,455,0.0,1.0
5977,28,3,0,306,306,0.0,1.0
6198,28,3,0,5,5,0.0,1.0
5957,28,3,0,45,45,0.0,1.0
6057,28,3,0,29,29,0.0,1.0
6043,28,3,1,7,8,0.125,0.875
6077,28,3,0,4,4,0.0,1.0
6014,28,3,2,12,14,0.14285714285714285,0.8571428571428571
6015,28,3,0,3,3,0.0,1.0
5978,28,3,1,2,3,0.3333333333333333,0.6666666666666666
5986,28,3,0,50,50,0.0,1.0
5959,28,3,1,358,359,0.002785515320334262,0.9972144846796658
6051,28,3,0,38,38,0.0,1.0
6029,28,3,0,3,3,0.0,1.0
6070,28,3,0,1,1,0.0,1.0
5942,28,3,0,145,145,0.0,1.0
5953,28,3,0,4,4,0.0,1.0
6076,28,3,0,7,7,0.0,1.0
5940,28,3,1,9,10,0.1,0.9
6109,28,3,1,92,93,0.010752688172043012,0.989247311827957
6187,28,3,0,3,3,0.0,1.0
6053,28,3,0,17,17,0.0,1.0
6104,28,3,0,9,9,0.0,1.0
5943,28,3,1,1,2,0.5,0.5
6017,28,3,2,1,3,0.6666666666666666,0.3333333333333333
6168,28,3,0,16,16,0.0,1.0
5989,28,3,0,6,6,0.0,1.0
5963,28,3,5,1,6,0.8333333333333334,0.16666666666666666
6194,28,3,0,26,26,0.0,1.0
6167,28,3,1,18,19,0.05263157894736842,0.9473684210526315
6004,28,3,1,63,64,0.015625,0.984375
6030,28,3,4,3,7,0.5714285714285714,0.42857142857142855
6054,28,3,1,5,6,0.16666666666666666,0.8333333333333334
6032,28,3,2,10,12,0.16666666666666666,0.8333333333333334
6170,28,3,2,62,64,0.03125,0.96875
6063,28,3,1,2,3,0.3333333333333333,0.6666666666666666
5988,28,3,1,0,1,1.0,0.0
6075,28,3,0,3,3,0.0,1.0
6061,28,3,0,67,67,0.0,1.0
5965,28,3,0,49,49,0.0,1.0
6040,28,3,2,8,10,0.2,0.8
6059,28,3,0,85,85,0.0,1.0
6106,28,3,0,63,63,0.0,1.0
6031,28,3,2,12,14,0.14285714285714285,0.8571428571428571
6180,28,3,0,6,6,0.0,1.0
6039,28,3,0,63,63,0.0,1.0
6189,29,3,0,18,18,0.0,1.0
5936,29,3,1,5,6,0.16666666666666666,0.8333333333333334
6087,29,3,0,11,11,0.0,1.0
5973,29,3,0,848,848,0.0,1.0
6085,29,3,3,9,12,0.25,0.75
6012,29,3,0,62,62,0.0,1.0
5982,29,3,1,5,6,0.16666666666666666,0.8333333333333334
5948,29,3,0,57,57,0.0,1.0
5974,29,3,0,6,6,0.0,1.0
6090,29,3,0,4,4,0.0,1.0
6068,29,3,3,0,3,1.0,0.0
5962,29,3,1,40,41,0.024390243902439025,0.975609756097561
6033,29,3,0,1,1,0.0,1.0
6038,29,3,1,1,2,0.5,0.5
6042,29,3,1,96,97,0.010309278350515464,0.9896907216494846
5924,29,3,1,2,3,0.3333333333333333,0.6666666666666666
6083,29,3,0,27,27,0.0,1.0
6178,29,3,5,13,18,0.2777777777777778,0.7222222222222222
5958,29,3,1,3,4,0.25,0.75
6086,29,3,0,14,14,0.0,1.0
5945,29,3,0,19,19,0.0,1.0
5935,29,3,1,4,5,0.2,0.8
6073,29,3,0,15,15,0.0,1.0
5980,29,3,1,44,45,0.022222222222222223,0.9777777777777777
5993,29,3,1,482,483,0.002070393374741201,0.9979296066252588
6037,29,3,0,223,223,0.0,1.0
5979,29,3,2,3,5,0.4,0.6
5966,29,3,0,73,73,0.0,1.0
5985,29,3,0,3,3,0.0,1.0
5967,29,3,0,76,76,0.0,1.0
6188,29,3,0,22,22,0.0,1.0
6041,29,3,0,12,12,0.0,1.0
5972,29,3,2,11,13,0.15384615384615385,0.8461538461538461
6069,29,3,1,3,4,0.25,0.75
5937,29,3,1,0,1,1.0,0.0
6028,29,3,3,28,31,0.0967741935483871,0.9032258064516129
5990,29,3,0,130,130,0.0,1.0
5928,29,3,1,480,481,0.002079002079002079,0.997920997920998
5992,29,3,2,2,4,0.5,0.5
6058,29,3,1,12,13,0.07692307692307693,0.9230769230769231
6001,29,3,2,27,29,0.06896551724137931,0.9310344827586207
5964,29,3,2,29,31,0.06451612903225806,0.9354838709677419
5950,29,3,0,4,4,0.0,1.0
5991,29,3,0,8,8,0.0,1.0
6177,29,3,0,309,309,0.0,1.0
5961,29,3,0,321,321,0.0,1.0
6176,29,3,0,93,93,0.0,1.0
5956,29,3,0,31,31,0.0,1.0
5938,29,3,0,639,639,0.0,1.0
6179,29,3,0,28,28,0.0,1.0
5947,29,3,1,59,60,0.016666666666666666,0.9833333333333333
5927,29,3,1,454,455,0.002197802197802198,0.9978021978021978
5977,29,3,0,306,306,0.0,1.0
6198,29,3,0,5,5,0.0,1.0
5957,29,3,0,45,45,0.0,1.0
6057,29,3,0,29,29,0.0,1.0
6043,29,3,1,7,8,0.125,0.875
6077,29,3,0,4,4,0.0,1.0
6014,29,3,2,12,14,0.14285714285714285,0.8571428571428571
6015,29,3,0,3,3,0.0,1.0
5978,29,3,0,3,3,0.0,1.0
5986,29,3,1,49,50,0.02,0.98
5959,29,3,0,359,359,0.0,1.0
6051,29,3,0,38,38,0.0,1.0
6029,29,3,0,3,3,0.0,1.0
6070,29,3,0,1,1,0.0,1.0
5942,29,3,0,145,145,0.0,1.0
5953,29,3,0,4,4,0.0,1.0
6076,29,3,0,7,7,0.0,1.0
5940,29,3,0,10,10,0.0,1.0
6109,29,3,1,92,93,0.010752688172043012,0.989247311827957
6187,29,3,0,3,3,0.0,1.0
6053,29,3,0,17,17,0.0,1.0
6104,29,3,0,9,9,0.0,1.0
5943,29,3,0,2,2,0.0,1.0
6017,29,3,1,2,3,0.3333333333333333,0.6666666666666666
6168,29,3,1,15,16,0.0625,0.9375
5989,29,3,0,6,6,0.0,1.0
5963,29,3,6,0,6,1.0,0.0
6194,29,3,0,26,26,0.0,1.0
6167,29,3,0,19,19,0.0,1.0
6004,29,3,1,63,64,0.015625,0.984375
6030,29,3,4,3,7,0.5714285714285714,0.42857142857142855
6054,29,3,0,6,6,0.0,1.0
6032,29,3,2,10,12,0.16666666666666666,0.8333333333333334
6170,29,3,1,63,64,0.015625,0.984375
6063,29,3,1,2,3,0.3333333333333333,0.6666666666666666
5988,29,3,1,0,1,1.0,0.0
6075,29,3,0,3,3,0.0,1.0
6061,29,3,0,67,67,0.0,1.0
5965,29,3,1,48,49,0.02040816326530612,0.9795918367346939
6040,29,3,3,7,10,0.3,0.7
6059,29,3,0,85,85,0.0,1.0
6106,29,3,0,63,63,0.0,1.0
6031,29,3,2,12,14,0.14285714285714285,0.8571428571428571
6180,29,3,0,6,6,0.0,1.0
6039,29,3,0,63,63,0.0,1.0
6189,0,4,0,18,18,0.0,1.0
5936,0,4,6,0,6,1.0,0.0
6087,0,4,0,11,11,0.0,1.0
5973,0,4,5,843,848,0.00589622641509434,0.9941037735849056
6085,0,4,12,0,12,1.0,0.0
6012,0,4,0,62,62,0.0,1.0
5982,0,4,0,6,6,0.0,1.0
5948,0,4,0,57,57,0.0,1.0
5974,0,4,6,0,6,1.0,0.0
6090,0,4,0,4,4,0.0,1.0
6068,0,4,3,0,3,1.0,0.0
5962,0,4,40,1,41,0.975609756097561,0.024390243902439025
6033,0,4,1,0,1,1.0,0.0
6038,0,4,2,0,2,1.0,0.0
6042,0,4,87,10,97,0.8969072164948454,0.10309278350515463
5924,0,4,3,0,3,1.0,0.0
6083,0,4,0,27,27,0.0,1.0
6178,0,4,18,0,18,1.0,0.0
5958,0,4,4,0,4,1.0,0.0
6086,0,4,0,14,14,0.0,1.0
5945,0,4,19,0,19,1.0,0.0
5935,0,4,5,0,5,1.0,0.0
6073,0,4,14,1,15,0.9333333333333333,0.06666666666666667
5980,0,4,45,0,45,1.0,0.0
5993,0,4,180,303,483,0.37267080745341613,0.6273291925465838
6037,0,4,170,53,223,0.7623318385650224,0.23766816143497757
5979,0,4,5,0,5,1.0,0.0
5966,0,4,0,73,73,0.0,1.0
5985,0,4,3,0,3,1.0,0.0
5967,0,4,0,76,76,0.0,1.0
6188,0,4,21,1,22,0.9545454545454546,0.045454545454545456
6041,0,4,0,12,12,0.0,1.0
5972,0,4,13,0,13,1.0,0.0
6069,0,4,1,3,4,0.25,0.75
5937,0,4,1,0,1,1.0,0.0
6028,0,4,31,0,31,1.0,0.0
5990,0,4,0,130,130,0.0,1.0
5928,0,4,241,240,481,0.501039501039501,0.498960498960499
5992,0,4,4,0,4,1.0,0.0
6058,0,4,13,0,13,1.0,0.0
6001,0,4,29,0,29,1.0,0.0
5964,0,4,31,0,31,1.0,0.0
5950,0,4,4,0,4,1.0,0.0
5991,0,4,8,0,8,1.0,0.0
6177,0,4,253,56,309,0.8187702265372169,0.18122977346278318
5961,0,4,0,321,321,0.0,1.0
6176,0,4,0,93,93,0.0,1.0
5956,0,4,0,31,31,0.0,1.0
5938,0,4,61,578,639,0.09546165884194054,0.9045383411580594
6179,0,4,28,0,28,1.0,0.0
5947,0,4,50,10,60,0.8333333333333334,0.16666666666666666
5927,0,4,14,441,455,0.03076923076923077,0.9692307692307692
5977,0,4,4,302,306,0.013071895424836602,0.9869281045751634
6198,0,4,0,5,5,0.0,1.0
5957,0,4,0,45,45,0.0,1.0
6057,0,4,29,0,29,1.0,0.0
6043,0,4,8,0,8,1.0,0.0
6077,0,4,0,4,4,0.0,1.0
6014,0,4,14,0,14,1.0,0.0
6015,0,4,3,0,3,1.0,0.0
5978,0,4,3,0,3,1.0,0.0
5986,0,4,19,31,50,0.38,0.62
5959,0,4,259,100,359,0.7214484679665738,0.2785515320334262
6051,0,4,33,5,38,0.868421052631579,0.13157894736842105
6029,0,4,3,0,3,1.0,0.0
6070,0,4,1,0,1,1.0,0.0
5942,0,4,0,145,145,0.0,1.0
5953,0,4,4,0,4,1.0,0.0
6076,0,4,7,0,7,1.0,0.0
5940,0,4,10,0,10,1.0,0.0
6109,0,4,82,11,93,0.8817204301075269,0.11827956989247312
6187,0,4,3,0,3,1.0,0.0
6053,0,4,0,17,17,0.0,1.0
6104,0,4,9,0,9,1.0,0.0
5943,0,4,2,0,2,1.0,0.0
6017,0,4,3,0,3,1.0,0.0
6168,0,4,12,4,16,0.75,0.25
5989,0,4,5,1,6,0.8333333333333334,0.16666666666666666
5963,0,4,6,0,6,1.0,0.0
6194,0,4,0,26,26,0.0,1.0
6167,0,4,19,0,19,1.0,0.0
6004,0,4,1,63,64,0.015625,0.984375
6030,0,4,7,0,7,1.0,0.0
6054,0,4,6,0,6,1.0,0.0
6032,0,4,12,0,12,1.0,0.0
6170,0,4,62,2,64,0.96875,0.03125
6063,0,4,3,0,3,1.0,0.0
5988,0,4,1,0,1,1.0,0.0
6075,0,4,3,0,3,1.0,0.0
6061,0,4,0,67,67,0.0,1.0
5965,0,4,45,4,49,0.9183673469387755,0.08163265306122448
6040,0,4,10,0,10,1.0,0.0
6059,0,4,0,85,85,0.0,1.0
6106,0,4,60,3,63,0.9523809523809523,0.047619047619047616
6031,0,4,8,6,14,0.5714285714285714,0.42857142857142855
6180,0,4,0,6,6,0.0,1.0
6039,0,4,24,39,63,0.38095238095238093,0.6190476190476191
6189,1,4,0,18,18,0.0,1.0
5936,1,4,6,0,6,1.0,0.0
6087,1,4,2,9,11,0.18181818181818182,0.8181818181818182
5973,1,4,4,844,848,0.0047169811320754715,0.9952830188679245
6085,1,4,12,0,12,1.0,0.0
6012,1,4,0,62,62,0.0,1.0
5982,1,4,0,6,6,0.0,1.0
5948,1,4,0,57,57,0.0,1.0
5974,1,4,6,0,6,1.0,0.0
6090,1,4,0,4,4,0.0,1.0
6068,1,4,3,0,3,1.0,0.0
5962,1,4,31,10,41,0.7560975609756098,0.24390243902439024
6033,1,4,1,0,1,1.0,0.0
6038,1,4,2,0,2,1.0,0.0
6042,1,4,79,18,97,0.8144329896907216,0.18556701030927836
5924,1,4,3,0,3,1.0,0.0
6083,1,4,0,27,27,0.0,1.0
6178,1,4,18,0,18,1.0,0.0
5958,1,4,4,0,4,1.0,0.0
6086,1,4,0,14,14,0.0,1.0
5945,1,4,17,2,19,0.8947368421052632,0.10526315789473684
5935,1,4,5,0,5,1.0,0.0
6073,1,4,13,2,15,0.8666666666666667,0.13333333333333333
5980,1,4,44,1,45,0.9777777777777777,0.022222222222222223
5993,1,4,95,388,483,0.19668737060041408,0.8033126293995859
6037,1,4,110,113,223,0.49327354260089684,0.5067264573991032
5979,1,4,5,0,5,1.0,0.0
5966,1,4,0,73,73,0.0,1.0
5985,1,4,3,0,3,1.0,0.0
5967,1,4,0,76,76,0.0,1.0
6188,1,4,21,1,22,0.9545454545454546,0.045454545454545456
6041,1,4,0,12,12,0.0,1.0
5972,1,4,13,0,13,1.0,0.0
6069,1,4,1,3,4,0.25,0.75
5937,1,4,1,0,1,1.0,0.0
6028,1,4,25,6,31,0.8064516129032258,0.1935483870967742
5990,1,4,0,130,130,0.0,1.0
5928,1,4,130,351,481,0.2702702702702703,0.7297297297297297
5992,1,4,4,0,4,1.0,0.0
6058,1,4,13,0,13,1.0,0.0
6001,1,4,28,1,29,0.9655172413793104,0.034482758620689655
5964,1,4,30,1,31,0.967741935483871,0.03225806451612903
5950,1,4,4,0,4,1.0,0.0
5991,1,4,8,0,8,1.0,0.0
6177,1,4,177,132,309,0.5728155339805825,0.42718446601941745
5961,1,4,0,321,321,0.0,1.0
6176,1,4,0,93,93,0.0,1.0
5956,1,4,0,31,31,0.0,1.0
5938,1,4,50,589,639,0.0782472613458529,0.9217527386541471
6179,1,4,27,1,28,0.9642857142857143,0.03571428571428571
5947,1,4,52,8,60,0.8666666666666667,0.13333333333333333
5927,1,4,7,448,455,0.015384615384615385,0.9846153846153847
5977,1,4,6,300,306,0.0196078431372549,0.9803921568627451
6198,1,4,0,5,5,0.0,1.0
5957,1,4,0,45,45,0.0,1.0
6057,1,4,27,2,29,0.9310344827586207,0.06896551724137931
6043,1,4,8,0,8,1.0,0.0
6077,1,4,0,4,4,0.0,1.0
6014,1,4,14,0,14,1.0,0.0
6015,1,4,3,0,3,1.0,0.0
5978,1,4,3,0,3,1.0,0.0
5986,1,4,19,31,50,0.38,0.62
5959,1,4,174,185,359,0.48467966573816157,0.5153203342618384
6051,1,4,29,9,38,0.7631578947368421,0.23684210526315788
6029,1,4,3,0,3,1.0,0.0
6070,1,4,1,0,1,1.0,0.0
5942,1,4,0,145,145,0.0,1.0
5953,1,4,4,0,4,1.0,0.0
6076,1,4,7,0,7,1.0,0.0
5940,1,4,10,0,10,1.0,0.0
6109,1,4,66,27,93,0.7096774193548387,0.2903225806451613
6187,1,4,3,0,3,1.0,0.0
6053,1,4,0,17,17,0.0,1.0
6104,1,4,9,0,9,1.0,0.0
5943,1,4,2,0,2,1.0,0.0
6017,1,4,3,0,3,1.0,0.0
6168,1,4,13,3,16,0.8125,0.1875
5989,1,4,6,0,6,1.0,0.0
5963,1,4,6,0,6,1.0,0.0
6194,1,4,0,26,26,0.0,1.0
6167,1,4,18,1,19,0.9473684210526315,0.05263157894736842
6004,1,4,1,63,64,0.015625,0.984375
6030,1,4,6,1,7,0.8571428571428571,0.14285714285714285
6054,1,4,6,0,6,1.0,0.0
6032,1,4,12,0,12,1.0,0.0
6170,1,4,54,10,64,0.84375,0.15625
6063,1,4,3,0,3,1.0,0.0
5988,1,4,1,0,1,1.0,0.0
6075,1,4,3,0,3,1.0,0.0
6061,1,4,0,67,67,0.0,1.0
5965,1,4,38,11,49,0.7755102040816326,0.22448979591836735
6040,1,4,9,1,10,0.9,0.1
6059,1,4,0,85,85,0.0,1.0
6106,1,4,54,9,63,0.8571428571428571,0.14285714285714285
6031,1,4,7,7,14,0.5,0.5
6180,1,4,0,6,6,0.0,1.0
6039,1,4,21,42,63,0.3333333333333333,0.6666666666666666
6189,2,4,0,18,18,0.0,1.0
5936,2,4,6,0,6,1.0,0.0
6087,2,4,2,9,11,0.18181818181818182,0.8181818181818182
5973,2,4,3,845,848,0.003537735849056604,0.9964622641509434
6085,2,4,12,0,12,1.0,0.0
6012,2,4,0,62,62,0.0,1.0
5982,2,4,0,6,6,0.0,1.0
5948,2,4,0,57,57,0.0,1.0
5974,2,4,5,1,6,0.8333333333333334,0.16666666666666666
6090,2,4,0,4,4,0.0,1.0
6068,2,4,3,0,3,1.0,0.0
5962,2,4,27,14,41,0.6585365853658537,0.34146341463414637
6033,2,4,0,1,1,0.0,1.0
6038,2,4,2,0,2,1.0,0.0
6042,2,4,53,44,97,0.5463917525773195,0.4536082474226804
5924,2,4,3,0,3,1.0,0.0
6083,2,4,0,27,27,0.0,1.0
6178,2,4,17,1,18,0.9444444444444444,0.05555555555555555
5958,2,4,4,0,4,1.0,0.0
6086,2,4,0,14,14,0.0,1.0
5945,2,4,14,5,19,0.7368421052631579,0.2631578947368421
5935,2,4,5,0,5,1.0,0.0
6073,2,4,11,4,15,0.7333333333333333,0.26666666666666666
5980,2,4,42,3,45,0.9333333333333333,0.06666666666666667
5993,2,4,48,435,483,0.09937888198757763,0.9006211180124224
6037,2,4,36,187,223,0.16143497757847533,0.8385650224215246
5979,2,4,5,0,5,1.0,0.0
5966,2,4,0,73,73,0.0,1.0
5985,2,4,3,0,3,1.0,0.0
5967,2,4,0,76,76,0.0,1.0
6188,2,4,18,4,22,0.8181818181818182,0.18181818181818182
6041,2,4,0,12,12,0.0,1.0
5972,2,4,13,0,13,1.0,0.0
6069,2,4,1,3,4,0.25,0.75
5937,2,4,1,0,1,1.0,0.0
6028,2,4,22,9,31,0.7096774193548387,0.2903225806451613
5990,2,4,0,130,130,0.0,1.0
5928,2,4,45,436,481,0.09355509355509356,0.9064449064449065
5992,2,4,4,0,4,1.0,0.0
6058,2,4,13,0,13,1.0,0.0
6001,2,4,21,8,29,0.7241379310344828,0.27586206896551724
5964,2,4,25,6,31,0.8064516129032258,0.1935483870967742
5950,2,4,3,1,4,0.75,0.25
5991,2,4,7,1,8,0.875,0.125
6177,2,4,59,250,309,0.19093851132686085,0.8090614886731392
5961,2,4,0,321,321,0.0,1.0
6176,2,4,0,93,93,0.0,1.0
5956,2,4,0,31,31,0.0,1.0
5938,2,4,26,613,639,0.0406885758998435,0.9593114241001565
6179,2,4,21,7,28,0.75,0.25
5947,2,4,45,15,60,0.75,0.25
5927,2,4,6,449,455,0.013186813186813187,0.9868131868131869
5977,2,4,4,302,306,0.013071895424836602,0.9869281045751634
6198,2,4,0,5,5,0.0,1.0
5957,2,4,0,45,45,0.0,1.0
6057,2,4,19,10,29,0.6551724137931034,0.3448275862068966
6043,2,4,8,0,8,1.0,0.0
6077,2,4,0,4,4,0.0,1.0
6014,2,4,14,0,14,1.0,0.0
6015,2,4,3,0,3,1.0,0.0
5978,2,4,3,0,3,1.0,0.0
5986,2,4,12,38,50,0.24,0.76
5959,2,4,72,287,359,0.20055710306406685,0.7994428969359332
6051,2,4,28,10,38,0.7368421052631579,0.2631578947368421
6029,2,4,3,0,3,1.0,0.0
6070,2,4,1,0,1,1.0,0.0
5942,2,4,0,145,145,0.0,1.0
5953,2,4,4,0,4,1.0,0.0
6076,2,4,7,0,7,1.0,0.0
5940,2,4,8,2,10,0.8,0.2
6109,2,4,37,56,93,0.3978494623655914,0.6021505376344086
6187,2,4,3,0,3,1.0,0.0
6053,2,4,0,17,17,0.0,1.0
6104,2,4,9,0,9,1.0,0.0
5943,2,4,2,0,2,1.0,0.0
6017,2,4,3,0,3,1.0,0.0
6168,2,4,9,7,16,0.5625,0.4375
5989,2,4,5,1,6,0.8333333333333334,0.16666666666666666
5963,2,4,6,0,6,1.0,0.0
6194,2,4,0,26,26,0.0,1.0
6167,2,4,18,1,19,0.9473684210526315,0.05263157894736842
6004,2,4,1,63,64,0.015625,0.984375
6030,2,4,6,1,7,0.8571428571428571,0.14285714285714285
6054,2,4,6,0,6,1.0,0.0
6032,2,4,12,0,12,1.0,0.0
6170,2,4,40,24,64,0.625,0.375
6063,2,4,3,0,3,1.0,0.0
5988,2,4,1,0,1,1.0,0.0
6075,2,4,3,0,3,1.0,0.0
6061,2,4,0,67,67,0.0,1.0
5965,2,4,22,27,49,0.4489795918367347,0.5510204081632653
6040,2,4,9,1,10,0.9,0.1
6059,2,4,0,85,85,0.0,1.0
6106,2,4,30,33,63,0.47619047619047616,0.5238095238095238
6031,2,4,7,7,14,0.5,0.5
6180,2,4,0,6,6,0.0,1.0
6039,2,4,24,39,63,0.38095238095238093,0.6190476190476191
6189,3,4,0,18,18,0.0,1.0
5936,3,4,6,0,6,1.0,0.0
6087,3,4,2,9,11,0.18181818181818182,0.8181818181818182
5973,3,4,4,844,848,0.0047169811320754715,0.9952830188679245
6085,3,4,11,1,12,0.9166666666666666,0.08333333333333333
6012,3,4,0,62,62,0.0,1.0
5982,3,4,0,6,6,0.0,1.0
5948,3,4,0,57,57,0.0,1.0
5974,3,4,4,2,6,0.6666666666666666,0.3333333333333333
6090,3,4,0,4,4,0.0,1.0
6068,3,4,3,0,3,1.0,0.0
5962,3,4,23,18,41,0.5609756097560976,0.43902439024390244
6033,3,4,0,1,1,0.0,1.0
6038,3,4,2,0,2,1.0,0.0
6042,3,4,35,62,97,0.36082474226804123,0.6391752577319587
5924,3,4,1,2,3,0.3333333333333333,0.6666666666666666
6083,3,4,0,27,27,0.0,1.0
6178,3,4,17,1,18,0.9444444444444444,0.05555555555555555
5958,3,4,3,1,4,0.75,0.25
6086,3,4,0,14,14,0.0,1.0
5945,3,4,7,12,19,0.3684210526315789,0.631578947368421
5935,3,4,4,1,5,0.8,0.2
6073,3,4,10,5,15,0.6666666666666666,0.3333333333333333
5980,3,4,33,12,45,0.7333333333333333,0.26666666666666666
5993,3,4,36,447,483,0.07453416149068323,0.9254658385093167
6037,3,4,22,201,223,0.09865470852017937,0.9013452914798207
5979,3,4,5,0,5,1.0,0.0
5966,3,4,0,73,73,0.0,1.0
5985,3,4,3,0,3,1.0,0.0
5967,3,4,0,76,76,0.0,1.0
6188,3,4,15,7,22,0.6818181818181818,0.3181818181818182
6041,3,4,0,12,12,0.0,1.0
5972,3,4,12,1,13,0.9230769230769231,0.07692307692307693
6069,3,4,1,3,4,0.25,0.75
5937,3,4,1,0,1,1.0,0.0
6028,3,4,19,12,31,0.6129032258064516,0.3870967741935484
5990,3,4,0,130,130,0.0,1.0
5928,3,4,26,455,481,0.05405405405405406,0.9459459459459459
5992,3,4,4,0,4,1.0,0.0
6058,3,4,13,0,13,1.0,0.0
6001,3,4,18,11,29,0.6206896551724138,0.3793103448275862
5964,3,4,21,10,31,0.6774193548387096,0.3225806451612903
5950,3,4,3,1,4,0.75,0.25
5991,3,4,6,2,8,0.75,0.25
6177,3,4,38,271,309,0.12297734627831715,0.8770226537216829
5961,3,4,0,321,321,0.0,1.0
6176,3,4,0,93,93,0.0,1.0
5956,3,4,0,31,31,0.0,1.0
5938,3,4,17,622,639,0.026604068857589983,0.97339593114241
6179,3,4,14,14,28,0.5,0.5
5947,3,4,31,29,60,0.5166666666666667,0.48333333333333334
5927,3,4,2,453,455,0.004395604395604396,0.9956043956043956
5977,3,4,5,301,306,0.016339869281045753,0.9836601307189542
6198,3,4,0,5,5,0.0,1.0
5957,3,4,0,45,45,0.0,1.0
6057,3,4,16,13,29,0.5517241379310345,0.4482758620689655
6043,3,4,8,0,8,1.0,0.0
6077,3,4,0,4,4,0.0,1.0
6014,3,4,12,2,14,0.8571428571428571,0.14285714285714285
6015,3,4,3,0,3,1.0,0.0
5978,3,4,2,1,3,0.6666666666666666,0.3333333333333333
5986,3,4,7,43,50,0.14,0.86
5959,3,4,47,312,359,0.1309192200557103,0.8690807799442897
6051,3,4,26,12,38,0.6842105263157895,0.3157894736842105
6029,3,4,2,1,3,0.6666666666666666,0.3333333333333333
6070,3,4,1,0,1,1.0,0.0
5942,3,4,0,145,145,0.0,1.0
5953,3,4,4,0,4,1.0,0.0
6076,3,4,7,0,7,1.0,0.0
5940,3,4,7,3,10,0.7,0.3
6109,3,4,23,70,93,0.24731182795698925,0.7526881720430108
6187,3,4,2,1,3,0.6666666666666666,0.3333333333333333
6053,3,4,0,17,17,0.0,1.0
6104,3,4,8,1,9,0.8888888888888888,0.1111111111111111
5943,3,4,2,0,2,1.0,0.0
6017,3,4,2,1,3,0.6666666666666666,0.3333333333333333
6168,3,4,9,7,16,0.5625,0.4375
5989,3,4,5,1,6,0.8333333333333334,0.16666666666666666
5963,3,4,6,0,6,1.0,0.0
6194,3,4,0,26,26,0.0,1.0
6167,3,4,18,1,19,0.9473684210526315,0.05263157894736842
6004,3,4,0,64,64,0.0,1.0
6030,3,4,6,1,7,0.8571428571428571,0.14285714285714285
6054,3,4,5,1,6,0.8333333333333334,0.16666666666666666
6032,3,4,11,1,12,0.9166666666666666,0.08333333333333333
6170,3,4,28,36,64,0.4375,0.5625
6063,3,4,3,0,3,1.0,0.0
5988,3,4,1,0,1,1.0,0.0
6075,3,4,3,0,3,1.0,0.0
6061,3,4,0,67,67,0.0,1.0
5965,3,4,16,33,49,0.32653061224489793,0.673469387755102
6040,3,4,9,1,10,0.9,0.1
6059,3,4,0,85,85,0.0,1.0
6106,3,4,18,45,63,0.2857142857142857,0.7142857142857143
6031,3,4,5,9,14,0.35714285714285715,0.6428571428571429
6180,3,4,0,6,6,0.0,1.0
6039,3,4,20,43,63,0.31746031746031744,0.6825396825396826
6189,4,4,0,18,18,0.0,1.0
5936,4,4,6,0,6,1.0,0.0
6087,4,4,3,8,11,0.2727272727272727,0.7272727272727273
5973,4,4,2,846,848,0.0023584905660377358,0.9976415094339622
6085,4,4,10,2,12,0.8333333333333334,0.16666666666666666
6012,4,4,0,62,62,0.0,1.0
5982,4,4,1,5,6,0.16666666666666666,0.8333333333333334
5948,4,4,0,57,57,0.0,1.0
5974,4,4,4,2,6,0.6666666666666666,0.3333333333333333
6090,4,4,0,4,4,0.0,1.0
6068,4,4,3,0,3,1.0,0.0
5962,4,4,15,26,41,0.36585365853658536,0.6341463414634146
6033,4,4,0,1,1,0.0,1.0
6038,4,4,2,0,2,1.0,0.0
6042,4,4,23,74,97,0.23711340206185566,0.7628865979381443
5924,4,4,3,0,3,1.0,0.0
6083,4,4,0,27,27,0.0,1.0
6178,4,4,12,6,18,0.6666666666666666,0.3333333333333333
5958,4,4,3,1,4,0.75,0.25
6086,4,4,0,14,14,0.0,1.0
5945,4,4,5,14,19,0.2631578947368421,0.7368421052631579
5935,4,4,5,0,5,1.0,0.0
6073,4,4,10,5,15,0.6666666666666666,0.3333333333333333
5980,4,4,31,14,45,0.6888888888888889,0.3111111111111111
5993,4,4,14,469,483,0.028985507246376812,0.9710144927536232
6037,4,4,12,211,223,0.053811659192825115,0.9461883408071748
5979,4,4,5,0,5,1.0,0.0
5966,4,4,0,73,73,0.0,1.0
5985,4,4,3,0,3,1.0,0.0
5967,4,4,0,76,76,0.0,1.0
6188,4,4,8,14,22,0.36363636363636365,0.6363636363636364
6041,4,4,0,12,12,0.0,1.0
5972,4,4,13,0,13,1.0,0.0
6069,4,4,1,3,4,0.25,0.75
5937,4,4,1,0,1,1.0,0.0
6028,4,4,15,16,31,0.4838709677419355,0.5161290322580645
5990,4,4,0,130,130,0.0,1.0
5928,4,4,27,454,481,0.056133056133056136,0.9438669438669439
5992,4,4,4,0,4,1.0,0.0
6058,4,4,12,1,13,0.9230769230769231,0.07692307692307693
6001,4,4,16,13,29,0.5517241379310345,0.4482758620689655
5964,4,4,18,13,31,0.5806451612903226,0.41935483870967744
5950,4,4,3,1,4,0.75,0.25
5991,4,4,5,3,8,0.625,0.375
6177,4,4,25,284,309,0.08090614886731391,0.919093851132686
5961,4,4,0,321,321,0.0,1.0
6176,4,4,0,93,93,0.0,1.0
5956,4,4,0,31,31,0.0,1.0
5938,4,4,6,633,639,0.009389671361502348,0.9906103286384976
6179,4,4,13,15,28,0.4642857142857143,0.5357142857142857
5947,4,4,25,35,60,0.4166666666666667,0.5833333333333334
5927,4,4,4,451,455,0.008791208791208791,0.9912087912087912
5977,4,4,2,304,306,0.006535947712418301,0.9934640522875817
6198,4,4,0,5,5,0.0,1.0
5957,4,4,0,45,45,0.0,1.0
6057,4,4,14,15,29,0.4827586206896552,0.5172413793103449
6043,4,4,8,0,8,1.0,0.0
6077,4,4,0,4,4,0.0,1.0
6014,4,4,10,4,14,0.7142857142857143,0.2857142857142857
6015,4,4,2,1,3,0.6666666666666666,0.3333333333333333
5978,4,4,3,0,3,1.0,0.0
5986,4,4,5,45,50,0.1,0.9
5959,4,4,29,330,359,0.0807799442896936,0.9192200557103064
6051,4,4,23,15,38,0.6052631578947368,0.39473684210526316
6029,4,4,1,2,3,0.3333333333333333,0.6666666666666666
6070,4,4,1,0,1,1.0,0.0
5942,4,4,0,145,145,0.0,1.0
5953,4,4,4,0,4,1.0,0.0
6076,4,4,5,2,7,0.7142857142857143,0.2857142857142857
5940,4,4,8,2,10,0.8,0.2
6109,4,4,14,79,93,0.15053763440860216,0.8494623655913979
6187,4,4,2,1,3,0.6666666666666666,0.3333333333333333
6053,4,4,0,17,17,0.0,1.0
6104,4,4,8,1,9,0.8888888888888888,0.1111111111111111
5943,4,4,2,0,2,1.0,0.0
6017,4,4,2,1,3,0.6666666666666666,0.3333333333333333
6168,4,4,8,8,16,0.5,0.5
5989,4,4,5,1,6,0.8333333333333334,0.16666666666666666
5963,4,4,6,0,6,1.0,0.0
6194,4,4,0,26,26,0.0,1.0
6167,4,4,11,8,19,0.5789473684210527,0.42105263157894735
6004,4,4,1,63,64,0.015625,0.984375
6030,4,4,6,1,7,0.8571428571428571,0.14285714285714285
6054,4,4,6,0,6,1.0,0.0
6032,4,4,10,2,12,0.8333333333333334,0.16666666666666666
6170,4,4,13,51,64,0.203125,0.796875
6063,4,4,3,0,3,1.0,0.0
5988,4,4,1,0,1,1.0,0.0
6075,4,4,3,0,3,1.0,0.0
6061,4,4,0,67,67,0.0,1.0
5965,4,4,16,33,49,0.32653061224489793,0.673469387755102
6040,4,4,8,2,10,0.8,0.2
6059,4,4,0,85,85,0.0,1.0
6106,4,4,9,54,63,0.14285714285714285,0.8571428571428571
6031,4,4,3,11,14,0.21428571428571427,0.7857142857142857
6180,4,4,0,6,6,0.0,1.0
6039,4,4,16,47,63,0.25396825396825395,0.746031746031746
6189,5,4,0,18,18,0.0,1.0
5936,5,4,5,1,6,0.8333333333333334,0.16666666666666666
6087,5,4,2,9,11,0.18181818181818182,0.8181818181818182
5973,5,4,4,844,848,0.0047169811320754715,0.9952830188679245
6085,5,4,6,6,12,0.5,0.5
6012,5,4,0,62,62,0.0,1.0
5982,5,4,0,6,6,0.0,1.0
5948,5,4,0,57,57,0.0,1.0
5974,5,4,3,3,6,0.5,0.5
6090,5,4,0,4,4,0.0,1.0
6068,5,4,3,0,3,1.0,0.0
5962,5,4,15,26,41,0.36585365853658536,0.6341463414634146
6033,5,4,0,1,1,0.0,1.0
6038,5,4,2,0,2,1.0,0.0
6042,5,4,18,79,97,0.18556701030927836,0.8144329896907216
5924,5,4,1,2,3,0.3333333333333333,0.6666666666666666
6083,5,4,0,27,27,0.0,1.0
6178,5,4,12,6,18,0.6666666666666666,0.3333333333333333
5958,5,4,4,0,4,1.0,0.0
6086,5,4,0,14,14,0.0,1.0
5945,5,4,8,11,19,0.42105263157894735,0.5789473684210527
5935,5,4,5,0,5,1.0,0.0
6073,5,4,11,4,15,0.7333333333333333,0.26666666666666666
5980,5,4,19,26,45,0.4222222222222222,0.5777777777777777
5993,5,4,15,468,483,0.031055900621118012,0.968944099378882
6037,5,4,9,214,223,0.04035874439461883,0.9596412556053812
5979,5,4,5,0,5,1.0,0.0
5966,5,4,0,73,73,0.0,1.0
5985,5,4,3,0,3,1.0,0.0
5967,5,4,0,76,76,0.0,1.0
6188,5,4,7,15,22,0.3181818181818182,0.6818181818181818
6041,5,4,0,12,12,0.0,1.0
5972,5,4,12,1,13,0.9230769230769231,0.07692307692307693
6069,5,4,0,4,4,0.0,1.0
5937,5,4,1,0,1,1.0,0.0
6028,5,4,9,22,31,0.2903225806451613,0.7096774193548387
5990,5,4,0,130,130,0.0,1.0
5928,5,4,16,465,481,0.033264033264033266,0.9667359667359667
5992,5,4,4,0,4,1.0,0.0
6058,5,4,12,1,13,0.9230769230769231,0.07692307692307693
6001,5,4,12,17,29,0.41379310344827586,0.5862068965517241
5964,5,4,17,14,31,0.5483870967741935,0.45161290322580644
5950,5,4,2,2,4,0.5,0.5
5991,5,4,5,3,8,0.625,0.375
6177,5,4,22,287,309,0.07119741100323625,0.9288025889967637
5961,5,4,0,321,321,0.0,1.0
6176,5,4,0,93,93,0.0,1.0
5956,5,4,0,31,31,0.0,1.0
5938,5,4,10,629,639,0.01564945226917058,0.9843505477308294
6179,5,4,8,20,28,0.2857142857142857,0.7142857142857143
5947,5,4,20,40,60,0.3333333333333333,0.6666666666666666
5927,5,4,3,452,455,0.006593406593406593,0.9934065934065934
5977,5,4,0,306,306,0.0,1.0
6198,5,4,0,5,5,0.0,1.0
5957,5,4,0,45,45,0.0,1.0
6057,5,4,11,18,29,0.3793103448275862,0.6206896551724138
6043,5,4,8,0,8,1.0,0.0
6077,5,4,0,4,4,0.0,1.0
6014,5,4,10,4,14,0.7142857142857143,0.2857142857142857
6015,5,4,1,2,3,0.3333333333333333,0.6666666666666666
5978,5,4,2,1,3,0.6666666666666666,0.3333333333333333
5986,5,4,5,45,50,0.1,0.9
5959,5,4,21,338,359,0.0584958217270195,0.9415041782729805
6051,5,4,17,21,38,0.4473684210526316,0.5526315789473685
6029,5,4,1,2,3,0.3333333333333333,0.6666666666666666
6070,5,4,1,0,1,1.0,0.0
5942,5,4,0,145,145,0.0,1.0
5953,5,4,4,0,4,1.0,0.0
6076,5,4,3,4,7,0.42857142857142855,0.5714285714285714
5940,5,4,6,4,10,0.6,0.4
6109,5,4,10,83,93,0.10752688172043011,0.8924731182795699
6187,5,4,2,1,3,0.6666666666666666,0.3333333333333333
6053,5,4,0,17,17,0.0,1.0
6104,5,4,7,2,9,0.7777777777777778,0.2222222222222222
5943,5,4,2,0,2,1.0,0.0
6017,5,4,3,0,3,1.0,0.0
6168,5,4,7,9,16,0.4375,0.5625
5989,5,4,5,1,6,0.8333333333333334,0.16666666666666666
5963,5,4,6,0,6,1.0,0.0
6194,5,4,0,26,26,0.0,1.0
6167,5,4,10,9,19,0.5263157894736842,0.47368421052631576
6004,5,4,1,63,64,0.015625,0.984375
6030,5,4,7,0,7,1.0,0.0
6054,5,4,5,1,6,0.8333333333333334,0.16666666666666666
6032,5,4,9,3,12,0.75,0.25
6170,5,4,21,43,64,0.328125,0.671875
6063,5,4,3,0,3,1.0,0.0
5988,5,4,1,0,1,1.0,0.0
6075,5,4,3,0,3,1.0,0.0
6061,5,4,0,67,67,0.0,1.0
5965,5,4,10,39,49,0.20408163265306123,0.7959183673469388
6040,5,4,8,2,10,0.8,0.2
6059,5,4,0,85,85,0.0,1.0
6106,5,4,5,58,63,0.07936507936507936,0.9206349206349206
6031,5,4,4,10,14,0.2857142857142857,0.7142857142857143
6180,5,4,0,6,6,0.0,1.0
6039,5,4,8,55,63,0.12698412698412698,0.873015873015873
6189,6,4,0,18,18,0.0,1.0
5936,6,4,5,1,6,0.8333333333333334,0.16666666666666666
6087,6,4,1,10,11,0.09090909090909091,0.9090909090909091
5973,6,4,0,848,848,0.0,1.0
6085,6,4,5,7,12,0.4166666666666667,0.5833333333333334
6012,6,4,0,62,62,0.0,1.0
5982,6,4,0,6,6,0.0,1.0
5948,6,4,0,57,57,0.0,1.0
5974,6,4,3,3,6,0.5,0.5
6090,6,4,0,4,4,0.0,1.0
6068,6,4,3,0,3,1.0,0.0
5962,6,4,15,26,41,0.36585365853658536,0.6341463414634146
6033,6,4,0,1,1,0.0,1.0
6038,6,4,2,0,2,1.0,0.0
6042,6,4,9,88,97,0.09278350515463918,0.9072164948453608
5924,6,4,1,2,3,0.3333333333333333,0.6666666666666666
6083,6,4,0,27,27,0.0,1.0
6178,6,4,11,7,18,0.6111111111111112,0.3888888888888889
5958,6,4,3,1,4,0.75,0.25
6086,6,4,0,14,14,0.0,1.0
5945,6,4,4,15,19,0.21052631578947367,0.7894736842105263
5935,6,4,4,1,5,0.8,0.2
6073,6,4,10,5,15,0.6666666666666666,0.3333333333333333
5980,6,4,17,28,45,0.37777777777777777,0.6222222222222222
5993,6,4,12,471,483,0.024844720496894408,0.9751552795031055
6037,6,4,5,218,223,0.02242152466367713,0.9775784753363229
5979,6,4,5,0,5,1.0,0.0
5966,6,4,0,73,73,0.0,1.0
5985,6,4,2,1,3,0.6666666666666666,0.3333333333333333
5967,6,4,0,76,76,0.0,1.0
6188,6,4,2,20,22,0.09090909090909091,0.9090909090909091
6041,6,4,0,12,12,0.0,1.0
5972,6,4,11,2,13,0.8461538461538461,0.15384615384615385
6069,6,4,2,2,4,0.5,0.5
5937,6,4,1,0,1,1.0,0.0
6028,6,4,8,23,31,0.25806451612903225,0.7419354838709677
5990,6,4,0,130,130,0.0,1.0
5928,6,4,13,468,481,0.02702702702702703,0.972972972972973
5992,6,4,3,1,4,0.75,0.25
6058,6,4,10,3,13,0.7692307692307693,0.23076923076923078
6001,6,4,11,18,29,0.3793103448275862,0.6206896551724138
5964,6,4,15,16,31,0.4838709677419355,0.5161290322580645
5950,6,4,3,1,4,0.75,0.25
5991,6,4,4,4,8,0.5,0.5
6177,6,4,10,299,309,0.032362459546925564,0.9676375404530745
5961,6,4,0,321,321,0.0,1.0
6176,6,4,0,93,93,0.0,1.0
5956,6,4,0,31,31,0.0,1.0
5938,6,4,7,632,639,0.010954616588419406,0.9890453834115805
6179,6,4,2,26,28,0.07142857142857142,0.9285714285714286
5947,6,4,11,49,60,0.18333333333333332,0.8166666666666667
5927,6,4,3,452,455,0.006593406593406593,0.9934065934065934
5977,6,4,2,304,306,0.006535947712418301,0.9934640522875817
6198,6,4,0,5,5,0.0,1.0
5957,6,4,0,45,45,0.0,1.0
6057,6,4,6,23,29,0.20689655172413793,0.7931034482758621
6043,6,4,8,0,8,1.0,0.0
6077,6,4,0,4,4,0.0,1.0
6014,6,4,10,4,14,0.7142857142857143,0.2857142857142857
6015,6,4,1,2,3,0.3333333333333333,0.6666666666666666
5978,6,4,2,1,3,0.6666666666666666,0.3333333333333333
5986,6,4,6,44,50,0.12,0.88
5959,6,4,12,347,359,0.033426183844011144,0.9665738161559888
6051,6,4,13,25,38,0.34210526315789475,0.6578947368421053
6029,6,4,2,1,3,0.6666666666666666,0.3333333333333333
6070,6,4,1,0,1,1.0,0.0
5942,6,4,0,145,145,0.0,1.0
5953,6,4,4,0,4,1.0,0.0
6076,6,4,6,1,7,0.8571428571428571,0.14285714285714285
5940,6,4,4,6,10,0.4,0.6
6109,6,4,8,85,93,0.08602150537634409,0.9139784946236559
6187,6,4,2,1,3,0.6666666666666666,0.3333333333333333
6053,6,4,0,17,17,0.0,1.0
6104,6,4,6,3,9,0.6666666666666666,0.3333333333333333
5943,6,4,2,0,2,1.0,0.0
6017,6,4,3,0,3,1.0,0.0
6168,6,4,8,8,16,0.5,0.5
5989,6,4,3,3,6,0.5,0.5
5963,6,4,6,0,6,1.0,0.0
6194,6,4,0,26,26,0.0,1.0
6167,6,4,8,11,19,0.42105263157894735,0.5789473684210527
6004,6,4,0,64,64,0.0,1.0
6030,6,4,6,1,7,0.8571428571428571,0.14285714285714285
6054,6,4,5,1,6,0.8333333333333334,0.16666666666666666
6032,6,4,9,3,12,0.75,0.25
6170,6,4,16,48,64,0.25,0.75
6063,6,4,3,0,3,1.0,0.0
5988,6,4,1,0,1,1.0,0.0
6075,6,4,3,0,3,1.0,0.0
6061,6,4,0,67,67,0.0,1.0
5965,6,4,14,35,49,0.2857142857142857,0.7142857142857143
6040,6,4,7,3,10,0.7,0.3
6059,6,4,0,85,85,0.0,1.0
6106,6,4,4,59,63,0.06349206349206349,0.9365079365079365
6031,6,4,7,7,14,0.5,0.5
6180,6,4,0,6,6,0.0,1.0
6039,6,4,10,53,63,0.15873015873015872,0.8412698412698413
6189,7,4,0,18,18,0.0,1.0
5936,7,4,4,2,6,0.6666666666666666,0.3333333333333333
6087,7,4,3,8,11,0.2727272727272727,0.7272727272727273
5973,7,4,0,848,848,0.0,1.0
6085,7,4,8,4,12,0.6666666666666666,0.3333333333333333
6012,7,4,0,62,62,0.0,1.0
5982,7,4,0,6,6,0.0,1.0
5948,7,4,0,57,57,0.0,1.0
5974,7,4,1,5,6,0.16666666666666666,0.8333333333333334
6090,7,4,0,4,4,0.0,1.0
6068,7,4,3,0,3,1.0,0.0
5962,7,4,10,31,41,0.24390243902439024,0.7560975609756098
6033,7,4,0,1,1,0.0,1.0
6038,7,4,2,0,2,1.0,0.0
6042,7,4,9,88,97,0.09278350515463918,0.9072164948453608
5924,7,4,1,2,3,0.3333333333333333,0.6666666666666666
6083,7,4,0,27,27,0.0,1.0
6178,7,4,8,10,18,0.4444444444444444,0.5555555555555556
5958,7,4,3,1,4,0.75,0.25
6086,7,4,0,14,14,0.0,1.0
5945,7,4,2,17,19,0.10526315789473684,0.8947368421052632
5935,7,4,4,1,5,0.8,0.2
6073,7,4,5,10,15,0.3333333333333333,0.6666666666666666
5980,7,4,12,33,45,0.26666666666666666,0.7333333333333333
5993,7,4,8,475,483,0.016563146997929608,0.9834368530020704
6037,7,4,5,218,223,0.02242152466367713,0.9775784753363229
5979,7,4,5,0,5,1.0,0.0
5966,7,4,0,73,73,0.0,1.0
5985,7,4,2,1,3,0.6666666666666666,0.3333333333333333
5967,7,4,0,76,76,0.0,1.0
6188,7,4,6,16,22,0.2727272727272727,0.7272727272727273
6041,7,4,0,12,12,0.0,1.0
5972,7,4,10,3,13,0.7692307692307693,0.23076923076923078
6069,7,4,1,3,4,0.25,0.75
5937,7,4,1,0,1,1.0,0.0
6028,7,4,10,21,31,0.3225806451612903,0.6774193548387096
5990,7,4,0,130,130,0.0,1.0
5928,7,4,11,470,481,0.02286902286902287,0.9771309771309772
5992,7,4,2,2,4,0.5,0.5
6058,7,4,7,6,13,0.5384615384615384,0.46153846153846156
6001,7,4,5,24,29,0.1724137931034483,0.8275862068965517
5964,7,4,13,18,31,0.41935483870967744,0.5806451612903226
5950,7,4,3,1,4,0.75,0.25
5991,7,4,4,4,8,0.5,0.5
6177,7,4,10,299,309,0.032362459546925564,0.9676375404530745
5961,7,4,0,321,321,0.0,1.0
6176,7,4,0,93,93,0.0,1.0
5956,7,4,0,31,31,0.0,1.0
5938,7,4,6,633,639,0.009389671361502348,0.9906103286384976
6179,7,4,6,22,28,0.21428571428571427,0.7857142857142857
5947,7,4,12,48,60,0.2,0.8
5927,7,4,2,453,455,0.004395604395604396,0.9956043956043956
5977,7,4,1,305,306,0.0032679738562091504,0.9967320261437909
6198,7,4,0,5,5,0.0,1.0
5957,7,4,0,45,45,0.0,1.0
6057,7,4,7,22,29,0.2413793103448276,0.7586206896551724
6043,7,4,8,0,8,1.0,0.0
6077,7,4,0,4,4,0.0,1.0
6014,7,4,7,7,14,0.5,0.5
6015,7,4,2,1,3,0.6666666666666666,0.3333333333333333
5978,7,4,1,2,3,0.3333333333333333,0.6666666666666666
5986,7,4,4,46,50,0.08,0.92
5959,7,4,10,349,359,0.027855153203342618,0.9721448467966574
6051,7,4,12,26,38,0.3157894736842105,0.6842105263157895
6029,7,4,1,2,3,0.3333333333333333,0.6666666666666666
6070,7,4,1,0,1,1.0,0.0
5942,7,4,0,145,145,0.0,1.0
5953,7,4,4,0,4,1.0,0.0
6076,7,4,3,4,7,0.42857142857142855,0.5714285714285714
5940,7,4,6,4,10,0.6,0.4
6109,7,4,7,86,93,0.07526881720430108,0.9247311827956989
6187,7,4,2,1,3,0.6666666666666666,0.3333333333333333
6053,7,4,0,17,17,0.0,1.0
6104,7,4,8,1,9,0.8888888888888888,0.1111111111111111
5943,7,4,2,0,2,1.0,0.0
6017,7,4,2,1,3,0.6666666666666666,0.3333333333333333
6168,7,4,5,11,16,0.3125,0.6875
5989,7,4,4,2,6,0.6666666666666666,0.3333333333333333
5963,7,4,6,0,6,1.0,0.0
6194,7,4,0,26,26,0.0,1.0
6167,7,4,7,12,19,0.3684210526315789,0.631578947368421
6004,7,4,1,63,64,0.015625,0.984375
6030,7,4,7,0,7,1.0,0.0
6054,7,4,5,1,6,0.8333333333333334,0.16666666666666666
6032,7,4,8,4,12,0.6666666666666666,0.3333333333333333
6170,7,4,11,53,64,0.171875,0.828125
6063,7,4,3,0,3,1.0,0.0
5988,7,4,1,0,1,1.0,0.0
6075,7,4,2,1,3,0.6666666666666666,0.3333333333333333
6061,7,4,0,67,67,0.0,1.0
5965,7,4,7,42,49,0.14285714285714285,0.8571428571428571
6040,7,4,8,2,10,0.8,0.2
6059,7,4,0,85,85,0.0,1.0
6106,7,4,2,61,63,0.031746031746031744,0.9682539682539683
6031,7,4,5,9,14,0.35714285714285715,0.6428571428571429
6180,7,4,0,6,6,0.0,1.0
6039,7,4,8,55,63,0.12698412698412698,0.873015873015873
6189,8,4,0,18,18,0.0,1.0
5936,8,4,3,3,6,0.5,0.5
6087,8,4,1,10,11,0.09090909090909091,0.9090909090909091
5973,8,4,1,847,848,0.0011792452830188679,0.9988207547169812
6085,8,4,6,6,12,0.5,0.5
6012,8,4,0,62,62,0.0,1.0
5982,8,4,0,6,6,0.0,1.0
5948,8,4,0,57,57,0.0,1.0
5974,8,4,4,2,6,0.6666666666666666,0.3333333333333333
6090,8,4,0,4,4,0.0,1.0
6068,8,4,3,0,3,1.0,0.0
5962,8,4,11,30,41,0.2682926829268293,0.7317073170731707
6033,8,4,0,1,1,0.0,1.0
6038,8,4,2,0,2,1.0,0.0
6042,8,4,6,91,97,0.061855670103092786,0.9381443298969072
5924,8,4,0,3,3,0.0,1.0
6083,8,4,0,27,27,0.0,1.0
6178,8,4,12,6,18,0.6666666666666666,0.3333333333333333
5958,8,4,4,0,4,1.0,0.0
6086,8,4,0,14,14,0.0,1.0
5945,8,4,2,17,19,0.10526315789473684,0.8947368421052632
5935,8,4,5,0,5,1.0,0.0
6073,8,4,8,7,15,0.5333333333333333,0.4666666666666667
5980,8,4,11,34,45,0.24444444444444444,0.7555555555555555
5993,8,4,5,478,483,0.010351966873706004,0.989648033126294
6037,8,4,5,218,223,0.02242152466367713,0.9775784753363229
5979,8,4,4,1,5,0.8,0.2
5966,8,4,0,73,73,0.0,1.0
5985,8,4,2,1,3,0.6666666666666666,0.3333333333333333
5967,8,4,0,76,76,0.0,1.0
6188,8,4,6,16,22,0.2727272727272727,0.7272727272727273
6041,8,4,0,12,12,0.0,1.0
5972,8,4,9,4,13,0.6923076923076923,0.3076923076923077
6069,8,4,2,2,4,0.5,0.5
5937,8,4,1,0,1,1.0,0.0
6028,8,4,4,27,31,0.12903225806451613,0.8709677419354839
5990,8,4,0,130,130,0.0,1.0
5928,8,4,10,471,481,0.02079002079002079,0.9792099792099792
5992,8,4,3,1,4,0.75,0.25
6058,8,4,6,7,13,0.46153846153846156,0.5384615384615384
6001,8,4,3,26,29,0.10344827586206896,0.896551724137931
5964,8,4,14,17,31,0.45161290322580644,0.5483870967741935
5950,8,4,3,1,4,0.75,0.25
5991,8,4,2,6,8,0.25,0.75
6177,8,4,12,297,309,0.038834951456310676,0.9611650485436893
5961,8,4,0,321,321,0.0,1.0
6176,8,4,0,93,93,0.0,1.0
5956,8,4,0,31,31,0.0,1.0
5938,8,4,7,632,639,0.010954616588419406,0.9890453834115805
6179,8,4,3,25,28,0.10714285714285714,0.8928571428571429
5947,8,4,11,49,60,0.18333333333333332,0.8166666666666667
5927,8,4,1,454,455,0.002197802197802198,0.9978021978021978
5977,8,4,1,305,306,0.0032679738562091504,0.9967320261437909
6198,8,4,0,5,5,0.0,1.0
5957,8,4,0,45,45,0.0,1.0
6057,8,4,2,27,29,0.06896551724137931,0.9310344827586207
6043,8,4,8,0,8,1.0,0.0
6077,8,4,0,4,4,0.0,1.0
6014,8,4,7,7,14,0.5,0.5
6015,8,4,3,0,3,1.0,0.0
5978,8,4,2,1,3,0.6666666666666666,0.3333333333333333
5986,8,4,4,46,50,0.08,0.92
5959,8,4,7,352,359,0.019498607242339833,0.9805013927576601
6051,8,4,9,29,38,0.23684210526315788,0.7631578947368421
6029,8,4,1,2,3,0.3333333333333333,0.6666666666666666
6070,8,4,1,0,1,1.0,0.0
5942,8,4,0,145,145,0.0,1.0
5953,8,4,4,0,4,1.0,0.0
6076,8,4,3,4,7,0.42857142857142855,0.5714285714285714
5940,8,4,5,5,10,0.5,0.5
6109,8,4,10,83,93,0.10752688172043011,0.8924731182795699
6187,8,4,2,1,3,0.6666666666666666,0.3333333333333333
6053,8,4,0,17,17,0.0,1.0
6104,8,4,8,1,9,0.8888888888888888,0.1111111111111111
5943,8,4,2,0,2,1.0,0.0
6017,8,4,2,1,3,0.6666666666666666,0.3333333333333333
6168,8,4,6,10,16,0.375,0.625
5989,8,4,2,4,6,0.3333333333333333,0.6666666666666666
5963,8,4,6,0,6,1.0,0.0
6194,8,4,0,26,26,0.0,1.0
6167,8,4,5,14,19,0.2631578947368421,0.7368421052631579
6004,8,4,1,63,64,0.015625,0.984375
6030,8,4,7,0,7,1.0,0.0
6054,8,4,5,1,6,0.8333333333333334,0.16666666666666666
6032,8,4,6,6,12,0.5,0.5
6170,8,4,12,52,64,0.1875,0.8125
6063,8,4,3,0,3,1.0,0.0
5988,8,4,1,0,1,1.0,0.0
6075,8,4,2,1,3,0.6666666666666666,0.3333333333333333
6061,8,4,0,67,67,0.0,1.0
5965,8,4,13,36,49,0.2653061224489796,0.7346938775510204
6040,8,4,5,5,10,0.5,0.5
6059,8,4,0,85,85,0.0,1.0
6106,8,4,3,60,63,0.047619047619047616,0.9523809523809523
6031,8,4,3,11,14,0.21428571428571427,0.7857142857142857
6180,8,4,0,6,6,0.0,1.0
6039,8,4,6,57,63,0.09523809523809523,0.9047619047619048
6189,9,4,0,18,18,0.0,1.0
5936,9,4,4,2,6,0.6666666666666666,0.3333333333333333
6087,9,4,2,9,11,0.18181818181818182,0.8181818181818182
5973,9,4,1,847,848,0.0011792452830188679,0.9988207547169812
6085,9,4,6,6,12,0.5,0.5
6012,9,4,0,62,62,0.0,1.0
5982,9,4,0,6,6,0.0,1.0
5948,9,4,0,57,57,0.0,1.0
5974,9,4,2,4,6,0.3333333333333333,0.6666666666666666
6090,9,4,0,4,4,0.0,1.0
6068,9,4,3,0,3,1.0,0.0
5962,9,4,9,32,41,0.21951219512195122,0.7804878048780488
6033,9,4,0,1,1,0.0,1.0
6038,9,4,2,0,2,1.0,0.0
6042,9,4,9,88,97,0.09278350515463918,0.9072164948453608
5924,9,4,1,2,3,0.3333333333333333,0.6666666666666666
6083,9,4,0,27,27,0.0,1.0
6178,9,4,8,10,18,0.4444444444444444,0.5555555555555556
5958,9,4,3,1,4,0.75,0.25
6086,9,4,0,14,14,0.0,1.0
5945,9,4,3,16,19,0.15789473684210525,0.8421052631578947
5935,9,4,5,0,5,1.0,0.0
6073,9,4,4,11,15,0.26666666666666666,0.7333333333333333
5980,9,4,10,35,45,0.2222222222222222,0.7777777777777778
5993,9,4,4,479,483,0.008281573498964804,0.9917184265010351
6037,9,4,6,217,223,0.026905829596412557,0.9730941704035875
5979,9,4,4,1,5,0.8,0.2
5966,9,4,0,73,73,0.0,1.0
5985,9,4,2,1,3,0.6666666666666666,0.3333333333333333
5967,9,4,0,76,76,0.0,1.0
6188,9,4,4,18,22,0.18181818181818182,0.8181818181818182
6041,9,4,0,12,12,0.0,1.0
5972,9,4,8,5,13,0.6153846153846154,0.38461538461538464
6069,9,4,0,4,4,0.0,1.0
5937,9,4,1,0,1,1.0,0.0
6028,9,4,4,27,31,0.12903225806451613,0.8709677419354839
5990,9,4,0,130,130,0.0,1.0
5928,9,4,12,469,481,0.02494802494802495,0.975051975051975
5992,9,4,2,2,4,0.5,0.5
6058,9,4,6,7,13,0.46153846153846156,0.5384615384615384
6001,9,4,6,23,29,0.20689655172413793,0.7931034482758621
5964,9,4,11,20,31,0.3548387096774194,0.6451612903225806
5950,9,4,3,1,4,0.75,0.25
5991,9,4,3,5,8,0.375,0.625
6177,9,4,6,303,309,0.019417475728155338,0.9805825242718447
5961,9,4,0,321,321,0.0,1.0
6176,9,4,0,93,93,0.0,1.0
5956,9,4,0,31,31,0.0,1.0
5938,9,4,5,634,639,0.00782472613458529,0.9921752738654147
6179,9,4,1,27,28,0.03571428571428571,0.9642857142857143
5947,9,4,11,49,60,0.18333333333333332,0.8166666666666667
5927,9,4,1,454,455,0.002197802197802198,0.9978021978021978
5977,9,4,0,306,306,0.0,1.0
6198,9,4,0,5,5,0.0,1.0
5957,9,4,0,45,45,0.0,1.0
6057,9,4,3,26,29,0.10344827586206896,0.896551724137931
6043,9,4,8,0,8,1.0,0.0
6077,9,4,0,4,4,0.0,1.0
6014,9,4,5,9,14,0.35714285714285715,0.6428571428571429
6015,9,4,2,1,3,0.6666666666666666,0.3333333333333333
5978,9,4,2,1,3,0.6666666666666666,0.3333333333333333
5986,9,4,2,48,50,0.04,0.96
5959,9,4,14,345,359,0.03899721448467967,0.9610027855153204
6051,9,4,8,30,38,0.21052631578947367,0.7894736842105263
6029,9,4,2,1,3,0.6666666666666666,0.3333333333333333
6070,9,4,1,0,1,1.0,0.0
5942,9,4,0,145,145,0.0,1.0
5953,9,4,3,1,4,0.75,0.25
6076,9,4,4,3,7,0.5714285714285714,0.42857142857142855
5940,9,4,3,7,10,0.3,0.7
6109,9,4,11,82,93,0.11827956989247312,0.8817204301075269
6187,9,4,3,0,3,1.0,0.0
6053,9,4,0,17,17,0.0,1.0
6104,9,4,8,1,9,0.8888888888888888,0.1111111111111111
5943,9,4,1,1,2,0.5,0.5
6017,9,4,2,1,3,0.6666666666666666,0.3333333333333333
6168,9,4,10,6,16,0.625,0.375
5989,9,4,3,3,6,0.5,0.5
5963,9,4,6,0,6,1.0,0.0
6194,9,4,0,26,26,0.0,1.0
6167,9,4,6,13,19,0.3157894736842105,0.6842105263157895
6004,9,4,1,63,64,0.015625,0.984375
6030,9,4,5,2,7,0.7142857142857143,0.2857142857142857
6054,9,4,1,5,6,0.16666666666666666,0.8333333333333334
6032,9,4,5,7,12,0.4166666666666667,0.5833333333333334
6170,9,4,11,53,64,0.171875,0.828125
6063,9,4,3,0,3,1.0,0.0
5988,9,4,1,0,1,1.0,0.0
6075,9,4,1,2,3,0.3333333333333333,0.6666666666666666
6061,9,4,0,67,67,0.0,1.0
5965,9,4,5,44,49,0.10204081632653061,0.8979591836734694
6040,9,4,6,4,10,0.6,0.4
6059,9,4,0,85,85,0.0,1.0
6106,9,4,2,61,63,0.031746031746031744,0.9682539682539683
6031,9,4,2,12,14,0.14285714285714285,0.8571428571428571
6180,9,4,0,6,6,0.0,1.0
6039,9,4,7,56,63,0.1111111111111111,0.8888888888888888
6189,10,4,0,18,18,0.0,1.0
5936,10,4,3,3,6,0.5,0.5
6087,10,4,2,9,11,0.18181818181818182,0.8181818181818182
5973,10,4,0,848,848,0.0,1.0
6085,10,4,4,8,12,0.3333333333333333,0.6666666666666666
6012,10,4,0,62,62,0.0,1.0
5982,10,4,1,5,6,0.16666666666666666,0.8333333333333334
5948,10,4,0,57,57,0.0,1.0
5974,10,4,2,4,6,0.3333333333333333,0.6666666666666666
6090,10,4,0,4,4,0.0,1.0
6068,10,4,3,0,3,1.0,0.0
5962,10,4,2,39,41,0.04878048780487805,0.9512195121951219
6033,10,4,0,1,1,0.0,1.0
6038,10,4,2,0,2,1.0,0.0
6042,10,4,5,92,97,0.05154639175257732,0.9484536082474226
5924,10,4,1,2,3,0.3333333333333333,0.6666666666666666
6083,10,4,0,27,27,0.0,1.0
6178,10,4,10,8,18,0.5555555555555556,0.4444444444444444
5958,10,4,3,1,4,0.75,0.25
6086,10,4,0,14,14,0.0,1.0
5945,10,4,2,17,19,0.10526315789473684,0.8947368421052632
5935,10,4,3,2,5,0.6,0.4
6073,10,4,4,11,15,0.26666666666666666,0.7333333333333333
5980,10,4,9,36,45,0.2,0.8
5993,10,4,5,478,483,0.010351966873706004,0.989648033126294
6037,10,4,4,219,223,0.017937219730941704,0.9820627802690582
5979,10,4,4,1,5,0.8,0.2
5966,10,4,0,73,73,0.0,1.0
5985,10,4,2,1,3,0.6666666666666666,0.3333333333333333
5967,10,4,0,76,76,0.0,1.0
6188,10,4,3,19,22,0.13636363636363635,0.8636363636363636
6041,10,4,0,12,12,0.0,1.0
5972,10,4,7,6,13,0.5384615384615384,0.46153846153846156
6069,10,4,1,3,4,0.25,0.75
5937,10,4,1,0,1,1.0,0.0
6028,10,4,6,25,31,0.1935483870967742,0.8064516129032258
5990,10,4,0,130,130,0.0,1.0
5928,10,4,6,475,481,0.012474012474012475,0.9875259875259875
5992,10,4,3,1,4,0.75,0.25
6058,10,4,5,8,13,0.38461538461538464,0.6153846153846154
6001,10,4,1,28,29,0.034482758620689655,0.9655172413793104
5964,10,4,11,20,31,0.3548387096774194,0.6451612903225806
5950,10,4,3,1,4,0.75,0.25
5991,10,4,1,7,8,0.125,0.875
6177,10,4,6,303,309,0.019417475728155338,0.9805825242718447
5961,10,4,0,321,321,0.0,1.0
6176,10,4,0,93,93,0.0,1.0
5956,10,4,0,31,31,0.0,1.0
5938,10,4,3,636,639,0.004694835680751174,0.9953051643192489
6179,10,4,4,24,28,0.14285714285714285,0.8571428571428571
5947,10,4,10,50,60,0.16666666666666666,0.8333333333333334
5927,10,4,1,454,455,0.002197802197802198,0.9978021978021978
5977,10,4,0,306,306,0.0,1.0
6198,10,4,0,5,5,0.0,1.0
5957,10,4,0,45,45,0.0,1.0
6057,10,4,6,23,29,0.20689655172413793,0.7931034482758621
6043,10,4,8,0,8,1.0,0.0
6077,10,4,0,4,4,0.0,1.0
6014,10,4,8,6,14,0.5714285714285714,0.42857142857142855
6015,10,4,3,0,3,1.0,0.0
5978,10,4,2,1,3,0.6666666666666666,0.3333333333333333
5986,10,4,2,48,50,0.04,0.96
5959,10,4,7,352,359,0.019498607242339833,0.9805013927576601
6051,10,4,8,30,38,0.21052631578947367,0.7894736842105263
6029,10,4,1,2,3,0.3333333333333333,0.6666666666666666
6070,10,4,1,0,1,1.0,0.0
5942,10,4,0,145,145,0.0,1.0
5953,10,4,4,0,4,1.0,0.0
6076,10,4,2,5,7,0.2857142857142857,0.7142857142857143
5940,10,4,2,8,10,0.2,0.8
6109,10,4,5,88,93,0.053763440860215055,0.946236559139785
6187,10,4,2,1,3,0.6666666666666666,0.3333333333333333
6053,10,4,0,17,17,0.0,1.0
6104,10,4,6,3,9,0.6666666666666666,0.3333333333333333
5943,10,4,1,1,2,0.5,0.5
6017,10,4,2,1,3,0.6666666666666666,0.3333333333333333
6168,10,4,6,10,16,0.375,0.625
5989,10,4,3,3,6,0.5,0.5
5963,10,4,6,0,6,1.0,0.0
6194,10,4,0,26,26,0.0,1.0
6167,10,4,9,10,19,0.47368421052631576,0.5263157894736842
6004,10,4,0,64,64,0.0,1.0
6030,10,4,6,1,7,0.8571428571428571,0.14285714285714285
6054,10,4,3,3,6,0.5,0.5
6032,10,4,8,4,12,0.6666666666666666,0.3333333333333333
6170,10,4,14,50,64,0.21875,0.78125
6063,10,4,3,0,3,1.0,0.0
5988,10,4,1,0,1,1.0,0.0
6075,10,4,1,2,3,0.3333333333333333,0.6666666666666666
6061,10,4,0,67,67,0.0,1.0
5965,10,4,3,46,49,0.061224489795918366,0.9387755102040817
6040,10,4,6,4,10,0.6,0.4
6059,10,4,0,85,85,0.0,1.0
6106,10,4,2,61,63,0.031746031746031744,0.9682539682539683
6031,10,4,3,11,14,0.21428571428571427,0.7857142857142857
6180,10,4,0,6,6,0.0,1.0
6039,10,4,3,60,63,0.047619047619047616,0.9523809523809523
6189,11,4,0,18,18,0.0,1.0
5936,11,4,3,3,6,0.5,0.5
6087,11,4,3,8,11,0.2727272727272727,0.7272727272727273
5973,11,4,1,847,848,0.0011792452830188679,0.9988207547169812
6085,11,4,3,9,12,0.25,0.75
6012,11,4,0,62,62,0.0,1.0
5982,11,4,0,6,6,0.0,1.0
5948,11,4,0,57,57,0.0,1.0
5974,11,4,3,3,6,0.5,0.5
6090,11,4,0,4,4,0.0,1.0
6068,11,4,3,0,3,1.0,0.0
5962,11,4,4,37,41,0.0975609756097561,0.9024390243902439
6033,11,4,0,1,1,0.0,1.0
6038,11,4,2,0,2,1.0,0.0
6042,11,4,4,93,97,0.041237113402061855,0.9587628865979382
5924,11,4,1,2,3,0.3333333333333333,0.6666666666666666
6083,11,4,0,27,27,0.0,1.0
6178,11,4,6,12,18,0.3333333333333333,0.6666666666666666
5958,11,4,2,2,4,0.5,0.5
6086,11,4,0,14,14,0.0,1.0
5945,11,4,1,18,19,0.05263157894736842,0.9473684210526315
5935,11,4,3,2,5,0.6,0.4
6073,11,4,6,9,15,0.4,0.6
5980,11,4,5,40,45,0.1111111111111111,0.8888888888888888
5993,11,4,2,481,483,0.004140786749482402,0.9958592132505176
6037,11,4,1,222,223,0.004484304932735426,0.9955156950672646
5979,11,4,4,1,5,0.8,0.2
5966,11,4,0,73,73,0.0,1.0
5985,11,4,1,2,3,0.3333333333333333,0.6666666666666666
5967,11,4,0,76,76,0.0,1.0
6188,11,4,5,17,22,0.22727272727272727,0.7727272727272727
6041,11,4,0,12,12,0.0,1.0
5972,11,4,5,8,13,0.38461538461538464,0.6153846153846154
6069,11,4,0,4,4,0.0,1.0
5937,11,4,1,0,1,1.0,0.0
6028,11,4,5,26,31,0.16129032258064516,0.8387096774193549
5990,11,4,0,130,130,0.0,1.0
5928,11,4,6,475,481,0.012474012474012475,0.9875259875259875
5992,11,4,2,2,4,0.5,0.5
6058,11,4,5,8,13,0.38461538461538464,0.6153846153846154
6001,11,4,1,28,29,0.034482758620689655,0.9655172413793104
5964,11,4,9,22,31,0.2903225806451613,0.7096774193548387
5950,11,4,2,2,4,0.5,0.5
5991,11,4,2,6,8,0.25,0.75
6177,11,4,3,306,309,0.009708737864077669,0.9902912621359223
5961,11,4,0,321,321,0.0,1.0
6176,11,4,0,93,93,0.0,1.0
5956,11,4,0,31,31,0.0,1.0
5938,11,4,1,638,639,0.001564945226917058,0.9984350547730829
6179,11,4,2,26,28,0.07142857142857142,0.9285714285714286
5947,11,4,9,51,60,0.15,0.85
5927,11,4,1,454,455,0.002197802197802198,0.9978021978021978
5977,11,4,0,306,306,0.0,1.0
6198,11,4,0,5,5,0.0,1.0
5957,11,4,0,45,45,0.0,1.0
6057,11,4,0,29,29,0.0,1.0
6043,11,4,8,0,8,1.0,0.0
6077,11,4,0,4,4,0.0,1.0
6014,11,4,3,11,14,0.21428571428571427,0.7857142857142857
6015,11,4,2,1,3,0.6666666666666666,0.3333333333333333
5978,11,4,2,1,3,0.6666666666666666,0.3333333333333333
5986,11,4,3,47,50,0.06,0.94
5959,11,4,2,357,359,0.005571030640668524,0.9944289693593314
6051,11,4,6,32,38,0.15789473684210525,0.8421052631578947
6029,11,4,1,2,3,0.3333333333333333,0.6666666666666666
6070,11,4,1,0,1,1.0,0.0
5942,11,4,0,145,145,0.0,1.0
5953,11,4,4,0,4,1.0,0.0
6076,11,4,3,4,7,0.42857142857142855,0.5714285714285714
5940,11,4,5,5,10,0.5,0.5
6109,11,4,2,91,93,0.021505376344086023,0.978494623655914
6187,11,4,1,2,3,0.3333333333333333,0.6666666666666666
6053,11,4,0,17,17,0.0,1.0
6104,11,4,5,4,9,0.5555555555555556,0.4444444444444444
5943,11,4,1,1,2,0.5,0.5
6017,11,4,3,0,3,1.0,0.0
6168,11,4,5,11,16,0.3125,0.6875
5989,11,4,2,4,6,0.3333333333333333,0.6666666666666666
5963,11,4,6,0,6,1.0,0.0
6194,11,4,0,26,26,0.0,1.0
6167,11,4,5,14,19,0.2631578947368421,0.7368421052631579
6004,11,4,0,64,64,0.0,1.0
6030,11,4,6,1,7,0.8571428571428571,0.14285714285714285
6054,11,4,3,3,6,0.5,0.5
6032,11,4,2,10,12,0.16666666666666666,0.8333333333333334
6170,11,4,10,54,64,0.15625,0.84375
6063,11,4,3,0,3,1.0,0.0
5988,11,4,1,0,1,1.0,0.0
6075,11,4,0,3,3,0.0,1.0
6061,11,4,0,67,67,0.0,1.0
5965,11,4,4,45,49,0.08163265306122448,0.9183673469387755
6040,11,4,6,4,10,0.6,0.4
6059,11,4,0,85,85,0.0,1.0
6106,11,4,1,62,63,0.015873015873015872,0.9841269841269841
6031,11,4,4,10,14,0.2857142857142857,0.7142857142857143
6180,11,4,0,6,6,0.0,1.0
6039,11,4,4,59,63,0.06349206349206349,0.9365079365079365
6189,12,4,0,18,18,0.0,1.0
5936,12,4,3,3,6,0.5,0.5
6087,12,4,1,10,11,0.09090909090909091,0.9090909090909091
5973,12,4,0,848,848,0.0,1.0
6085,12,4,5,7,12,0.4166666666666667,0.5833333333333334
6012,12,4,0,62,62,0.0,1.0
5982,12,4,1,5,6,0.16666666666666666,0.8333333333333334
5948,12,4,0,57,57,0.0,1.0
5974,12,4,2,4,6,0.3333333333333333,0.6666666666666666
6090,12,4,0,4,4,0.0,1.0
6068,12,4,3,0,3,1.0,0.0
5962,12,4,3,38,41,0.07317073170731707,0.926829268292683
6033,12,4,0,1,1,0.0,1.0
6038,12,4,2,0,2,1.0,0.0
6042,12,4,7,90,97,0.07216494845360824,0.9278350515463918
5924,12,4,1,2,3,0.3333333333333333,0.6666666666666666
6083,12,4,0,27,27,0.0,1.0
6178,12,4,8,10,18,0.4444444444444444,0.5555555555555556
5958,12,4,4,0,4,1.0,0.0
6086,12,4,0,14,14,0.0,1.0
5945,12,4,1,18,19,0.05263157894736842,0.9473684210526315
5935,12,4,4,1,5,0.8,0.2
6073,12,4,4,11,15,0.26666666666666666,0.7333333333333333
5980,12,4,4,41,45,0.08888888888888889,0.9111111111111111
5993,12,4,5,478,483,0.010351966873706004,0.989648033126294
6037,12,4,2,221,223,0.008968609865470852,0.9910313901345291
5979,12,4,3,2,5,0.6,0.4
5966,12,4,0,73,73,0.0,1.0
5985,12,4,1,2,3,0.3333333333333333,0.6666666666666666
5967,12,4,0,76,76,0.0,1.0
6188,12,4,4,18,22,0.18181818181818182,0.8181818181818182
6041,12,4,0,12,12,0.0,1.0
5972,12,4,8,5,13,0.6153846153846154,0.38461538461538464
6069,12,4,1,3,4,0.25,0.75
5937,12,4,1,0,1,1.0,0.0
6028,12,4,4,27,31,0.12903225806451613,0.8709677419354839
5990,12,4,0,130,130,0.0,1.0
5928,12,4,5,476,481,0.010395010395010396,0.9896049896049897
5992,12,4,3,1,4,0.75,0.25
6058,12,4,3,10,13,0.23076923076923078,0.7692307692307693
6001,12,4,1,28,29,0.034482758620689655,0.9655172413793104
5964,12,4,8,23,31,0.25806451612903225,0.7419354838709677
5950,12,4,1,3,4,0.25,0.75
5991,12,4,1,7,8,0.125,0.875
6177,12,4,0,309,309,0.0,1.0
5961,12,4,0,321,321,0.0,1.0
6176,12,4,0,93,93,0.0,1.0
5956,12,4,0,31,31,0.0,1.0
5938,12,4,1,638,639,0.001564945226917058,0.9984350547730829
6179,12,4,3,25,28,0.10714285714285714,0.8928571428571429
5947,12,4,7,53,60,0.11666666666666667,0.8833333333333333
5927,12,4,0,455,455,0.0,1.0
5977,12,4,0,306,306,0.0,1.0
6198,12,4,0,5,5,0.0,1.0
5957,12,4,0,45,45,0.0,1.0
6057,12,4,2,27,29,0.06896551724137931,0.9310344827586207
6043,12,4,7,1,8,0.875,0.125
6077,12,4,0,4,4,0.0,1.0
6014,12,4,7,7,14,0.5,0.5
6015,12,4,2,1,3,0.6666666666666666,0.3333333333333333
5978,12,4,2,1,3,0.6666666666666666,0.3333333333333333
5986,12,4,1,49,50,0.02,0.98
5959,12,4,1,358,359,0.002785515320334262,0.9972144846796658
6051,12,4,4,34,38,0.10526315789473684,0.8947368421052632
6029,12,4,0,3,3,0.0,1.0
6070,12,4,1,0,1,1.0,0.0
5942,12,4,0,145,145,0.0,1.0
5953,12,4,2,2,4,0.5,0.5
6076,12,4,1,6,7,0.14285714285714285,0.8571428571428571
5940,12,4,3,7,10,0.3,0.7
6109,12,4,4,89,93,0.043010752688172046,0.956989247311828
6187,12,4,1,2,3,0.3333333333333333,0.6666666666666666
6053,12,4,0,17,17,0.0,1.0
6104,12,4,4,5,9,0.4444444444444444,0.5555555555555556
5943,12,4,1,1,2,0.5,0.5
6017,12,4,2,1,3,0.6666666666666666,0.3333333333333333
6168,12,4,3,13,16,0.1875,0.8125
5989,12,4,1,5,6,0.16666666666666666,0.8333333333333334
5963,12,4,6,0,6,1.0,0.0
6194,12,4,0,26,26,0.0,1.0
6167,12,4,5,14,19,0.2631578947368421,0.7368421052631579
6004,12,4,0,64,64,0.0,1.0
6030,12,4,6,1,7,0.8571428571428571,0.14285714285714285
6054,12,4,2,4,6,0.3333333333333333,0.6666666666666666
6032,12,4,4,8,12,0.3333333333333333,0.6666666666666666
6170,12,4,7,57,64,0.109375,0.890625
6063,12,4,3,0,3,1.0,0.0
5988,12,4,1,0,1,1.0,0.0
6075,12,4,0,3,3,0.0,1.0
6061,12,4,0,67,67,0.0,1.0
5965,12,4,1,48,49,0.02040816326530612,0.9795918367346939
6040,12,4,7,3,10,0.7,0.3
6059,12,4,0,85,85,0.0,1.0
6106,12,4,1,62,63,0.015873015873015872,0.9841269841269841
6031,12,4,4,10,14,0.2857142857142857,0.7142857142857143
6180,12,4,0,6,6,0.0,1.0
6039,12,4,5,58,63,0.07936507936507936,0.9206349206349206
6189,13,4,0,18,18,0.0,1.0
5936,13,4,3,3,6,0.5,0.5
6087,13,4,4,7,11,0.36363636363636365,0.6363636363636364
5973,13,4,0,848,848,0.0,1.0
6085,13,4,8,4,12,0.6666666666666666,0.3333333333333333
6012,13,4,0,62,62,0.0,1.0
5982,13,4,1,5,6,0.16666666666666666,0.8333333333333334
5948,13,4,0,57,57,0.0,1.0
5974,13,4,2,4,6,0.3333333333333333,0.6666666666666666
6090,13,4,0,4,4,0.0,1.0
6068,13,4,3,0,3,1.0,0.0
5962,13,4,1,40,41,0.024390243902439025,0.975609756097561
6033,13,4,0,1,1,0.0,1.0
6038,13,4,2,0,2,1.0,0.0
6042,13,4,5,92,97,0.05154639175257732,0.9484536082474226
5924,13,4,2,1,3,0.6666666666666666,0.3333333333333333
6083,13,4,0,27,27,0.0,1.0
6178,13,4,4,14,18,0.2222222222222222,0.7777777777777778
5958,13,4,4,0,4,1.0,0.0
6086,13,4,0,14,14,0.0,1.0
5945,13,4,1,18,19,0.05263157894736842,0.9473684210526315
5935,13,4,2,3,5,0.4,0.6
6073,13,4,4,11,15,0.26666666666666666,0.7333333333333333
5980,13,4,2,43,45,0.044444444444444446,0.9555555555555556
5993,13,4,3,480,483,0.006211180124223602,0.9937888198757764
6037,13,4,2,221,223,0.008968609865470852,0.9910313901345291
5979,13,4,3,2,5,0.6,0.4
5966,13,4,0,73,73,0.0,1.0
5985,13,4,1,2,3,0.3333333333333333,0.6666666666666666
5967,13,4,0,76,76,0.0,1.0
6188,13,4,2,20,22,0.09090909090909091,0.9090909090909091
6041,13,4,0,12,12,0.0,1.0
5972,13,4,9,4,13,0.6923076923076923,0.3076923076923077
6069,13,4,1,3,4,0.25,0.75
5937,13,4,1,0,1,1.0,0.0
6028,13,4,4,27,31,0.12903225806451613,0.8709677419354839
5990,13,4,0,130,130,0.0,1.0
5928,13,4,2,479,481,0.004158004158004158,0.9958419958419958
5992,13,4,2,2,4,0.5,0.5
6058,13,4,5,8,13,0.38461538461538464,0.6153846153846154
6001,13,4,2,27,29,0.06896551724137931,0.9310344827586207
5964,13,4,6,25,31,0.1935483870967742,0.8064516129032258
5950,13,4,2,2,4,0.5,0.5
5991,13,4,2,6,8,0.25,0.75
6177,13,4,1,308,309,0.003236245954692557,0.9967637540453075
5961,13,4,0,321,321,0.0,1.0
6176,13,4,0,93,93,0.0,1.0
5956,13,4,0,31,31,0.0,1.0
5938,13,4,2,637,639,0.003129890453834116,0.9968701095461658
6179,13,4,3,25,28,0.10714285714285714,0.8928571428571429
5947,13,4,6,54,60,0.1,0.9
5927,13,4,0,455,455,0.0,1.0
5977,13,4,1,305,306,0.0032679738562091504,0.9967320261437909
6198,13,4,0,5,5,0.0,1.0
5957,13,4,0,45,45,0.0,1.0
6057,13,4,2,27,29,0.06896551724137931,0.9310344827586207
6043,13,4,7,1,8,0.875,0.125
6077,13,4,0,4,4,0.0,1.0
6014,13,4,4,10,14,0.2857142857142857,0.7142857142857143
6015,13,4,2,1,3,0.6666666666666666,0.3333333333333333
5978,13,4,2,1,3,0.6666666666666666,0.3333333333333333
5986,13,4,1,49,50,0.02,0.98
5959,13,4,3,356,359,0.008356545961002786,0.9916434540389972
6051,13,4,0,38,38,0.0,1.0
6029,13,4,1,2,3,0.3333333333333333,0.6666666666666666
6070,13,4,1,0,1,1.0,0.0
5942,13,4,0,145,145,0.0,1.0
5953,13,4,3,1,4,0.75,0.25
6076,13,4,2,5,7,0.2857142857142857,0.7142857142857143
5940,13,4,3,7,10,0.3,0.7
6109,13,4,4,89,93,0.043010752688172046,0.956989247311828
6187,13,4,0,3,3,0.0,1.0
6053,13,4,0,17,17,0.0,1.0
6104,13,4,4,5,9,0.4444444444444444,0.5555555555555556
5943,13,4,0,2,2,0.0,1.0
6017,13,4,2,1,3,0.6666666666666666,0.3333333333333333
6168,13,4,5,11,16,0.3125,0.6875
5989,13,4,0,6,6,0.0,1.0
5963,13,4,5,1,6,0.8333333333333334,0.16666666666666666
6194,13,4,0,26,26,0.0,1.0
6167,13,4,3,16,19,0.15789473684210525,0.8421052631578947
6004,13,4,0,64,64,0.0,1.0
6030,13,4,6,1,7,0.8571428571428571,0.14285714285714285
6054,13,4,2,4,6,0.3333333333333333,0.6666666666666666
6032,13,4,8,4,12,0.6666666666666666,0.3333333333333333
6170,13,4,10,54,64,0.15625,0.84375
6063,13,4,3,0,3,1.0,0.0
5988,13,4,1,0,1,1.0,0.0
6075,13,4,0,3,3,0.0,1.0
6061,13,4,0,67,67,0.0,1.0
5965,13,4,3,46,49,0.061224489795918366,0.9387755102040817
6040,13,4,4,6,10,0.4,0.6
6059,13,4,0,85,85,0.0,1.0
6106,13,4,0,63,63,0.0,1.0
6031,13,4,5,9,14,0.35714285714285715,0.6428571428571429
6180,13,4,0,6,6,0.0,1.0
6039,13,4,4,59,63,0.06349206349206349,0.9365079365079365
6189,14,4,0,18,18,0.0,1.0
5936,14,4,2,4,6,0.3333333333333333,0.6666666666666666
6087,14,4,2,9,11,0.18181818181818182,0.8181818181818182
5973,14,4,1,847,848,0.0011792452830188679,0.9988207547169812
6085,14,4,1,11,12,0.08333333333333333,0.9166666666666666
6012,14,4,0,62,62,0.0,1.0
5982,14,4,0,6,6,0.0,1.0
5948,14,4,0,57,57,0.0,1.0
5974,14,4,2,4,6,0.3333333333333333,0.6666666666666666
6090,14,4,0,4,4,0.0,1.0
6068,14,4,3,0,3,1.0,0.0
5962,14,4,2,39,41,0.04878048780487805,0.9512195121951219
6033,14,4,0,1,1,0.0,1.0
6038,14,4,1,1,2,0.5,0.5
6042,14,4,6,91,97,0.061855670103092786,0.9381443298969072
5924,14,4,1,2,3,0.3333333333333333,0.6666666666666666
6083,14,4,0,27,27,0.0,1.0
6178,14,4,6,12,18,0.3333333333333333,0.6666666666666666
5958,14,4,2,2,4,0.5,0.5
6086,14,4,0,14,14,0.0,1.0
5945,14,4,1,18,19,0.05263157894736842,0.9473684210526315
5935,14,4,0,5,5,0.0,1.0
6073,14,4,1,14,15,0.06666666666666667,0.9333333333333333
5980,14,4,1,44,45,0.022222222222222223,0.9777777777777777
5993,14,4,0,483,483,0.0,1.0
6037,14,4,4,219,223,0.017937219730941704,0.9820627802690582
5979,14,4,3,2,5,0.6,0.4
5966,14,4,0,73,73,0.0,1.0
5985,14,4,1,2,3,0.3333333333333333,0.6666666666666666
5967,14,4,0,76,76,0.0,1.0
6188,14,4,3,19,22,0.13636363636363635,0.8636363636363636
6041,14,4,0,12,12,0.0,1.0
5972,14,4,4,9,13,0.3076923076923077,0.6923076923076923
6069,14,4,1,3,4,0.25,0.75
5937,14,4,1,0,1,1.0,0.0
6028,14,4,4,27,31,0.12903225806451613,0.8709677419354839
5990,14,4,0,130,130,0.0,1.0
5928,14,4,3,478,481,0.006237006237006237,0.9937629937629938
5992,14,4,2,2,4,0.5,0.5
6058,14,4,2,11,13,0.15384615384615385,0.8461538461538461
6001,14,4,1,28,29,0.034482758620689655,0.9655172413793104
5964,14,4,4,27,31,0.12903225806451613,0.8709677419354839
5950,14,4,1,3,4,0.25,0.75
5991,14,4,2,6,8,0.25,0.75
6177,14,4,2,307,309,0.006472491909385114,0.9935275080906149
5961,14,4,0,321,321,0.0,1.0
6176,14,4,0,93,93,0.0,1.0
5956,14,4,0,31,31,0.0,1.0
5938,14,4,0,639,639,0.0,1.0
6179,14,4,0,28,28,0.0,1.0
5947,14,4,10,50,60,0.16666666666666666,0.8333333333333334
5927,14,4,1,454,455,0.002197802197802198,0.9978021978021978
5977,14,4,0,306,306,0.0,1.0
6198,14,4,0,5,5,0.0,1.0
5957,14,4,0,45,45,0.0,1.0
6057,14,4,1,28,29,0.034482758620689655,0.9655172413793104
6043,14,4,7,1,8,0.875,0.125
6077,14,4,0,4,4,0.0,1.0
6014,14,4,5,9,14,0.35714285714285715,0.6428571428571429
6015,14,4,1,2,3,0.3333333333333333,0.6666666666666666
5978,14,4,0,3,3,0.0,1.0
5986,14,4,4,46,50,0.08,0.92
5959,14,4,2,357,359,0.005571030640668524,0.9944289693593314
6051,14,4,4,34,38,0.10526315789473684,0.8947368421052632
6029,14,4,1,2,3,0.3333333333333333,0.6666666666666666
6070,14,4,1,0,1,1.0,0.0
5942,14,4,0,145,145,0.0,1.0
5953,14,4,4,0,4,1.0,0.0
6076,14,4,1,6,7,0.14285714285714285,0.8571428571428571
5940,14,4,2,8,10,0.2,0.8
6109,14,4,4,89,93,0.043010752688172046,0.956989247311828
6187,14,4,1,2,3,0.3333333333333333,0.6666666666666666
6053,14,4,0,17,17,0.0,1.0
6104,14,4,5,4,9,0.5555555555555556,0.4444444444444444
5943,14,4,1,1,2,0.5,0.5
6017,14,4,2,1,3,0.6666666666666666,0.3333333333333333
6168,14,4,2,14,16,0.125,0.875
5989,14,4,1,5,6,0.16666666666666666,0.8333333333333334
5963,14,4,6,0,6,1.0,0.0
6194,14,4,0,26,26,0.0,1.0
6167,14,4,4,15,19,0.21052631578947367,0.7894736842105263
6004,14,4,0,64,64,0.0,1.0
6030,14,4,6,1,7,0.8571428571428571,0.14285714285714285
6054,14,4,2,4,6,0.3333333333333333,0.6666666666666666
6032,14,4,4,8,12,0.3333333333333333,0.6666666666666666
6170,14,4,4,60,64,0.0625,0.9375
6063,14,4,3,0,3,1.0,0.0
5988,14,4,1,0,1,1.0,0.0
6075,14,4,3,0,3,1.0,0.0
6061,14,4,0,67,67,0.0,1.0
5965,14,4,1,48,49,0.02040816326530612,0.9795918367346939
6040,14,4,4,6,10,0.4,0.6
6059,14,4,0,85,85,0.0,1.0
6106,14,4,2,61,63,0.031746031746031744,0.9682539682539683
6031,14,4,3,11,14,0.21428571428571427,0.7857142857142857
6180,14,4,0,6,6,0.0,1.0
6039,14,4,2,61,63,0.031746031746031744,0.9682539682539683
6189,15,4,0,18,18,0.0,1.0
5936,15,4,1,5,6,0.16666666666666666,0.8333333333333334
6087,15,4,3,8,11,0.2727272727272727,0.7272727272727273
5973,15,4,0,848,848,0.0,1.0
6085,15,4,7,5,12,0.5833333333333334,0.4166666666666667
6012,15,4,0,62,62,0.0,1.0
5982,15,4,1,5,6,0.16666666666666666,0.8333333333333334
5948,15,4,0,57,57,0.0,1.0
5974,15,4,4,2,6,0.6666666666666666,0.3333333333333333
6090,15,4,0,4,4,0.0,1.0
6068,15,4,3,0,3,1.0,0.0
5962,15,4,2,39,41,0.04878048780487805,0.9512195121951219
6033,15,4,0,1,1,0.0,1.0
6038,15,4,2,0,2,1.0,0.0
6042,15,4,6,91,97,0.061855670103092786,0.9381443298969072
5924,15,4,1,2,3,0.3333333333333333,0.6666666666666666
6083,15,4,0,27,27,0.0,1.0
6178,15,4,4,14,18,0.2222222222222222,0.7777777777777778
5958,15,4,3,1,4,0.75,0.25
6086,15,4,0,14,14,0.0,1.0
5945,15,4,1,18,19,0.05263157894736842,0.9473684210526315
5935,15,4,0,5,5,0.0,1.0
6073,15,4,3,12,15,0.2,0.8
5980,15,4,2,43,45,0.044444444444444446,0.9555555555555556
5993,15,4,4,479,483,0.008281573498964804,0.9917184265010351
6037,15,4,0,223,223,0.0,1.0
5979,15,4,3,2,5,0.6,0.4
5966,15,4,0,73,73,0.0,1.0
5985,15,4,0,3,3,0.0,1.0
5967,15,4,0,76,76,0.0,1.0
6188,15,4,0,22,22,0.0,1.0
6041,15,4,0,12,12,0.0,1.0
5972,15,4,6,7,13,0.46153846153846156,0.5384615384615384
6069,15,4,1,3,4,0.25,0.75
5937,15,4,1,0,1,1.0,0.0
6028,15,4,4,27,31,0.12903225806451613,0.8709677419354839
5990,15,4,0,130,130,0.0,1.0
5928,15,4,1,480,481,0.002079002079002079,0.997920997920998
5992,15,4,2,2,4,0.5,0.5
6058,15,4,2,11,13,0.15384615384615385,0.8461538461538461
6001,15,4,1,28,29,0.034482758620689655,0.9655172413793104
5964,15,4,4,27,31,0.12903225806451613,0.8709677419354839
5950,15,4,1,3,4,0.25,0.75
5991,15,4,2,6,8,0.25,0.75
6177,15,4,8,301,309,0.025889967637540454,0.9741100323624595
5961,15,4,0,321,321,0.0,1.0
6176,15,4,0,93,93,0.0,1.0
5956,15,4,0,31,31,0.0,1.0
5938,15,4,1,638,639,0.001564945226917058,0.9984350547730829
6179,15,4,0,28,28,0.0,1.0
5947,15,4,3,57,60,0.05,0.95
5927,15,4,1,454,455,0.002197802197802198,0.9978021978021978
5977,15,4,0,306,306,0.0,1.0
6198,15,4,0,5,5,0.0,1.0
5957,15,4,0,45,45,0.0,1.0
6057,15,4,5,24,29,0.1724137931034483,0.8275862068965517
6043,15,4,6,2,8,0.75,0.25
6077,15,4,0,4,4,0.0,1.0
6014,15,4,3,11,14,0.21428571428571427,0.7857142857142857
6015,15,4,2,1,3,0.6666666666666666,0.3333333333333333
5978,15,4,1,2,3,0.3333333333333333,0.6666666666666666
5986,15,4,1,49,50,0.02,0.98
5959,15,4,4,355,359,0.011142061281337047,0.9888579387186629
6051,15,4,5,33,38,0.13157894736842105,0.868421052631579
6029,15,4,1,2,3,0.3333333333333333,0.6666666666666666
6070,15,4,0,1,1,0.0,1.0
5942,15,4,0,145,145,0.0,1.0
5953,15,4,3,1,4,0.75,0.25
6076,15,4,1,6,7,0.14285714285714285,0.8571428571428571
5940,15,4,2,8,10,0.2,0.8
6109,15,4,3,90,93,0.03225806451612903,0.967741935483871
6187,15,4,1,2,3,0.3333333333333333,0.6666666666666666
6053,15,4,0,17,17,0.0,1.0
6104,15,4,2,7,9,0.2222222222222222,0.7777777777777778
5943,15,4,1,1,2,0.5,0.5
6017,15,4,3,0,3,1.0,0.0
6168,15,4,2,14,16,0.125,0.875
5989,15,4,0,6,6,0.0,1.0
5963,15,4,5,1,6,0.8333333333333334,0.16666666666666666
6194,15,4,0,26,26,0.0,1.0
6167,15,4,3,16,19,0.15789473684210525,0.8421052631578947
6004,15,4,0,64,64,0.0,1.0
6030,15,4,7,0,7,1.0,0.0
6054,15,4,1,5,6,0.16666666666666666,0.8333333333333334
6032,15,4,4,8,12,0.3333333333333333,0.6666666666666666
6170,15,4,5,59,64,0.078125,0.921875
6063,15,4,3,0,3,1.0,0.0
5988,15,4,1,0,1,1.0,0.0
6075,15,4,0,3,3,0.0,1.0
6061,15,4,0,67,67,0.0,1.0
5965,15,4,2,47,49,0.04081632653061224,0.9591836734693877
6040,15,4,4,6,10,0.4,0.6
6059,15,4,0,85,85,0.0,1.0
6106,15,4,1,62,63,0.015873015873015872,0.9841269841269841
6031,15,4,4,10,14,0.2857142857142857,0.7142857142857143
6180,15,4,0,6,6,0.0,1.0
6039,15,4,1,62,63,0.015873015873015872,0.9841269841269841
6189,16,4,0,18,18,0.0,1.0
5936,16,4,2,4,6,0.3333333333333333,0.6666666666666666
6087,16,4,2,9,11,0.18181818181818182,0.8181818181818182
5973,16,4,1,847,848,0.0011792452830188679,0.9988207547169812
6085,16,4,3,9,12,0.25,0.75
6012,16,4,0,62,62,0.0,1.0
5982,16,4,1,5,6,0.16666666666666666,0.8333333333333334
5948,16,4,0,57,57,0.0,1.0
5974,16,4,2,4,6,0.3333333333333333,0.6666666666666666
6090,16,4,0,4,4,0.0,1.0
6068,16,4,2,1,3,0.6666666666666666,0.3333333333333333
5962,16,4,2,39,41,0.04878048780487805,0.9512195121951219
6033,16,4,0,1,1,0.0,1.0
6038,16,4,2,0,2,1.0,0.0
6042,16,4,2,95,97,0.020618556701030927,0.979381443298969
5924,16,4,0,3,3,0.0,1.0
6083,16,4,0,27,27,0.0,1.0
6178,16,4,4,14,18,0.2222222222222222,0.7777777777777778
5958,16,4,3,1,4,0.75,0.25
6086,16,4,0,14,14,0.0,1.0
5945,16,4,1,18,19,0.05263157894736842,0.9473684210526315
5935,16,4,3,2,5,0.6,0.4
6073,16,4,4,11,15,0.26666666666666666,0.7333333333333333
5980,16,4,2,43,45,0.044444444444444446,0.9555555555555556
5993,16,4,8,475,483,0.016563146997929608,0.9834368530020704
6037,16,4,0,223,223,0.0,1.0
5979,16,4,3,2,5,0.6,0.4
5966,16,4,0,73,73,0.0,1.0
5985,16,4,0,3,3,0.0,1.0
5967,16,4,0,76,76,0.0,1.0
6188,16,4,1,21,22,0.045454545454545456,0.9545454545454546
6041,16,4,0,12,12,0.0,1.0
5972,16,4,3,10,13,0.23076923076923078,0.7692307692307693
6069,16,4,1,3,4,0.25,0.75
5937,16,4,1,0,1,1.0,0.0
6028,16,4,3,28,31,0.0967741935483871,0.9032258064516129
5990,16,4,0,130,130,0.0,1.0
5928,16,4,2,479,481,0.004158004158004158,0.9958419958419958
5992,16,4,2,2,4,0.5,0.5
6058,16,4,2,11,13,0.15384615384615385,0.8461538461538461
6001,16,4,1,28,29,0.034482758620689655,0.9655172413793104
5964,16,4,2,29,31,0.06451612903225806,0.9354838709677419
5950,16,4,0,4,4,0.0,1.0
5991,16,4,1,7,8,0.125,0.875
6177,16,4,0,309,309,0.0,1.0
5961,16,4,0,321,321,0.0,1.0
6176,16,4,0,93,93,0.0,1.0
5956,16,4,0,31,31,0.0,1.0
5938,16,4,1,638,639,0.001564945226917058,0.9984350547730829
6179,16,4,2,26,28,0.07142857142857142,0.9285714285714286
5947,16,4,1,59,60,0.016666666666666666,0.9833333333333333
5927,16,4,0,455,455,0.0,1.0
5977,16,4,0,306,306,0.0,1.0
6198,16,4,0,5,5,0.0,1.0
5957,16,4,0,45,45,0.0,1.0
6057,16,4,2,27,29,0.06896551724137931,0.9310344827586207
6043,16,4,4,4,8,0.5,0.5
6077,16,4,0,4,4,0.0,1.0
6014,16,4,3,11,14,0.21428571428571427,0.7857142857142857
6015,16,4,2,1,3,0.6666666666666666,0.3333333333333333
5978,16,4,0,3,3,0.0,1.0
5986,16,4,1,49,50,0.02,0.98
5959,16,4,1,358,359,0.002785515320334262,0.9972144846796658
6051,16,4,2,36,38,0.05263157894736842,0.9473684210526315
6029,16,4,1,2,3,0.3333333333333333,0.6666666666666666
6070,16,4,0,1,1,0.0,1.0
5942,16,4,0,145,145,0.0,1.0
5953,16,4,3,1,4,0.75,0.25
6076,16,4,1,6,7,0.14285714285714285,0.8571428571428571
5940,16,4,1,9,10,0.1,0.9
6109,16,4,0,93,93,0.0,1.0
6187,16,4,0,3,3,0.0,1.0
6053,16,4,0,17,17,0.0,1.0
6104,16,4,3,6,9,0.3333333333333333,0.6666666666666666
5943,16,4,0,2,2,0.0,1.0
6017,16,4,2,1,3,0.6666666666666666,0.3333333333333333
6168,16,4,2,14,16,0.125,0.875
5989,16,4,0,6,6,0.0,1.0
5963,16,4,5,1,6,0.8333333333333334,0.16666666666666666
6194,16,4,0,26,26,0.0,1.0
6167,16,4,1,18,19,0.05263157894736842,0.9473684210526315
6004,16,4,1,63,64,0.015625,0.984375
6030,16,4,6,1,7,0.8571428571428571,0.14285714285714285
6054,16,4,1,5,6,0.16666666666666666,0.8333333333333334
6032,16,4,4,8,12,0.3333333333333333,0.6666666666666666
6170,16,4,5,59,64,0.078125,0.921875
6063,16,4,3,0,3,1.0,0.0
5988,16,4,1,0,1,1.0,0.0
6075,16,4,0,3,3,0.0,1.0
6061,16,4,0,67,67,0.0,1.0
5965,16,4,3,46,49,0.061224489795918366,0.9387755102040817
6040,16,4,3,7,10,0.3,0.7
6059,16,4,0,85,85,0.0,1.0
6106,16,4,1,62,63,0.015873015873015872,0.9841269841269841
6031,16,4,4,10,14,0.2857142857142857,0.7142857142857143
6180,16,4,0,6,6,0.0,1.0
6039,16,4,2,61,63,0.031746031746031744,0.9682539682539683
6189,17,4,0,18,18,0.0,1.0
5936,17,4,2,4,6,0.3333333333333333,0.6666666666666666
6087,17,4,4,7,11,0.36363636363636365,0.6363636363636364
5973,17,4,0,848,848,0.0,1.0
6085,17,4,2,10,12,0.16666666666666666,0.8333333333333334
6012,17,4,0,62,62,0.0,1.0
5982,17,4,0,6,6,0.0,1.0
5948,17,4,0,57,57,0.0,1.0
5974,17,4,3,3,6,0.5,0.5
6090,17,4,0,4,4,0.0,1.0
6068,17,4,3,0,3,1.0,0.0
5962,17,4,1,40,41,0.024390243902439025,0.975609756097561
6033,17,4,0,1,1,0.0,1.0
6038,17,4,1,1,2,0.5,0.5
6042,17,4,2,95,97,0.020618556701030927,0.979381443298969
5924,17,4,0,3,3,0.0,1.0
6083,17,4,0,27,27,0.0,1.0
6178,17,4,5,13,18,0.2777777777777778,0.7222222222222222
5958,17,4,2,2,4,0.5,0.5
6086,17,4,0,14,14,0.0,1.0
5945,17,4,1,18,19,0.05263157894736842,0.9473684210526315
5935,17,4,2,3,5,0.4,0.6
6073,17,4,1,14,15,0.06666666666666667,0.9333333333333333
5980,17,4,2,43,45,0.044444444444444446,0.9555555555555556
5993,17,4,1,482,483,0.002070393374741201,0.9979296066252588
6037,17,4,2,221,223,0.008968609865470852,0.9910313901345291
5979,17,4,3,2,5,0.6,0.4
5966,17,4,0,73,73,0.0,1.0
5985,17,4,1,2,3,0.3333333333333333,0.6666666666666666
5967,17,4,0,76,76,0.0,1.0
6188,17,4,2,20,22,0.09090909090909091,0.9090909090909091
6041,17,4,0,12,12,0.0,1.0
5972,17,4,7,6,13,0.5384615384615384,0.46153846153846156
6069,17,4,0,4,4,0.0,1.0
5937,17,4,1,0,1,1.0,0.0
6028,17,4,4,27,31,0.12903225806451613,0.8709677419354839
5990,17,4,0,130,130,0.0,1.0
5928,17,4,2,479,481,0.004158004158004158,0.9958419958419958
5992,17,4,2,2,4,0.5,0.5
6058,17,4,4,9,13,0.3076923076923077,0.6923076923076923
6001,17,4,2,27,29,0.06896551724137931,0.9310344827586207
5964,17,4,2,29,31,0.06451612903225806,0.9354838709677419
5950,17,4,0,4,4,0.0,1.0
5991,17,4,1,7,8,0.125,0.875
6177,17,4,2,307,309,0.006472491909385114,0.9935275080906149
5961,17,4,0,321,321,0.0,1.0
6176,17,4,0,93,93,0.0,1.0
5956,17,4,0,31,31,0.0,1.0
5938,17,4,1,638,639,0.001564945226917058,0.9984350547730829
6179,17,4,2,26,28,0.07142857142857142,0.9285714285714286
5947,17,4,5,55,60,0.08333333333333333,0.9166666666666666
5927,17,4,1,454,455,0.002197802197802198,0.9978021978021978
5977,17,4,0,306,306,0.0,1.0
6198,17,4,0,5,5,0.0,1.0
5957,17,4,0,45,45,0.0,1.0
6057,17,4,4,25,29,0.13793103448275862,0.8620689655172413
6043,17,4,4,4,8,0.5,0.5
6077,17,4,0,4,4,0.0,1.0
6014,17,4,2,12,14,0.14285714285714285,0.8571428571428571
6015,17,4,2,1,3,0.6666666666666666,0.3333333333333333
5978,17,4,1,2,3,0.3333333333333333,0.6666666666666666
5986,17,4,1,49,50,0.02,0.98
5959,17,4,1,358,359,0.002785515320334262,0.9972144846796658
6051,17,4,2,36,38,0.05263157894736842,0.9473684210526315
6029,17,4,1,2,3,0.3333333333333333,0.6666666666666666
6070,17,4,0,1,1,0.0,1.0
5942,17,4,0,145,145,0.0,1.0
5953,17,4,1,3,4,0.25,0.75
6076,17,4,0,7,7,0.0,1.0
5940,17,4,0,10,10,0.0,1.0
6109,17,4,3,90,93,0.03225806451612903,0.967741935483871
6187,17,4,0,3,3,0.0,1.0
6053,17,4,0,17,17,0.0,1.0
6104,17,4,1,8,9,0.1111111111111111,0.8888888888888888
5943,17,4,1,1,2,0.5,0.5
6017,17,4,3,0,3,1.0,0.0
6168,17,4,2,14,16,0.125,0.875
5989,17,4,0,6,6,0.0,1.0
5963,17,4,6,0,6,1.0,0.0
6194,17,4,0,26,26,0.0,1.0
6167,17,4,1,18,19,0.05263157894736842,0.9473684210526315
6004,17,4,0,64,64,0.0,1.0
6030,17,4,5,2,7,0.7142857142857143,0.2857142857142857
6054,17,4,1,5,6,0.16666666666666666,0.8333333333333334
6032,17,4,3,9,12,0.25,0.75
6170,17,4,5,59,64,0.078125,0.921875
6063,17,4,3,0,3,1.0,0.0
5988,17,4,1,0,1,1.0,0.0
6075,17,4,0,3,3,0.0,1.0
6061,17,4,0,67,67,0.0,1.0
5965,17,4,0,49,49,0.0,1.0
6040,17,4,3,7,10,0.3,0.7
6059,17,4,0,85,85,0.0,1.0
6106,17,4,2,61,63,0.031746031746031744,0.9682539682539683
6031,17,4,3,11,14,0.21428571428571427,0.7857142857142857
6180,17,4,0,6,6,0.0,1.0
6039,17,4,4,59,63,0.06349206349206349,0.9365079365079365
6189,18,4,0,18,18,0.0,1.0
5936,18,4,1,5,6,0.16666666666666666,0.8333333333333334
6087,18,4,2,9,11,0.18181818181818182,0.8181818181818182
5973,18,4,1,847,848,0.0011792452830188679,0.9988207547169812
6085,18,4,0,12,12,0.0,1.0
6012,18,4,0,62,62,0.0,1.0
5982,18,4,1,5,6,0.16666666666666666,0.8333333333333334
5948,18,4,0,57,57,0.0,1.0
5974,18,4,4,2,6,0.6666666666666666,0.3333333333333333
6090,18,4,0,4,4,0.0,1.0
6068,18,4,2,1,3,0.6666666666666666,0.3333333333333333
5962,18,4,2,39,41,0.04878048780487805,0.9512195121951219
6033,18,4,0,1,1,0.0,1.0
6038,18,4,1,1,2,0.5,0.5
6042,18,4,2,95,97,0.020618556701030927,0.979381443298969
5924,18,4,1,2,3,0.3333333333333333,0.6666666666666666
6083,18,4,0,27,27,0.0,1.0
6178,18,4,4,14,18,0.2222222222222222,0.7777777777777778
5958,18,4,2,2,4,0.5,0.5
6086,18,4,0,14,14,0.0,1.0
5945,18,4,0,19,19,0.0,1.0
5935,18,4,4,1,5,0.8,0.2
6073,18,4,1,14,15,0.06666666666666667,0.9333333333333333
5980,18,4,1,44,45,0.022222222222222223,0.9777777777777777
5993,18,4,0,483,483,0.0,1.0
6037,18,4,1,222,223,0.004484304932735426,0.9955156950672646
5979,18,4,2,3,5,0.4,0.6
5966,18,4,0,73,73,0.0,1.0
5985,18,4,0,3,3,0.0,1.0
5967,18,4,0,76,76,0.0,1.0
6188,18,4,1,21,22,0.045454545454545456,0.9545454545454546
6041,18,4,0,12,12,0.0,1.0
5972,18,4,5,8,13,0.38461538461538464,0.6153846153846154
6069,18,4,0,4,4,0.0,1.0
5937,18,4,1,0,1,1.0,0.0
6028,18,4,7,24,31,0.22580645161290322,0.7741935483870968
5990,18,4,0,130,130,0.0,1.0
5928,18,4,2,479,481,0.004158004158004158,0.9958419958419958
5992,18,4,3,1,4,0.75,0.25
6058,18,4,4,9,13,0.3076923076923077,0.6923076923076923
6001,18,4,3,26,29,0.10344827586206896,0.896551724137931
5964,18,4,1,30,31,0.03225806451612903,0.967741935483871
5950,18,4,0,4,4,0.0,1.0
5991,18,4,0,8,8,0.0,1.0
6177,18,4,2,307,309,0.006472491909385114,0.9935275080906149
5961,18,4,0,321,321,0.0,1.0
6176,18,4,0,93,93,0.0,1.0
5956,18,4,0,31,31,0.0,1.0
5938,18,4,1,638,639,0.001564945226917058,0.9984350547730829
6179,18,4,2,26,28,0.07142857142857142,0.9285714285714286
5947,18,4,2,58,60,0.03333333333333333,0.9666666666666667
5927,18,4,0,455,455,0.0,1.0
5977,18,4,0,306,306,0.0,1.0
6198,18,4,0,5,5,0.0,1.0
5957,18,4,0,45,45,0.0,1.0
6057,18,4,1,28,29,0.034482758620689655,0.9655172413793104
6043,18,4,5,3,8,0.625,0.375
6077,18,4,0,4,4,0.0,1.0
6014,18,4,2,12,14,0.14285714285714285,0.8571428571428571
6015,18,4,0,3,3,0.0,1.0
5978,18,4,2,1,3,0.6666666666666666,0.3333333333333333
5986,18,4,2,48,50,0.04,0.96
5959,18,4,0,359,359,0.0,1.0
6051,18,4,1,37,38,0.02631578947368421,0.9736842105263158
6029,18,4,2,1,3,0.6666666666666666,0.3333333333333333
6070,18,4,0,1,1,0.0,1.0
5942,18,4,0,145,145,0.0,1.0
5953,18,4,3,1,4,0.75,0.25
6076,18,4,0,7,7,0.0,1.0
5940,18,4,0,10,10,0.0,1.0
6109,18,4,1,92,93,0.010752688172043012,0.989247311827957
6187,18,4,1,2,3,0.3333333333333333,0.6666666666666666
6053,18,4,0,17,17,0.0,1.0
6104,18,4,3,6,9,0.3333333333333333,0.6666666666666666
5943,18,4,0,2,2,0.0,1.0
6017,18,4,2,1,3,0.6666666666666666,0.3333333333333333
6168,18,4,4,12,16,0.25,0.75
5989,18,4,0,6,6,0.0,1.0
5963,18,4,6,0,6,1.0,0.0
6194,18,4,0,26,26,0.0,1.0
6167,18,4,2,17,19,0.10526315789473684,0.8947368421052632
6004,18,4,0,64,64,0.0,1.0
6030,18,4,5,2,7,0.7142857142857143,0.2857142857142857
6054,18,4,2,4,6,0.3333333333333333,0.6666666666666666
6032,18,4,5,7,12,0.4166666666666667,0.5833333333333334
6170,18,4,1,63,64,0.015625,0.984375
6063,18,4,3,0,3,1.0,0.0
5988,18,4,1,0,1,1.0,0.0
6075,18,4,0,3,3,0.0,1.0
6061,18,4,0,67,67,0.0,1.0
5965,18,4,0,49,49,0.0,1.0
6040,18,4,3,7,10,0.3,0.7
6059,18,4,0,85,85,0.0,1.0
6106,18,4,1,62,63,0.015873015873015872,0.9841269841269841
6031,18,4,3,11,14,0.21428571428571427,0.7857142857142857
6180,18,4,0,6,6,0.0,1.0
6039,18,4,2,61,63,0.031746031746031744,0.9682539682539683
6189,19,4,0,18,18,0.0,1.0
5936,19,4,2,4,6,0.3333333333333333,0.6666666666666666
6087,19,4,3,8,11,0.2727272727272727,0.7272727272727273
5973,19,4,1,847,848,0.0011792452830188679,0.9988207547169812
6085,19,4,0,12,12,0.0,1.0
6012,19,4,0,62,62,0.0,1.0
5982,19,4,0,6,6,0.0,1.0
5948,19,4,0,57,57,0.0,1.0
5974,19,4,3,3,6,0.5,0.5
6090,19,4,0,4,4,0.0,1.0
6068,19,4,2,1,3,0.6666666666666666,0.3333333333333333
5962,19,4,1,40,41,0.024390243902439025,0.975609756097561
6033,19,4,0,1,1,0.0,1.0
6038,19,4,1,1,2,0.5,0.5
6042,19,4,2,95,97,0.020618556701030927,0.979381443298969
5924,19,4,0,3,3,0.0,1.0
6083,19,4,0,27,27,0.0,1.0
6178,19,4,2,16,18,0.1111111111111111,0.8888888888888888
5958,19,4,2,2,4,0.5,0.5
6086,19,4,0,14,14,0.0,1.0
5945,19,4,0,19,19,0.0,1.0
5935,19,4,1,4,5,0.2,0.8
6073,19,4,3,12,15,0.2,0.8
5980,19,4,2,43,45,0.044444444444444446,0.9555555555555556
5993,19,4,0,483,483,0.0,1.0
6037,19,4,0,223,223,0.0,1.0
5979,19,4,3,2,5,0.6,0.4
5966,19,4,0,73,73,0.0,1.0
5985,19,4,0,3,3,0.0,1.0
5967,19,4,0,76,76,0.0,1.0
6188,19,4,0,22,22,0.0,1.0
6041,19,4,0,12,12,0.0,1.0
5972,19,4,4,9,13,0.3076923076923077,0.6923076923076923
6069,19,4,0,4,4,0.0,1.0
5937,19,4,1,0,1,1.0,0.0
6028,19,4,3,28,31,0.0967741935483871,0.9032258064516129
5990,19,4,0,130,130,0.0,1.0
5928,19,4,0,481,481,0.0,1.0
5992,19,4,3,1,4,0.75,0.25
6058,19,4,2,11,13,0.15384615384615385,0.8461538461538461
6001,19,4,2,27,29,0.06896551724137931,0.9310344827586207
5964,19,4,4,27,31,0.12903225806451613,0.8709677419354839
5950,19,4,0,4,4,0.0,1.0
5991,19,4,1,7,8,0.125,0.875
6177,19,4,1,308,309,0.003236245954692557,0.9967637540453075
5961,19,4,0,321,321,0.0,1.0
6176,19,4,0,93,93,0.0,1.0
5956,19,4,0,31,31,0.0,1.0
5938,19,4,0,639,639,0.0,1.0
6179,19,4,0,28,28,0.0,1.0
5947,19,4,5,55,60,0.08333333333333333,0.9166666666666666
5927,19,4,1,454,455,0.002197802197802198,0.9978021978021978
5977,19,4,0,306,306,0.0,1.0
6198,19,4,0,5,5,0.0,1.0
5957,19,4,0,45,45,0.0,1.0
6057,19,4,1,28,29,0.034482758620689655,0.9655172413793104
6043,19,4,4,4,8,0.5,0.5
6077,19,4,0,4,4,0.0,1.0
6014,19,4,3,11,14,0.21428571428571427,0.7857142857142857
6015,19,4,0,3,3,0.0,1.0
5978,19,4,1,2,3,0.3333333333333333,0.6666666666666666
5986,19,4,2,48,50,0.04,0.96
5959,19,4,2,357,359,0.005571030640668524,0.9944289693593314
6051,19,4,2,36,38,0.05263157894736842,0.9473684210526315
6029,19,4,0,3,3,0.0,1.0
6070,19,4,0,1,1,0.0,1.0
5942,19,4,0,145,145,0.0,1.0
5953,19,4,0,4,4,0.0,1.0
6076,19,4,0,7,7,0.0,1.0
5940,19,4,2,8,10,0.2,0.8
6109,19,4,1,92,93,0.010752688172043012,0.989247311827957
6187,19,4,0,3,3,0.0,1.0
6053,19,4,0,17,17,0.0,1.0
6104,19,4,2,7,9,0.2222222222222222,0.7777777777777778
5943,19,4,0,2,2,0.0,1.0
6017,19,4,3,0,3,1.0,0.0
6168,19,4,1,15,16,0.0625,0.9375
5989,19,4,0,6,6,0.0,1.0
5963,19,4,5,1,6,0.8333333333333334,0.16666666666666666
6194,19,4,0,26,26,0.0,1.0
6167,19,4,1,18,19,0.05263157894736842,0.9473684210526315
6004,19,4,1,63,64,0.015625,0.984375
6030,19,4,6,1,7,0.8571428571428571,0.14285714285714285
6054,19,4,2,4,6,0.3333333333333333,0.6666666666666666
6032,19,4,1,11,12,0.08333333333333333,0.9166666666666666
6170,19,4,1,63,64,0.015625,0.984375
6063,19,4,3,0,3,1.0,0.0
5988,19,4,1,0,1,1.0,0.0
6075,19,4,0,3,3,0.0,1.0
6061,19,4,0,67,67,0.0,1.0
5965,19,4,0,49,49,0.0,1.0
6040,19,4,6,4,10,0.6,0.4
6059,19,4,0,85,85,0.0,1.0
6106,19,4,1,62,63,0.015873015873015872,0.9841269841269841
6031,19,4,3,11,14,0.21428571428571427,0.7857142857142857
6180,19,4,0,6,6,0.0,1.0
6039,19,4,1,62,63,0.015873015873015872,0.9841269841269841
6189,20,4,0,18,18,0.0,1.0
5936,20,4,1,5,6,0.16666666666666666,0.8333333333333334
6087,20,4,2,9,11,0.18181818181818182,0.8181818181818182
5973,20,4,1,847,848,0.0011792452830188679,0.9988207547169812
6085,20,4,0,12,12,0.0,1.0
6012,20,4,0,62,62,0.0,1.0
5982,20,4,1,5,6,0.16666666666666666,0.8333333333333334
5948,20,4,0,57,57,0.0,1.0
5974,20,4,2,4,6,0.3333333333333333,0.6666666666666666
6090,20,4,0,4,4,0.0,1.0
6068,20,4,3,0,3,1.0,0.0
5962,20,4,2,39,41,0.04878048780487805,0.9512195121951219
6033,20,4,0,1,1,0.0,1.0
6038,20,4,1,1,2,0.5,0.5
6042,20,4,3,94,97,0.030927835051546393,0.9690721649484536
5924,20,4,1,2,3,0.3333333333333333,0.6666666666666666
6083,20,4,0,27,27,0.0,1.0
6178,20,4,3,15,18,0.16666666666666666,0.8333333333333334
5958,20,4,2,2,4,0.5,0.5
6086,20,4,0,14,14,0.0,1.0
5945,20,4,1,18,19,0.05263157894736842,0.9473684210526315
5935,20,4,0,5,5,0.0,1.0
6073,20,4,4,11,15,0.26666666666666666,0.7333333333333333
5980,20,4,2,43,45,0.044444444444444446,0.9555555555555556
5993,20,4,1,482,483,0.002070393374741201,0.9979296066252588
6037,20,4,0,223,223,0.0,1.0
5979,20,4,3,2,5,0.6,0.4
5966,20,4,0,73,73,0.0,1.0
5985,20,4,0,3,3,0.0,1.0
5967,20,4,0,76,76,0.0,1.0
6188,20,4,1,21,22,0.045454545454545456,0.9545454545454546
6041,20,4,0,12,12,0.0,1.0
5972,20,4,4,9,13,0.3076923076923077,0.6923076923076923
6069,20,4,0,4,4,0.0,1.0
5937,20,4,1,0,1,1.0,0.0
6028,20,4,3,28,31,0.0967741935483871,0.9032258064516129
5990,20,4,0,130,130,0.0,1.0
5928,20,4,3,478,481,0.006237006237006237,0.9937629937629938
5992,20,4,2,2,4,0.5,0.5
6058,20,4,1,12,13,0.07692307692307693,0.9230769230769231
6001,20,4,0,29,29,0.0,1.0
5964,20,4,4,27,31,0.12903225806451613,0.8709677419354839
5950,20,4,3,1,4,0.75,0.25
5991,20,4,0,8,8,0.0,1.0
6177,20,4,0,309,309,0.0,1.0
5961,20,4,0,321,321,0.0,1.0
6176,20,4,0,93,93,0.0,1.0
5956,20,4,0,31,31,0.0,1.0
5938,20,4,0,639,639,0.0,1.0
6179,20,4,2,26,28,0.07142857142857142,0.9285714285714286
5947,20,4,7,53,60,0.11666666666666667,0.8833333333333333
5927,20,4,0,455,455,0.0,1.0
5977,20,4,0,306,306,0.0,1.0
6198,20,4,0,5,5,0.0,1.0
5957,20,4,0,45,45,0.0,1.0
6057,20,4,0,29,29,0.0,1.0
6043,20,4,4,4,8,0.5,0.5
6077,20,4,0,4,4,0.0,1.0
6014,20,4,2,12,14,0.14285714285714285,0.8571428571428571
6015,20,4,0,3,3,0.0,1.0
5978,20,4,1,2,3,0.3333333333333333,0.6666666666666666
5986,20,4,0,50,50,0.0,1.0
5959,20,4,1,358,359,0.002785515320334262,0.9972144846796658
6051,20,4,3,35,38,0.07894736842105263,0.9210526315789473
6029,20,4,1,2,3,0.3333333333333333,0.6666666666666666
6070,20,4,0,1,1,0.0,1.0
5942,20,4,0,145,145,0.0,1.0
5953,20,4,1,3,4,0.25,0.75
6076,20,4,0,7,7,0.0,1.0
5940,20,4,1,9,10,0.1,0.9
6109,20,4,0,93,93,0.0,1.0
6187,20,4,0,3,3,0.0,1.0
6053,20,4,0,17,17,0.0,1.0
6104,20,4,2,7,9,0.2222222222222222,0.7777777777777778
5943,20,4,0,2,2,0.0,1.0
6017,20,4,3,0,3,1.0,0.0
6168,20,4,1,15,16,0.0625,0.9375
5989,20,4,0,6,6,0.0,1.0
5963,20,4,6,0,6,1.0,0.0
6194,20,4,0,26,26,0.0,1.0
6167,20,4,3,16,19,0.15789473684210525,0.8421052631578947
6004,20,4,1,63,64,0.015625,0.984375
6030,20,4,4,3,7,0.5714285714285714,0.42857142857142855
6054,20,4,1,5,6,0.16666666666666666,0.8333333333333334
6032,20,4,2,10,12,0.16666666666666666,0.8333333333333334
6170,20,4,1,63,64,0.015625,0.984375
6063,20,4,3,0,3,1.0,0.0
5988,20,4,1,0,1,1.0,0.0
6075,20,4,0,3,3,0.0,1.0
6061,20,4,0,67,67,0.0,1.0
5965,20,4,1,48,49,0.02040816326530612,0.9795918367346939
6040,20,4,1,9,10,0.1,0.9
6059,20,4,0,85,85,0.0,1.0
6106,20,4,1,62,63,0.015873015873015872,0.9841269841269841
6031,20,4,3,11,14,0.21428571428571427,0.7857142857142857
6180,20,4,0,6,6,0.0,1.0
6039,20,4,2,61,63,0.031746031746031744,0.9682539682539683
6189,21,4,0,18,18,0.0,1.0
5936,21,4,3,3,6,0.5,0.5
6087,21,4,3,8,11,0.2727272727272727,0.7272727272727273
5973,21,4,0,848,848,0.0,1.0
6085,21,4,1,11,12,0.08333333333333333,0.9166666666666666
6012,21,4,0,62,62,0.0,1.0
5982,21,4,1,5,6,0.16666666666666666,0.8333333333333334
5948,21,4,0,57,57,0.0,1.0
5974,21,4,2,4,6,0.3333333333333333,0.6666666666666666
6090,21,4,0,4,4,0.0,1.0
6068,21,4,2,1,3,0.6666666666666666,0.3333333333333333
5962,21,4,1,40,41,0.024390243902439025,0.975609756097561
6033,21,4,0,1,1,0.0,1.0
6038,21,4,1,1,2,0.5,0.5
6042,21,4,1,96,97,0.010309278350515464,0.9896907216494846
5924,21,4,1,2,3,0.3333333333333333,0.6666666666666666
6083,21,4,0,27,27,0.0,1.0
6178,21,4,1,17,18,0.05555555555555555,0.9444444444444444
5958,21,4,2,2,4,0.5,0.5
6086,21,4,0,14,14,0.0,1.0
5945,21,4,1,18,19,0.05263157894736842,0.9473684210526315
5935,21,4,0,5,5,0.0,1.0
6073,21,4,1,14,15,0.06666666666666667,0.9333333333333333
5980,21,4,3,42,45,0.06666666666666667,0.9333333333333333
5993,21,4,0,483,483,0.0,1.0
6037,21,4,0,223,223,0.0,1.0
5979,21,4,2,3,5,0.4,0.6
5966,21,4,0,73,73,0.0,1.0
5985,21,4,0,3,3,0.0,1.0
5967,21,4,0,76,76,0.0,1.0
6188,21,4,1,21,22,0.045454545454545456,0.9545454545454546
6041,21,4,0,12,12,0.0,1.0
5972,21,4,4,9,13,0.3076923076923077,0.6923076923076923
6069,21,4,1,3,4,0.25,0.75
5937,21,4,1,0,1,1.0,0.0
6028,21,4,3,28,31,0.0967741935483871,0.9032258064516129
5990,21,4,0,130,130,0.0,1.0
5928,21,4,0,481,481,0.0,1.0
5992,21,4,3,1,4,0.75,0.25
6058,21,4,2,11,13,0.15384615384615385,0.8461538461538461
6001,21,4,1,28,29,0.034482758620689655,0.9655172413793104
5964,21,4,1,30,31,0.03225806451612903,0.967741935483871
5950,21,4,0,4,4,0.0,1.0
5991,21,4,1,7,8,0.125,0.875
6177,21,4,0,309,309,0.0,1.0
5961,21,4,0,321,321,0.0,1.0
6176,21,4,0,93,93,0.0,1.0
5956,21,4,0,31,31,0.0,1.0
5938,21,4,1,638,639,0.001564945226917058,0.9984350547730829
6179,21,4,0,28,28,0.0,1.0
5947,21,4,5,55,60,0.08333333333333333,0.9166666666666666
5927,21,4,0,455,455,0.0,1.0
5977,21,4,0,306,306,0.0,1.0
6198,21,4,0,5,5,0.0,1.0
5957,21,4,0,45,45,0.0,1.0
6057,21,4,0,29,29,0.0,1.0
6043,21,4,4,4,8,0.5,0.5
6077,21,4,0,4,4,0.0,1.0
6014,21,4,3,11,14,0.21428571428571427,0.7857142857142857
6015,21,4,0,3,3,0.0,1.0
5978,21,4,2,1,3,0.6666666666666666,0.3333333333333333
5986,21,4,3,47,50,0.06,0.94
5959,21,4,1,358,359,0.002785515320334262,0.9972144846796658
6051,21,4,0,38,38,0.0,1.0
6029,21,4,0,3,3,0.0,1.0
6070,21,4,0,1,1,0.0,1.0
5942,21,4,0,145,145,0.0,1.0
5953,21,4,3,1,4,0.75,0.25
6076,21,4,0,7,7,0.0,1.0
5940,21,4,2,8,10,0.2,0.8
6109,21,4,0,93,93,0.0,1.0
6187,21,4,0,3,3,0.0,1.0
6053,21,4,0,17,17,0.0,1.0
6104,21,4,1,8,9,0.1111111111111111,0.8888888888888888
5943,21,4,0,2,2,0.0,1.0
6017,21,4,3,0,3,1.0,0.0
6168,21,4,0,16,16,0.0,1.0
5989,21,4,0,6,6,0.0,1.0
5963,21,4,5,1,6,0.8333333333333334,0.16666666666666666
6194,21,4,0,26,26,0.0,1.0
6167,21,4,0,19,19,0.0,1.0
6004,21,4,1,63,64,0.015625,0.984375
6030,21,4,5,2,7,0.7142857142857143,0.2857142857142857
6054,21,4,0,6,6,0.0,1.0
6032,21,4,2,10,12,0.16666666666666666,0.8333333333333334
6170,21,4,2,62,64,0.03125,0.96875
6063,21,4,3,0,3,1.0,0.0
5988,21,4,1,0,1,1.0,0.0
6075,21,4,0,3,3,0.0,1.0
6061,21,4,0,67,67,0.0,1.0
5965,21,4,0,49,49,0.0,1.0
6040,21,4,2,8,10,0.2,0.8
6059,21,4,0,85,85,0.0,1.0
6106,21,4,1,62,63,0.015873015873015872,0.9841269841269841
6031,21,4,3,11,14,0.21428571428571427,0.7857142857142857
6180,21,4,0,6,6,0.0,1.0
6039,21,4,2,61,63,0.031746031746031744,0.9682539682539683
6189,22,4,0,18,18,0.0,1.0
5936,22,4,2,4,6,0.3333333333333333,0.6666666666666666
6087,22,4,2,9,11,0.18181818181818182,0.8181818181818182
5973,22,4,0,848,848,0.0,1.0
6085,22,4,2,10,12,0.16666666666666666,0.8333333333333334
6012,22,4,0,62,62,0.0,1.0
5982,22,4,1,5,6,0.16666666666666666,0.8333333333333334
5948,22,4,0,57,57,0.0,1.0
5974,22,4,2,4,6,0.3333333333333333,0.6666666666666666
6090,22,4,0,4,4,0.0,1.0
6068,22,4,2,1,3,0.6666666666666666,0.3333333333333333
5962,22,4,0,41,41,0.0,1.0
6033,22,4,0,1,1,0.0,1.0
6038,22,4,1,1,2,0.5,0.5
6042,22,4,3,94,97,0.030927835051546393,0.9690721649484536
5924,22,4,0,3,3,0.0,1.0
6083,22,4,0,27,27,0.0,1.0
6178,22,4,2,16,18,0.1111111111111111,0.8888888888888888
5958,22,4,2,2,4,0.5,0.5
6086,22,4,0,14,14,0.0,1.0
5945,22,4,0,19,19,0.0,1.0
5935,22,4,0,5,5,0.0,1.0
6073,22,4,1,14,15,0.06666666666666667,0.9333333333333333
5980,22,4,1,44,45,0.022222222222222223,0.9777777777777777
5993,22,4,2,481,483,0.004140786749482402,0.9958592132505176
6037,22,4,0,223,223,0.0,1.0
5979,22,4,2,3,5,0.4,0.6
5966,22,4,0,73,73,0.0,1.0
5985,22,4,0,3,3,0.0,1.0
5967,22,4,0,76,76,0.0,1.0
6188,22,4,0,22,22,0.0,1.0
6041,22,4,0,12,12,0.0,1.0
5972,22,4,4,9,13,0.3076923076923077,0.6923076923076923
6069,22,4,1,3,4,0.25,0.75
5937,22,4,1,0,1,1.0,0.0
6028,22,4,1,30,31,0.03225806451612903,0.967741935483871
5990,22,4,0,130,130,0.0,1.0
5928,22,4,2,479,481,0.004158004158004158,0.9958419958419958
5992,22,4,2,2,4,0.5,0.5
6058,22,4,1,12,13,0.07692307692307693,0.9230769230769231
6001,22,4,1,28,29,0.034482758620689655,0.9655172413793104
5964,22,4,1,30,31,0.03225806451612903,0.967741935483871
5950,22,4,3,1,4,0.75,0.25
5991,22,4,1,7,8,0.125,0.875
6177,22,4,0,309,309,0.0,1.0
5961,22,4,0,321,321,0.0,1.0
6176,22,4,0,93,93,0.0,1.0
5956,22,4,0,31,31,0.0,1.0
5938,22,4,0,639,639,0.0,1.0
6179,22,4,1,27,28,0.03571428571428571,0.9642857142857143
5947,22,4,2,58,60,0.03333333333333333,0.9666666666666667
5927,22,4,1,454,455,0.002197802197802198,0.9978021978021978
5977,22,4,0,306,306,0.0,1.0
6198,22,4,0,5,5,0.0,1.0
5957,22,4,0,45,45,0.0,1.0
6057,22,4,2,27,29,0.06896551724137931,0.9310344827586207
6043,22,4,0,8,8,0.0,1.0
6077,22,4,0,4,4,0.0,1.0
6014,22,4,5,9,14,0.35714285714285715,0.6428571428571429
6015,22,4,0,3,3,0.0,1.0
5978,22,4,1,2,3,0.3333333333333333,0.6666666666666666
5986,22,4,1,49,50,0.02,0.98
5959,22,4,1,358,359,0.002785515320334262,0.9972144846796658
6051,22,4,0,38,38,0.0,1.0
6029,22,4,1,2,3,0.3333333333333333,0.6666666666666666
6070,22,4,0,1,1,0.0,1.0
5942,22,4,0,145,145,0.0,1.0
5953,22,4,1,3,4,0.25,0.75
6076,22,4,0,7,7,0.0,1.0
5940,22,4,0,10,10,0.0,1.0
6109,22,4,0,93,93,0.0,1.0
6187,22,4,0,3,3,0.0,1.0
6053,22,4,0,17,17,0.0,1.0
6104,22,4,1,8,9,0.1111111111111111,0.8888888888888888
5943,22,4,0,2,2,0.0,1.0
6017,22,4,2,1,3,0.6666666666666666,0.3333333333333333
6168,22,4,2,14,16,0.125,0.875
5989,22,4,0,6,6,0.0,1.0
5963,22,4,5,1,6,0.8333333333333334,0.16666666666666666
6194,22,4,0,26,26,0.0,1.0
6167,22,4,1,18,19,0.05263157894736842,0.9473684210526315
6004,22,4,0,64,64,0.0,1.0
6030,22,4,5,2,7,0.7142857142857143,0.2857142857142857
6054,22,4,1,5,6,0.16666666666666666,0.8333333333333334
6032,22,4,2,10,12,0.16666666666666666,0.8333333333333334
6170,22,4,1,63,64,0.015625,0.984375
6063,22,4,3,0,3,1.0,0.0
5988,22,4,1,0,1,1.0,0.0
6075,22,4,2,1,3,0.6666666666666666,0.3333333333333333
6061,22,4,0,67,67,0.0,1.0
5965,22,4,1,48,49,0.02040816326530612,0.9795918367346939
6040,22,4,0,10,10,0.0,1.0
6059,22,4,0,85,85,0.0,1.0
6106,22,4,0,63,63,0.0,1.0
6031,22,4,0,14,14,0.0,1.0
6180,22,4,0,6,6,0.0,1.0
6039,22,4,1,62,63,0.015873015873015872,0.9841269841269841
6189,23,4,0,18,18,0.0,1.0
5936,23,4,2,4,6,0.3333333333333333,0.6666666666666666
6087,23,4,1,10,11,0.09090909090909091,0.9090909090909091
5973,23,4,0,848,848,0.0,1.0
6085,23,4,1,11,12,0.08333333333333333,0.9166666666666666
6012,23,4,0,62,62,0.0,1.0
5982,23,4,0,6,6,0.0,1.0
5948,23,4,0,57,57,0.0,1.0
5974,23,4,1,5,6,0.16666666666666666,0.8333333333333334
6090,23,4,0,4,4,0.0,1.0
6068,23,4,3,0,3,1.0,0.0
5962,23,4,0,41,41,0.0,1.0
6033,23,4,0,1,1,0.0,1.0
6038,23,4,1,1,2,0.5,0.5
6042,23,4,3,94,97,0.030927835051546393,0.9690721649484536
5924,23,4,1,2,3,0.3333333333333333,0.6666666666666666
6083,23,4,0,27,27,0.0,1.0
6178,23,4,3,15,18,0.16666666666666666,0.8333333333333334
5958,23,4,2,2,4,0.5,0.5
6086,23,4,0,14,14,0.0,1.0
5945,23,4,0,19,19,0.0,1.0
5935,23,4,0,5,5,0.0,1.0
6073,23,4,4,11,15,0.26666666666666666,0.7333333333333333
5980,23,4,1,44,45,0.022222222222222223,0.9777777777777777
5993,23,4,0,483,483,0.0,1.0
6037,23,4,0,223,223,0.0,1.0
5979,23,4,2,3,5,0.4,0.6
5966,23,4,0,73,73,0.0,1.0
5985,23,4,0,3,3,0.0,1.0
5967,23,4,0,76,76,0.0,1.0
6188,23,4,0,22,22,0.0,1.0
6041,23,4,0,12,12,0.0,1.0
5972,23,4,1,12,13,0.07692307692307693,0.9230769230769231
6069,23,4,1,3,4,0.25,0.75
5937,23,4,1,0,1,1.0,0.0
6028,23,4,2,29,31,0.06451612903225806,0.9354838709677419
5990,23,4,0,130,130,0.0,1.0
5928,23,4,2,479,481,0.004158004158004158,0.9958419958419958
5992,23,4,4,0,4,1.0,0.0
6058,23,4,1,12,13,0.07692307692307693,0.9230769230769231
6001,23,4,2,27,29,0.06896551724137931,0.9310344827586207
5964,23,4,0,31,31,0.0,1.0
5950,23,4,0,4,4,0.0,1.0
5991,23,4,2,6,8,0.25,0.75
6177,23,4,0,309,309,0.0,1.0
5961,23,4,0,321,321,0.0,1.0
6176,23,4,0,93,93,0.0,1.0
5956,23,4,0,31,31,0.0,1.0
5938,23,4,0,639,639,0.0,1.0
6179,23,4,0,28,28,0.0,1.0
5947,23,4,1,59,60,0.016666666666666666,0.9833333333333333
5927,23,4,1,454,455,0.002197802197802198,0.9978021978021978
5977,23,4,0,306,306,0.0,1.0
6198,23,4,0,5,5,0.0,1.0
5957,23,4,0,45,45,0.0,1.0
6057,23,4,0,29,29,0.0,1.0
6043,23,4,3,5,8,0.375,0.625
6077,23,4,0,4,4,0.0,1.0
6014,23,4,3,11,14,0.21428571428571427,0.7857142857142857
6015,23,4,0,3,3,0.0,1.0
5978,23,4,0,3,3,0.0,1.0
5986,23,4,0,50,50,0.0,1.0
5959,23,4,1,358,359,0.002785515320334262,0.9972144846796658
6051,23,4,0,38,38,0.0,1.0
6029,23,4,0,3,3,0.0,1.0
6070,23,4,0,1,1,0.0,1.0
5942,23,4,0,145,145,0.0,1.0
5953,23,4,1,3,4,0.25,0.75
6076,23,4,0,7,7,0.0,1.0
5940,23,4,1,9,10,0.1,0.9
6109,23,4,0,93,93,0.0,1.0
6187,23,4,0,3,3,0.0,1.0
6053,23,4,0,17,17,0.0,1.0
6104,23,4,0,9,9,0.0,1.0
5943,23,4,1,1,2,0.5,0.5
6017,23,4,2,1,3,0.6666666666666666,0.3333333333333333
6168,23,4,0,16,16,0.0,1.0
5989,23,4,0,6,6,0.0,1.0
5963,23,4,6,0,6,1.0,0.0
6194,23,4,0,26,26,0.0,1.0
6167,23,4,1,18,19,0.05263157894736842,0.9473684210526315
6004,23,4,0,64,64,0.0,1.0
6030,23,4,5,2,7,0.7142857142857143,0.2857142857142857
6054,23,4,1,5,6,0.16666666666666666,0.8333333333333334
6032,23,4,2,10,12,0.16666666666666666,0.8333333333333334
6170,23,4,1,63,64,0.015625,0.984375
6063,23,4,3,0,3,1.0,0.0
5988,23,4,1,0,1,1.0,0.0
6075,23,4,0,3,3,0.0,1.0
6061,23,4,0,67,67,0.0,1.0
5965,23,4,2,47,49,0.04081632653061224,0.9591836734693877
6040,23,4,2,8,10,0.2,0.8
6059,23,4,0,85,85,0.0,1.0
6106,23,4,1,62,63,0.015873015873015872,0.9841269841269841
6031,23,4,1,13,14,0.07142857142857142,0.9285714285714286
6180,23,4,0,6,6,0.0,1.0
6039,23,4,2,61,63,0.031746031746031744,0.9682539682539683
6189,24,4,0,18,18,0.0,1.0
5936,24,4,1,5,6,0.16666666666666666,0.8333333333333334
6087,24,4,3,8,11,0.2727272727272727,0.7272727272727273
5973,24,4,0,848,848,0.0,1.0
6085,24,4,0,12,12,0.0,1.0
6012,24,4,0,62,62,0.0,1.0
5982,24,4,0,6,6,0.0,1.0
5948,24,4,0,57,57,0.0,1.0
5974,24,4,1,5,6,0.16666666666666666,0.8333333333333334
6090,24,4,0,4,4,0.0,1.0
6068,24,4,2,1,3,0.6666666666666666,0.3333333333333333
5962,24,4,1,40,41,0.024390243902439025,0.975609756097561
6033,24,4,0,1,1,0.0,1.0
6038,24,4,1,1,2,0.5,0.5
6042,24,4,1,96,97,0.010309278350515464,0.9896907216494846
5924,24,4,1,2,3,0.3333333333333333,0.6666666666666666
6083,24,4,0,27,27,0.0,1.0
6178,24,4,2,16,18,0.1111111111111111,0.8888888888888888
5958,24,4,2,2,4,0.5,0.5
6086,24,4,0,14,14,0.0,1.0
5945,24,4,0,19,19,0.0,1.0
5935,24,4,0,5,5,0.0,1.0
6073,24,4,0,15,15,0.0,1.0
5980,24,4,2,43,45,0.044444444444444446,0.9555555555555556
5993,24,4,4,479,483,0.008281573498964804,0.9917184265010351
6037,24,4,0,223,223,0.0,1.0
5979,24,4,1,4,5,0.2,0.8
5966,24,4,0,73,73,0.0,1.0
5985,24,4,0,3,3,0.0,1.0
5967,24,4,0,76,76,0.0,1.0
6188,24,4,1,21,22,0.045454545454545456,0.9545454545454546
6041,24,4,0,12,12,0.0,1.0
5972,24,4,3,10,13,0.23076923076923078,0.7692307692307693
6069,24,4,1,3,4,0.25,0.75
5937,24,4,1,0,1,1.0,0.0
6028,24,4,3,28,31,0.0967741935483871,0.9032258064516129
5990,24,4,0,130,130,0.0,1.0
5928,24,4,0,481,481,0.0,1.0
5992,24,4,3,1,4,0.75,0.25
6058,24,4,2,11,13,0.15384615384615385,0.8461538461538461
6001,24,4,2,27,29,0.06896551724137931,0.9310344827586207
5964,24,4,2,29,31,0.06451612903225806,0.9354838709677419
5950,24,4,2,2,4,0.5,0.5
5991,24,4,1,7,8,0.125,0.875
6177,24,4,0,309,309,0.0,1.0
5961,24,4,0,321,321,0.0,1.0
6176,24,4,0,93,93,0.0,1.0
5956,24,4,0,31,31,0.0,1.0
5938,24,4,0,639,639,0.0,1.0
6179,24,4,0,28,28,0.0,1.0
5947,24,4,0,60,60,0.0,1.0
5927,24,4,1,454,455,0.002197802197802198,0.9978021978021978
5977,24,4,0,306,306,0.0,1.0
6198,24,4,0,5,5,0.0,1.0
5957,24,4,0,45,45,0.0,1.0
6057,24,4,0,29,29,0.0,1.0
6043,24,4,0,8,8,0.0,1.0
6077,24,4,0,4,4,0.0,1.0
6014,24,4,3,11,14,0.21428571428571427,0.7857142857142857
6015,24,4,0,3,3,0.0,1.0
5978,24,4,2,1,3,0.6666666666666666,0.3333333333333333
5986,24,4,1,49,50,0.02,0.98
5959,24,4,1,358,359,0.002785515320334262,0.9972144846796658
6051,24,4,0,38,38,0.0,1.0
6029,24,4,0,3,3,0.0,1.0
6070,24,4,0,1,1,0.0,1.0
5942,24,4,0,145,145,0.0,1.0
5953,24,4,0,4,4,0.0,1.0
6076,24,4,0,7,7,0.0,1.0
5940,24,4,1,9,10,0.1,0.9
6109,24,4,0,93,93,0.0,1.0
6187,24,4,0,3,3,0.0,1.0
6053,24,4,0,17,17,0.0,1.0
6104,24,4,1,8,9,0.1111111111111111,0.8888888888888888
5943,24,4,0,2,2,0.0,1.0
6017,24,4,3,0,3,1.0,0.0
6168,24,4,2,14,16,0.125,0.875
5989,24,4,0,6,6,0.0,1.0
5963,24,4,5,1,6,0.8333333333333334,0.16666666666666666
6194,24,4,0,26,26,0.0,1.0
6167,24,4,0,19,19,0.0,1.0
6004,24,4,1,63,64,0.015625,0.984375
6030,24,4,4,3,7,0.5714285714285714,0.42857142857142855
6054,24,4,0,6,6,0.0,1.0
6032,24,4,2,10,12,0.16666666666666666,0.8333333333333334
6170,24,4,3,61,64,0.046875,0.953125
6063,24,4,1,2,3,0.3333333333333333,0.6666666666666666
5988,24,4,1,0,1,1.0,0.0
6075,24,4,0,3,3,0.0,1.0
6061,24,4,0,67,67,0.0,1.0
5965,24,4,1,48,49,0.02040816326530612,0.9795918367346939
6040,24,4,4,6,10,0.4,0.6
6059,24,4,0,85,85,0.0,1.0
6106,24,4,2,61,63,0.031746031746031744,0.9682539682539683
6031,24,4,3,11,14,0.21428571428571427,0.7857142857142857
6180,24,4,0,6,6,0.0,1.0
6039,24,4,0,63,63,0.0,1.0
6189,25,4,0,18,18,0.0,1.0
5936,25,4,1,5,6,0.16666666666666666,0.8333333333333334
6087,25,4,0,11,11,0.0,1.0
5973,25,4,0,848,848,0.0,1.0
6085,25,4,0,12,12,0.0,1.0
6012,25,4,0,62,62,0.0,1.0
5982,25,4,1,5,6,0.16666666666666666,0.8333333333333334
5948,25,4,0,57,57,0.0,1.0
5974,25,4,2,4,6,0.3333333333333333,0.6666666666666666
6090,25,4,0,4,4,0.0,1.0
6068,25,4,1,2,3,0.3333333333333333,0.6666666666666666
5962,25,4,1,40,41,0.024390243902439025,0.975609756097561
6033,25,4,0,1,1,0.0,1.0
6038,25,4,1,1,2,0.5,0.5
6042,25,4,0,97,97,0.0,1.0
5924,25,4,0,3,3,0.0,1.0
6083,25,4,0,27,27,0.0,1.0
6178,25,4,2,16,18,0.1111111111111111,0.8888888888888888
5958,25,4,1,3,4,0.25,0.75
6086,25,4,0,14,14,0.0,1.0
5945,25,4,4,15,19,0.21052631578947367,0.7894736842105263
5935,25,4,1,4,5,0.2,0.8
6073,25,4,1,14,15,0.06666666666666667,0.9333333333333333
5980,25,4,2,43,45,0.044444444444444446,0.9555555555555556
5993,25,4,1,482,483,0.002070393374741201,0.9979296066252588
6037,25,4,0,223,223,0.0,1.0
5979,25,4,2,3,5,0.4,0.6
5966,25,4,0,73,73,0.0,1.0
5985,25,4,0,3,3,0.0,1.0
5967,25,4,0,76,76,0.0,1.0
6188,25,4,0,22,22,0.0,1.0
6041,25,4,0,12,12,0.0,1.0
5972,25,4,1,12,13,0.07692307692307693,0.9230769230769231
6069,25,4,1,3,4,0.25,0.75
5937,25,4,1,0,1,1.0,0.0
6028,25,4,1,30,31,0.03225806451612903,0.967741935483871
5990,25,4,0,130,130,0.0,1.0
5928,25,4,1,480,481,0.002079002079002079,0.997920997920998
5992,25,4,2,2,4,0.5,0.5
6058,25,4,0,13,13,0.0,1.0
6001,25,4,2,27,29,0.06896551724137931,0.9310344827586207
5964,25,4,2,29,31,0.06451612903225806,0.9354838709677419
5950,25,4,0,4,4,0.0,1.0
5991,25,4,1,7,8,0.125,0.875
6177,25,4,0,309,309,0.0,1.0
5961,25,4,0,321,321,0.0,1.0
6176,25,4,0,93,93,0.0,1.0
5956,25,4,0,31,31,0.0,1.0
5938,25,4,0,639,639,0.0,1.0
6179,25,4,1,27,28,0.03571428571428571,0.9642857142857143
5947,25,4,1,59,60,0.016666666666666666,0.9833333333333333
5927,25,4,1,454,455,0.002197802197802198,0.9978021978021978
5977,25,4,0,306,306,0.0,1.0
6198,25,4,0,5,5,0.0,1.0
5957,25,4,0,45,45,0.0,1.0
6057,25,4,0,29,29,0.0,1.0
6043,25,4,2,6,8,0.25,0.75
6077,25,4,0,4,4,0.0,1.0
6014,25,4,2,12,14,0.14285714285714285,0.8571428571428571
6015,25,4,0,3,3,0.0,1.0
5978,25,4,2,1,3,0.6666666666666666,0.3333333333333333
5986,25,4,2,48,50,0.04,0.96
5959,25,4,1,358,359,0.002785515320334262,0.9972144846796658
6051,25,4,0,38,38,0.0,1.0
6029,25,4,0,3,3,0.0,1.0
6070,25,4,0,1,1,0.0,1.0
5942,25,4,0,145,145,0.0,1.0
5953,25,4,1,3,4,0.25,0.75
6076,25,4,0,7,7,0.0,1.0
5940,25,4,1,9,10,0.1,0.9
6109,25,4,0,93,93,0.0,1.0
6187,25,4,0,3,3,0.0,1.0
6053,25,4,0,17,17,0.0,1.0
6104,25,4,0,9,9,0.0,1.0
5943,25,4,1,1,2,0.5,0.5
6017,25,4,1,2,3,0.3333333333333333,0.6666666666666666
6168,25,4,1,15,16,0.0625,0.9375
5989,25,4,2,4,6,0.3333333333333333,0.6666666666666666
5963,25,4,6,0,6,1.0,0.0
6194,25,4,0,26,26,0.0,1.0
6167,25,4,1,18,19,0.05263157894736842,0.9473684210526315
6004,25,4,0,64,64,0.0,1.0
6030,25,4,6,1,7,0.8571428571428571,0.14285714285714285
6054,25,4,1,5,6,0.16666666666666666,0.8333333333333334
6032,25,4,0,12,12,0.0,1.0
6170,25,4,3,61,64,0.046875,0.953125
6063,25,4,1,2,3,0.3333333333333333,0.6666666666666666
5988,25,4,1,0,1,1.0,0.0
6075,25,4,0,3,3,0.0,1.0
6061,25,4,0,67,67,0.0,1.0
5965,25,4,0,49,49,0.0,1.0
6040,25,4,1,9,10,0.1,0.9
6059,25,4,0,85,85,0.0,1.0
6106,25,4,1,62,63,0.015873015873015872,0.9841269841269841
6031,25,4,6,8,14,0.42857142857142855,0.5714285714285714
6180,25,4,0,6,6,0.0,1.0
6039,25,4,2,61,63,0.031746031746031744,0.9682539682539683
6189,26,4,0,18,18,0.0,1.0
5936,26,4,1,5,6,0.16666666666666666,0.8333333333333334
6087,26,4,0,11,11,0.0,1.0
5973,26,4,0,848,848,0.0,1.0
6085,26,4,3,9,12,0.25,0.75
6012,26,4,0,62,62,0.0,1.0
5982,26,4,1,5,6,0.16666666666666666,0.8333333333333334
5948,26,4,0,57,57,0.0,1.0
5974,26,4,1,5,6,0.16666666666666666,0.8333333333333334
6090,26,4,0,4,4,0.0,1.0
6068,26,4,1,2,3,0.3333333333333333,0.6666666666666666
5962,26,4,1,40,41,0.024390243902439025,0.975609756097561
6033,26,4,0,1,1,0.0,1.0
6038,26,4,2,0,2,1.0,0.0
6042,26,4,1,96,97,0.010309278350515464,0.9896907216494846
5924,26,4,0,3,3,0.0,1.0
6083,26,4,0,27,27,0.0,1.0
6178,26,4,1,17,18,0.05555555555555555,0.9444444444444444
5958,26,4,2,2,4,0.5,0.5
6086,26,4,0,14,14,0.0,1.0
5945,26,4,0,19,19,0.0,1.0
5935,26,4,0,5,5,0.0,1.0
6073,26,4,2,13,15,0.13333333333333333,0.8666666666666667
5980,26,4,1,44,45,0.022222222222222223,0.9777777777777777
5993,26,4,2,481,483,0.004140786749482402,0.9958592132505176
6037,26,4,0,223,223,0.0,1.0
5979,26,4,3,2,5,0.6,0.4
5966,26,4,0,73,73,0.0,1.0
5985,26,4,0,3,3,0.0,1.0
5967,26,4,0,76,76,0.0,1.0
6188,26,4,1,21,22,0.045454545454545456,0.9545454545454546
6041,26,4,0,12,12,0.0,1.0
5972,26,4,3,10,13,0.23076923076923078,0.7692307692307693
6069,26,4,1,3,4,0.25,0.75
5937,26,4,1,0,1,1.0,0.0
6028,26,4,1,30,31,0.03225806451612903,0.967741935483871
5990,26,4,0,130,130,0.0,1.0
5928,26,4,3,478,481,0.006237006237006237,0.9937629937629938
5992,26,4,3,1,4,0.75,0.25
6058,26,4,1,12,13,0.07692307692307693,0.9230769230769231
6001,26,4,1,28,29,0.034482758620689655,0.9655172413793104
5964,26,4,3,28,31,0.0967741935483871,0.9032258064516129
5950,26,4,0,4,4,0.0,1.0
5991,26,4,0,8,8,0.0,1.0
6177,26,4,1,308,309,0.003236245954692557,0.9967637540453075
5961,26,4,0,321,321,0.0,1.0
6176,26,4,0,93,93,0.0,1.0
5956,26,4,0,31,31,0.0,1.0
5938,26,4,0,639,639,0.0,1.0
6179,26,4,1,27,28,0.03571428571428571,0.9642857142857143
5947,26,4,4,56,60,0.06666666666666667,0.9333333333333333
5927,26,4,0,455,455,0.0,1.0
5977,26,4,0,306,306,0.0,1.0
6198,26,4,0,5,5,0.0,1.0
5957,26,4,0,45,45,0.0,1.0
6057,26,4,0,29,29,0.0,1.0
6043,26,4,2,6,8,0.25,0.75
6077,26,4,0,4,4,0.0,1.0
6014,26,4,0,14,14,0.0,1.0
6015,26,4,0,3,3,0.0,1.0
5978,26,4,1,2,3,0.3333333333333333,0.6666666666666666
5986,26,4,0,50,50,0.0,1.0
5959,26,4,1,358,359,0.002785515320334262,0.9972144846796658
6051,26,4,0,38,38,0.0,1.0
6029,26,4,0,3,3,0.0,1.0
6070,26,4,0,1,1,0.0,1.0
5942,26,4,0,145,145,0.0,1.0
5953,26,4,1,3,4,0.25,0.75
6076,26,4,0,7,7,0.0,1.0
5940,26,4,0,10,10,0.0,1.0
6109,26,4,1,92,93,0.010752688172043012,0.989247311827957
6187,26,4,1,2,3,0.3333333333333333,0.6666666666666666
6053,26,4,0,17,17,0.0,1.0
6104,26,4,0,9,9,0.0,1.0
5943,26,4,1,1,2,0.5,0.5
6017,26,4,3,0,3,1.0,0.0
6168,26,4,2,14,16,0.125,0.875
5989,26,4,0,6,6,0.0,1.0
5963,26,4,5,1,6,0.8333333333333334,0.16666666666666666
6194,26,4,0,26,26,0.0,1.0
6167,26,4,0,19,19,0.0,1.0
6004,26,4,1,63,64,0.015625,0.984375
6030,26,4,3,4,7,0.42857142857142855,0.5714285714285714
6054,26,4,1,5,6,0.16666666666666666,0.8333333333333334
6032,26,4,1,11,12,0.08333333333333333,0.9166666666666666
6170,26,4,1,63,64,0.015625,0.984375
6063,26,4,1,2,3,0.3333333333333333,0.6666666666666666
5988,26,4,1,0,1,1.0,0.0
6075,26,4,0,3,3,0.0,1.0
6061,26,4,0,67,67,0.0,1.0
5965,26,4,1,48,49,0.02040816326530612,0.9795918367346939
6040,26,4,2,8,10,0.2,0.8
6059,26,4,0,85,85,0.0,1.0
6106,26,4,1,62,63,0.015873015873015872,0.9841269841269841
6031,26,4,7,7,14,0.5,0.5
6180,26,4,0,6,6,0.0,1.0
6039,26,4,0,63,63,0.0,1.0
6189,27,4,0,18,18,0.0,1.0
5936,27,4,0,6,6,0.0,1.0
6087,27,4,0,11,11,0.0,1.0
5973,27,4,0,848,848,0.0,1.0
6085,27,4,2,10,12,0.16666666666666666,0.8333333333333334
6012,27,4,0,62,62,0.0,1.0
5982,27,4,1,5,6,0.16666666666666666,0.8333333333333334
5948,27,4,0,57,57,0.0,1.0
5974,27,4,1,5,6,0.16666666666666666,0.8333333333333334
6090,27,4,0,4,4,0.0,1.0
6068,27,4,3,0,3,1.0,0.0
5962,27,4,1,40,41,0.024390243902439025,0.975609756097561
6033,27,4,0,1,1,0.0,1.0
6038,27,4,2,0,2,1.0,0.0
6042,27,4,2,95,97,0.020618556701030927,0.979381443298969
5924,27,4,1,2,3,0.3333333333333333,0.6666666666666666
6083,27,4,0,27,27,0.0,1.0
6178,27,4,2,16,18,0.1111111111111111,0.8888888888888888
5958,27,4,1,3,4,0.25,0.75
6086,27,4,0,14,14,0.0,1.0
5945,27,4,0,19,19,0.0,1.0
5935,27,4,0,5,5,0.0,1.0
6073,27,4,0,15,15,0.0,1.0
5980,27,4,1,44,45,0.022222222222222223,0.9777777777777777
5993,27,4,4,479,483,0.008281573498964804,0.9917184265010351
6037,27,4,0,223,223,0.0,1.0
5979,27,4,2,3,5,0.4,0.6
5966,27,4,0,73,73,0.0,1.0
5985,27,4,0,3,3,0.0,1.0
5967,27,4,0,76,76,0.0,1.0
6188,27,4,0,22,22,0.0,1.0
6041,27,4,0,12,12,0.0,1.0
5972,27,4,3,10,13,0.23076923076923078,0.7692307692307693
6069,27,4,0,4,4,0.0,1.0
5937,27,4,1,0,1,1.0,0.0
6028,27,4,2,29,31,0.06451612903225806,0.9354838709677419
5990,27,4,0,130,130,0.0,1.0
5928,27,4,1,480,481,0.002079002079002079,0.997920997920998
5992,27,4,1,3,4,0.25,0.75
6058,27,4,2,11,13,0.15384615384615385,0.8461538461538461
6001,27,4,1,28,29,0.034482758620689655,0.9655172413793104
5964,27,4,1,30,31,0.03225806451612903,0.967741935483871
5950,27,4,3,1,4,0.75,0.25
5991,27,4,1,7,8,0.125,0.875
6177,27,4,0,309,309,0.0,1.0
5961,27,4,0,321,321,0.0,1.0
6176,27,4,0,93,93,0.0,1.0
5956,27,4,0,31,31,0.0,1.0
5938,27,4,0,639,639,0.0,1.0
6179,27,4,0,28,28,0.0,1.0
5947,27,4,0,60,60,0.0,1.0
5927,27,4,1,454,455,0.002197802197802198,0.9978021978021978
5977,27,4,0,306,306,0.0,1.0
6198,27,4,0,5,5,0.0,1.0
5957,27,4,0,45,45,0.0,1.0
6057,27,4,0,29,29,0.0,1.0
6043,27,4,1,7,8,0.125,0.875
6077,27,4,0,4,4,0.0,1.0
6014,27,4,1,13,14,0.07142857142857142,0.9285714285714286
6015,27,4,0,3,3,0.0,1.0
5978,27,4,1,2,3,0.3333333333333333,0.6666666666666666
5986,27,4,0,50,50,0.0,1.0
5959,27,4,2,357,359,0.005571030640668524,0.9944289693593314
6051,27,4,2,36,38,0.05263157894736842,0.9473684210526315
6029,27,4,0,3,3,0.0,1.0
6070,27,4,0,1,1,0.0,1.0
5942,27,4,0,145,145,0.0,1.0
5953,27,4,1,3,4,0.25,0.75
6076,27,4,0,7,7,0.0,1.0
5940,27,4,0,10,10,0.0,1.0
6109,27,4,0,93,93,0.0,1.0
6187,27,4,0,3,3,0.0,1.0
6053,27,4,0,17,17,0.0,1.0
6104,27,4,0,9,9,0.0,1.0
5943,27,4,1,1,2,0.5,0.5
6017,27,4,1,2,3,0.3333333333333333,0.6666666666666666
6168,27,4,4,12,16,0.25,0.75
5989,27,4,0,6,6,0.0,1.0
5963,27,4,6,0,6,1.0,0.0
6194,27,4,0,26,26,0.0,1.0
6167,27,4,0,19,19,0.0,1.0
6004,27,4,0,64,64,0.0,1.0
6030,27,4,6,1,7,0.8571428571428571,0.14285714285714285
6054,27,4,0,6,6,0.0,1.0
6032,27,4,2,10,12,0.16666666666666666,0.8333333333333334
6170,27,4,3,61,64,0.046875,0.953125
6063,27,4,1,2,3,0.3333333333333333,0.6666666666666666
5988,27,4,1,0,1,1.0,0.0
6075,27,4,0,3,3,0.0,1.0
6061,27,4,0,67,67,0.0,1.0
5965,27,4,1,48,49,0.02040816326530612,0.9795918367346939
6040,27,4,0,10,10,0.0,1.0
6059,27,4,0,85,85,0.0,1.0
6106,27,4,1,62,63,0.015873015873015872,0.9841269841269841
6031,27,4,2,12,14,0.14285714285714285,0.8571428571428571
6180,27,4,0,6,6,0.0,1.0
6039,27,4,1,62,63,0.015873015873015872,0.9841269841269841
6189,28,4,0,18,18,0.0,1.0
5936,28,4,1,5,6,0.16666666666666666,0.8333333333333334
6087,28,4,1,10,11,0.09090909090909091,0.9090909090909091
5973,28,4,0,848,848,0.0,1.0
6085,28,4,2,10,12,0.16666666666666666,0.8333333333333334
6012,28,4,0,62,62,0.0,1.0
5982,28,4,0,6,6,0.0,1.0
5948,28,4,0,57,57,0.0,1.0
5974,28,4,0,6,6,0.0,1.0
6090,28,4,0,4,4,0.0,1.0
6068,28,4,1,2,3,0.3333333333333333,0.6666666666666666
5962,28,4,0,41,41,0.0,1.0
6033,28,4,0,1,1,0.0,1.0
6038,28,4,1,1,2,0.5,0.5
6042,28,4,0,97,97,0.0,1.0
5924,28,4,1,2,3,0.3333333333333333,0.6666666666666666
6083,28,4,0,27,27,0.0,1.0
6178,28,4,4,14,18,0.2222222222222222,0.7777777777777778
5958,28,4,2,2,4,0.5,0.5
6086,28,4,0,14,14,0.0,1.0
5945,28,4,0,19,19,0.0,1.0
5935,28,4,0,5,5,0.0,1.0
6073,28,4,0,15,15,0.0,1.0
5980,28,4,1,44,45,0.022222222222222223,0.9777777777777777
5993,28,4,2,481,483,0.004140786749482402,0.9958592132505176
6037,28,4,0,223,223,0.0,1.0
5979,28,4,2,3,5,0.4,0.6
5966,28,4,0,73,73,0.0,1.0
5985,28,4,0,3,3,0.0,1.0
5967,28,4,0,76,76,0.0,1.0
6188,28,4,1,21,22,0.045454545454545456,0.9545454545454546
6041,28,4,0,12,12,0.0,1.0
5972,28,4,2,11,13,0.15384615384615385,0.8461538461538461
6069,28,4,2,2,4,0.5,0.5
5937,28,4,1,0,1,1.0,0.0
6028,28,4,2,29,31,0.06451612903225806,0.9354838709677419
5990,28,4,0,130,130,0.0,1.0
5928,28,4,1,480,481,0.002079002079002079,0.997920997920998
5992,28,4,4,0,4,1.0,0.0
6058,28,4,2,11,13,0.15384615384615385,0.8461538461538461
6001,28,4,1,28,29,0.034482758620689655,0.9655172413793104
5964,28,4,0,31,31,0.0,1.0
5950,28,4,0,4,4,0.0,1.0
5991,28,4,0,8,8,0.0,1.0
6177,28,4,1,308,309,0.003236245954692557,0.9967637540453075
5961,28,4,0,321,321,0.0,1.0
6176,28,4,0,93,93,0.0,1.0
5956,28,4,0,31,31,0.0,1.0
5938,28,4,0,639,639,0.0,1.0
6179,28,4,1,27,28,0.03571428571428571,0.9642857142857143
5947,28,4,1,59,60,0.016666666666666666,0.9833333333333333
5927,28,4,0,455,455,0.0,1.0
5977,28,4,0,306,306,0.0,1.0
6198,28,4,0,5,5,0.0,1.0
5957,28,4,0,45,45,0.0,1.0
6057,28,4,0,29,29,0.0,1.0
6043,28,4,2,6,8,0.25,0.75
6077,28,4,0,4,4,0.0,1.0
6014,28,4,2,12,14,0.14285714285714285,0.8571428571428571
6015,28,4,0,3,3,0.0,1.0
5978,28,4,0,3,3,0.0,1.0
5986,28,4,0,50,50,0.0,1.0
5959,28,4,0,359,359,0.0,1.0
6051,28,4,0,38,38,0.0,1.0
6029,28,4,0,3,3,0.0,1.0
6070,28,4,0,1,1,0.0,1.0
5942,28,4,0,145,145,0.0,1.0
5953,28,4,1,3,4,0.25,0.75
6076,28,4,0,7,7,0.0,1.0
5940,28,4,1,9,10,0.1,0.9
6109,28,4,0,93,93,0.0,1.0
6187,28,4,0,3,3,0.0,1.0
6053,28,4,0,17,17,0.0,1.0
6104,28,4,0,9,9,0.0,1.0
5943,28,4,1,1,2,0.5,0.5
6017,28,4,2,1,3,0.6666666666666666,0.3333333333333333
6168,28,4,1,15,16,0.0625,0.9375
5989,28,4,0,6,6,0.0,1.0
5963,28,4,5,1,6,0.8333333333333334,0.16666666666666666
6194,28,4,0,26,26,0.0,1.0
6167,28,4,0,19,19,0.0,1.0
6004,28,4,0,64,64,0.0,1.0
6030,28,4,3,4,7,0.42857142857142855,0.5714285714285714
6054,28,4,0,6,6,0.0,1.0
6032,28,4,2,10,12,0.16666666666666666,0.8333333333333334
6170,28,4,0,64,64,0.0,1.0
6063,28,4,2,1,3,0.6666666666666666,0.3333333333333333
5988,28,4,1,0,1,1.0,0.0
6075,28,4,0,3,3,0.0,1.0
6061,28,4,0,67,67,0.0,1.0
5965,28,4,1,48,49,0.02040816326530612,0.9795918367346939
6040,28,4,1,9,10,0.1,0.9
6059,28,4,0,85,85,0.0,1.0
6106,28,4,0,63,63,0.0,1.0
6031,28,4,7,7,14,0.5,0.5
6180,28,4,0,6,6,0.0,1.0
6039,28,4,1,62,63,0.015873015873015872,0.9841269841269841
6189,29,4,0,18,18,0.0,1.0
5936,29,4,0,6,6,0.0,1.0
6087,29,4,2,9,11,0.18181818181818182,0.8181818181818182
5973,29,4,0,848,848,0.0,1.0
6085,29,4,3,9,12,0.25,0.75
6012,29,4,0,62,62,0.0,1.0
5982,29,4,0,6,6,0.0,1.0
5948,29,4,0,57,57,0.0,1.0
5974,29,4,2,4,6,0.3333333333333333,0.6666666666666666
6090,29,4,0,4,4,0.0,1.0
6068,29,4,1,2,3,0.3333333333333333,0.6666666666666666
5962,29,4,1,40,41,0.024390243902439025,0.975609756097561
6033,29,4,0,1,1,0.0,1.0
6038,29,4,1,1,2,0.5,0.5
6042,29,4,1,96,97,0.010309278350515464,0.9896907216494846
5924,29,4,0,3,3,0.0,1.0
6083,29,4,0,27,27,0.0,1.0
6178,29,4,3,15,18,0.16666666666666666,0.8333333333333334
5958,29,4,1,3,4,0.25,0.75
6086,29,4,0,14,14,0.0,1.0
5945,29,4,0,19,19,0.0,1.0
5935,29,4,2,3,5,0.4,0.6
6073,29,4,0,15,15,0.0,1.0
5980,29,4,2,43,45,0.044444444444444446,0.9555555555555556
5993,29,4,2,481,483,0.004140786749482402,0.9958592132505176
6037,29,4,0,223,223,0.0,1.0
5979,29,4,2,3,5,0.4,0.6
5966,29,4,0,73,73,0.0,1.0
5985,29,4,0,3,3,0.0,1.0
5967,29,4,0,76,76,0.0,1.0
6188,29,4,0,22,22,0.0,1.0
6041,29,4,0,12,12,0.0,1.0
5972,29,4,3,10,13,0.23076923076923078,0.7692307692307693
6069,29,4,1,3,4,0.25,0.75
5937,29,4,1,0,1,1.0,0.0
6028,29,4,2,29,31,0.06451612903225806,0.9354838709677419
5990,29,4,0,130,130,0.0,1.0
5928,29,4,0,481,481,0.0,1.0
5992,29,4,2,2,4,0.5,0.5
6058,29,4,1,12,13,0.07692307692307693,0.9230769230769231
6001,29,4,1,28,29,0.034482758620689655,0.9655172413793104
5964,29,4,1,30,31,0.03225806451612903,0.967741935483871
5950,29,4,0,4,4,0.0,1.0
5991,29,4,0,8,8,0.0,1.0
6177,29,4,0,309,309,0.0,1.0
5961,29,4,0,321,321,0.0,1.0
6176,29,4,0,93,93,0.0,1.0
5956,29,4,0,31,31,0.0,1.0
5938,29,4,0,639,639,0.0,1.0
6179,29,4,1,27,28,0.03571428571428571,0.9642857142857143
5947,29,4,0,60,60,0.0,1.0
5927,29,4,0,455,455,0.0,1.0
5977,29,4,0,306,306,0.0,1.0
6198,29,4,0,5,5,0.0,1.0
5957,29,4,0,45,45,0.0,1.0
6057,29,4,0,29,29,0.0,1.0
6043,29,4,0,8,8,0.0,1.0
6077,29,4,0,4,4,0.0,1.0
6014,29,4,2,12,14,0.14285714285714285,0.8571428571428571
6015,29,4,0,3,3,0.0,1.0
5978,29,4,1,2,3,0.3333333333333333,0.6666666666666666
5986,29,4,0,50,50,0.0,1.0
5959,29,4,0,359,359,0.0,1.0
6051,29,4,0,38,38,0.0,1.0
6029,29,4,0,3,3,0.0,1.0
6070,29,4,0,1,1,0.0,1.0
5942,29,4,0,145,145,0.0,1.0
5953,29,4,0,4,4,0.0,1.0
6076,29,4,0,7,7,0.0,1.0
5940,29,4,2,8,10,0.2,0.8
6109,29,4,0,93,93,0.0,1.0
6187,29,4,0,3,3,0.0,1.0
6053,29,4,0,17,17,0.0,1.0
6104,29,4,0,9,9,0.0,1.0
5943,29,4,0,2,2,0.0,1.0
6017,29,4,2,1,3,0.6666666666666666,0.3333333333333333
6168,29,4,2,14,16,0.125,0.875
5989,29,4,0,6,6,0.0,1.0
5963,29,4,5,1,6,0.8333333333333334,0.16666666666666666
6194,29,4,0,26,26,0.0,1.0
6167,29,4,1,18,19,0.05263157894736842,0.9473684210526315
6004,29,4,1,63,64,0.015625,0.984375
6030,29,4,2,5,7,0.2857142857142857,0.7142857142857143
6054,29,4,1,5,6,0.16666666666666666,0.8333333333333334
6032,29,4,1,11,12,0.08333333333333333,0.9166666666666666
6170,29,4,1,63,64,0.015625,0.984375
6063,29,4,1,2,3,0.3333333333333333,0.6666666666666666
5988,29,4,1,0,1,1.0,0.0
6075,29,4,0,3,3,0.0,1.0
6061,29,4,0,67,67,0.0,1.0
5965,29,4,0,49,49,0.0,1.0
6040,29,4,0,10,10,0.0,1.0
6059,29,4,0,85,85,0.0,1.0
6106,29,4,0,63,63,0.0,1.0
6031,29,4,3,11,14,0.21428571428571427,0.7857142857142857
6180,29,4,0,6,6,0.0,1.0
6039,29,4,1,62,63,0.015873015873015872,0.9841269841269841
